PokerStars Hand #177192972162: Tournament #2067822782, $1.00+$0.10 USD Hold'em No Limit - Level II (20/40) - 2017/10/21 18:50:32 CUST [2017/10/21 10:50:32 ET]
Table '2067822782 41' 9-max Seat #1 is the button
Seat 1: Xam54rus (2795 in chips) 
Seat 3: ferraresi81 (6840 in chips) 
Seat 4: chencovzp (2026 in chips) 
Seat 5: avia707 (2919 in chips) 
Seat 6: Barossi415 (2758 in chips) 
Seat 7: TURoff (3000 in chips) 
Seat 8: luka luka580 (7799 in chips) 
Seat 9: Mefiusto (3339 in chips) 
Xam54rus: posts the ante 5
ferraresi81: posts the ante 5
chencovzp: posts the ante 5
avia707: posts the ante 5
Barossi415: posts the ante 5
TURoff: posts the ante 5
luka luka580: posts the ante 5
Mefiusto: posts the ante 5
ferraresi81: posts small blind 20
chencovzp: posts big blind 40
*** HOLE CARDS ***
Dealt to TURoff [2d Qc]
avia707: folds 
Barossi415: folds 
TURoff: folds 
luka luka580: folds 
Mefiusto: folds 
Xam54rus: folds 
ferraresi81: calls 20
chencovzp: checks 
*** FLOP *** [7d 5s Kc]
ferraresi81: checks 
chencovzp: checks 
*** TURN *** [7d 5s Kc] [5c]
ferraresi81: bets 120
chencovzp: calls 120
*** RIVER *** [7d 5s Kc 5c] [8d]
ferraresi81: checks 
chencovzp: bets 320
ferraresi81: folds 
Uncalled bet (320) returned to chencovzp
chencovzp collected 360 from pot
chencovzp: doesn't show hand 
*** SUMMARY ***
Total pot 360 | Rake 0 
Board [7d 5s Kc 5c 8d]
Seat 1: Xam54rus (button) folded before Flop (didn't bet)
Seat 3: ferraresi81 (small blind) folded on the River
Seat 4: chencovzp (big blind) collected (360)
Seat 5: avia707 folded before Flop (didn't bet)
Seat 6: Barossi415 folded before Flop (didn't bet)
Seat 7: TURoff folded before Flop (didn't bet)
Seat 8: luka luka580 folded before Flop (didn't bet)
Seat 9: Mefiusto folded before Flop (didn't bet)





PokerStars Hand #177193002148: Tournament #2067822782, $1.00+$0.10 USD Hold'em No Limit - Level II (20/40) - 2017/10/21 18:51:20 CUST [2017/10/21 10:51:20 ET]
Table '2067822782 41' 9-max Seat #3 is the button
Seat 1: Xam54rus (2790 in chips) 
Seat 2: Otti193 (3000 in chips) 
Seat 3: ferraresi81 (6675 in chips) 
Seat 4: chencovzp (2221 in chips) 
Seat 5: avia707 (2914 in chips) 
Seat 6: Barossi415 (2753 in chips) 
Seat 7: TURoff (2995 in chips) 
Seat 8: luka luka580 (7794 in chips) 
Seat 9: Mefiusto (3334 in chips) 
Xam54rus: posts the ante 5
Otti193: posts the ante 5
ferraresi81: posts the ante 5
chencovzp: posts the ante 5
avia707: posts the ante 5
Barossi415: posts the ante 5
TURoff: posts the ante 5
luka luka580: posts the ante 5
Mefiusto: posts the ante 5
chencovzp: posts small blind 20
avia707: posts big blind 40
*** HOLE CARDS ***
Dealt to TURoff [As 3h]
Barossi415: folds 
TURoff: folds 
luka luka580: calls 40
Mefiusto: folds 
Xam54rus: folds 
Otti193: folds 
ferraresi81: folds 
chencovzp: calls 20
avia707: checks 
*** FLOP *** [Ts 2s 5c]
chencovzp: checks 
avia707: checks 
luka luka580: checks 
*** TURN *** [Ts 2s 5c] [Qs]
chencovzp: checks 
avia707: checks 
luka luka580: checks 
*** RIVER *** [Ts 2s 5c Qs] [6c]
chencovzp: bets 120
avia707: folds 
luka luka580: folds 
Uncalled bet (120) returned to chencovzp
chencovzp collected 165 from pot
chencovzp: doesn't show hand 
*** SUMMARY ***
Total pot 165 | Rake 0 
Board [Ts 2s 5c Qs 6c]
Seat 1: Xam54rus folded before Flop (didn't bet)
Seat 2: Otti193 folded before Flop (didn't bet)
Seat 3: ferraresi81 (button) folded before Flop (didn't bet)
Seat 4: chencovzp (small blind) collected (165)
Seat 5: avia707 (big blind) folded on the River
Seat 6: Barossi415 folded before Flop (didn't bet)
Seat 7: TURoff folded before Flop (didn't bet)
Seat 8: luka luka580 folded on the River
Seat 9: Mefiusto folded before Flop (didn't bet)





PokerStars Hand #177193034267: Tournament #2067822782, $1.00+$0.10 USD Hold'em No Limit - Level II (20/40) - 2017/10/21 18:52:12 CUST [2017/10/21 10:52:12 ET]
Table '2067822782 41' 9-max Seat #4 is the button
Seat 1: Xam54rus (2785 in chips) 
Seat 2: Otti193 (2995 in chips) 
Seat 3: ferraresi81 (6670 in chips) 
Seat 4: chencovzp (2341 in chips) 
Seat 5: avia707 (2869 in chips) 
Seat 6: Barossi415 (2748 in chips) 
Seat 7: TURoff (2990 in chips) 
Seat 8: luka luka580 (7749 in chips) 
Seat 9: Mefiusto (3329 in chips) 
Xam54rus: posts the ante 5
Otti193: posts the ante 5
ferraresi81: posts the ante 5
chencovzp: posts the ante 5
avia707: posts the ante 5
Barossi415: posts the ante 5
TURoff: posts the ante 5
luka luka580: posts the ante 5
Mefiusto: posts the ante 5
avia707: posts small blind 20
Barossi415: posts big blind 40
*** HOLE CARDS ***
Dealt to TURoff [7h 8c]
TURoff: folds 
luka luka580: folds 
Mefiusto: calls 40
Xam54rus: folds 
Otti193: folds 
ferraresi81: folds 
chencovzp: calls 40
avia707: folds 
Barossi415: checks 
*** FLOP *** [Jh 3s Qd]
Barossi415: checks 
Mefiusto: bets 93
chencovzp: folds 
Barossi415: folds 
Uncalled bet (93) returned to Mefiusto
Mefiusto collected 185 from pot
Mefiusto: doesn't show hand 
*** SUMMARY ***
Total pot 185 | Rake 0 
Board [Jh 3s Qd]
Seat 1: Xam54rus folded before Flop (didn't bet)
Seat 2: Otti193 folded before Flop (didn't bet)
Seat 3: ferraresi81 folded before Flop (didn't bet)
Seat 4: chencovzp (button) folded on the Flop
Seat 5: avia707 (small blind) folded before Flop
Seat 6: Barossi415 (big blind) folded on the Flop
Seat 7: TURoff folded before Flop (didn't bet)
Seat 8: luka luka580 folded before Flop (didn't bet)
Seat 9: Mefiusto collected (185)





PokerStars Hand #177193050628: Tournament #2067822782, $1.00+$0.10 USD Hold'em No Limit - Level II (20/40) - 2017/10/21 18:52:38 CUST [2017/10/21 10:52:38 ET]
Table '2067822782 41' 9-max Seat #5 is the button
Seat 1: Xam54rus (2780 in chips) 
Seat 2: Otti193 (2990 in chips) 
Seat 3: ferraresi81 (6665 in chips) 
Seat 4: chencovzp (2296 in chips) 
Seat 5: avia707 (2844 in chips) 
Seat 6: Barossi415 (2703 in chips) 
Seat 7: TURoff (2985 in chips) 
Seat 8: luka luka580 (7744 in chips) 
Seat 9: Mefiusto (3469 in chips) 
Xam54rus: posts the ante 5
Otti193: posts the ante 5
ferraresi81: posts the ante 5
chencovzp: posts the ante 5
avia707: posts the ante 5
Barossi415: posts the ante 5
TURoff: posts the ante 5
luka luka580: posts the ante 5
Mefiusto: posts the ante 5
Barossi415: posts small blind 20
TURoff: posts big blind 40
*** HOLE CARDS ***
Dealt to TURoff [6h 2h]
luka luka580: folds 
Mefiusto: calls 40
Xam54rus: folds 
Otti193: folds 
ferraresi81: folds 
chencovzp: calls 40
avia707: folds 
Barossi415: calls 20
TURoff: checks 
*** FLOP *** [3s Qs 5s]
Barossi415: checks 
TURoff: checks 
Mefiusto: checks 
chencovzp: checks 
*** TURN *** [3s Qs 5s] [3h]
Barossi415: checks 
TURoff: checks 
Mefiusto: bets 240
chencovzp: calls 240
Barossi415: folds 
TURoff: folds 
*** RIVER *** [3s Qs 5s 3h] [9d]
Mefiusto: bets 160
chencovzp: calls 160
*** SHOW DOWN ***
Mefiusto: shows [9h Th] (two pair, Nines and Threes)
chencovzp: shows [8d Qc] (two pair, Queens and Threes)
chencovzp collected 1005 from pot
*** SUMMARY ***
Total pot 1005 | Rake 0 
Board [3s Qs 5s 3h 9d]
Seat 1: Xam54rus folded before Flop (didn't bet)
Seat 2: Otti193 folded before Flop (didn't bet)
Seat 3: ferraresi81 folded before Flop (didn't bet)
Seat 4: chencovzp showed [8d Qc] and won (1005) with two pair, Queens and Threes
Seat 5: avia707 (button) folded before Flop (didn't bet)
Seat 6: Barossi415 (small blind) folded on the Turn
Seat 7: TURoff (big blind) folded on the Turn
Seat 8: luka luka580 folded before Flop (didn't bet)
Seat 9: Mefiusto showed [9h Th] and lost with two pair, Nines and Threes





PokerStars Hand #177193088166: Tournament #2067822782, $1.00+$0.10 USD Hold'em No Limit - Level II (20/40) - 2017/10/21 18:53:39 CUST [2017/10/21 10:53:39 ET]
Table '2067822782 41' 9-max Seat #6 is the button
Seat 1: Xam54rus (2775 in chips) 
Seat 2: Otti193 (2985 in chips) 
Seat 3: ferraresi81 (6660 in chips) 
Seat 4: chencovzp (2856 in chips) 
Seat 5: avia707 (2839 in chips) 
Seat 6: Barossi415 (2658 in chips) 
Seat 7: TURoff (2940 in chips) 
Seat 8: luka luka580 (7739 in chips) 
Seat 9: Mefiusto (3024 in chips) 
Xam54rus: posts the ante 5
Otti193: posts the ante 5
ferraresi81: posts the ante 5
chencovzp: posts the ante 5
avia707: posts the ante 5
Barossi415: posts the ante 5
TURoff: posts the ante 5
luka luka580: posts the ante 5
Mefiusto: posts the ante 5
TURoff: posts small blind 20
luka luka580: posts big blind 40
*** HOLE CARDS ***
Dealt to TURoff [Ah 7c]
Mefiusto: raises 80 to 120
Xam54rus: folds 
Otti193: folds 
ferraresi81: calls 120
chencovzp: calls 120
avia707: folds 
Barossi415: folds 
TURoff: folds 
luka luka580: folds 
*** FLOP *** [4c 8c 2c]
Mefiusto: bets 560
ferraresi81: folds 
chencovzp: folds 
Uncalled bet (560) returned to Mefiusto
Mefiusto collected 465 from pot
Mefiusto: doesn't show hand 
*** SUMMARY ***
Total pot 465 | Rake 0 
Board [4c 8c 2c]
Seat 1: Xam54rus folded before Flop (didn't bet)
Seat 2: Otti193 folded before Flop (didn't bet)
Seat 3: ferraresi81 folded on the Flop
Seat 4: chencovzp folded on the Flop
Seat 5: avia707 folded before Flop (didn't bet)
Seat 6: Barossi415 (button) folded before Flop (didn't bet)
Seat 7: TURoff (small blind) folded before Flop
Seat 8: luka luka580 (big blind) folded before Flop
Seat 9: Mefiusto collected (465)





PokerStars Hand #177193112878: Tournament #2067822782, $1.00+$0.10 USD Hold'em No Limit - Level II (20/40) - 2017/10/21 18:54:19 CUST [2017/10/21 10:54:19 ET]
Table '2067822782 41' 9-max Seat #7 is the button
Seat 1: Xam54rus (2770 in chips) 
Seat 2: Otti193 (2980 in chips) 
Seat 3: ferraresi81 (6535 in chips) 
Seat 4: chencovzp (2731 in chips) 
Seat 5: avia707 (2834 in chips) 
Seat 6: Barossi415 (2653 in chips) 
Seat 7: TURoff (2915 in chips) 
Seat 8: luka luka580 (7694 in chips) 
Seat 9: Mefiusto (3364 in chips) 
Xam54rus: posts the ante 5
Otti193: posts the ante 5
ferraresi81: posts the ante 5
chencovzp: posts the ante 5
avia707: posts the ante 5
Barossi415: posts the ante 5
TURoff: posts the ante 5
luka luka580: posts the ante 5
Mefiusto: posts the ante 5
luka luka580: posts small blind 20
Mefiusto: posts big blind 40
*** HOLE CARDS ***
Dealt to TURoff [Qs 4d]
Xam54rus: folds 
Otti193: raises 80 to 120
ferraresi81: calls 120
chencovzp: calls 120
avia707: folds 
Barossi415: folds 
TURoff: folds 
luka luka580: folds 
Mefiusto: raises 3239 to 3359 and is all-in
Otti193: folds 
ferraresi81: folds 
chencovzp: folds 
Uncalled bet (3239) returned to Mefiusto
Mefiusto collected 545 from pot
Mefiusto: doesn't show hand 
*** SUMMARY ***
Total pot 545 | Rake 0 
Seat 1: Xam54rus folded before Flop (didn't bet)
Seat 2: Otti193 folded before Flop
Seat 3: ferraresi81 folded before Flop
Seat 4: chencovzp folded before Flop
Seat 5: avia707 folded before Flop (didn't bet)
Seat 6: Barossi415 folded before Flop (didn't bet)
Seat 7: TURoff (button) folded before Flop (didn't bet)
Seat 8: luka luka580 (small blind) folded before Flop
Seat 9: Mefiusto (big blind) collected (545)





PokerStars Hand #177193363876: Tournament #2067822782, $1.00+$0.10 USD Hold'em No Limit - Level II (20/40) - 2017/10/21 19:01:57 CUST [2017/10/21 11:01:57 ET]
Table '2067822782 41' 9-max Seat #9 is the button
Seat 1: Xam54rus (2765 in chips) 
Seat 2: Otti193 (2855 in chips) 
Seat 3: ferraresi81 (6410 in chips) 
Seat 4: chencovzp (2606 in chips) 
Seat 5: avia707 (2829 in chips) 
Seat 6: Barossi415 (2648 in chips) 
Seat 7: TURoff (2910 in chips) 
Seat 8: Giedra85 (3000 in chips) 
Seat 9: Mefiusto (3784 in chips) 
Xam54rus: posts the ante 5
Otti193: posts the ante 5
ferraresi81: posts the ante 5
chencovzp: posts the ante 5
avia707: posts the ante 5
Barossi415: posts the ante 5
TURoff: posts the ante 5
Giedra85: posts the ante 5
Mefiusto: posts the ante 5
Xam54rus: posts small blind 20
Otti193: posts big blind 40
*** HOLE CARDS ***
Dealt to TURoff [4h 6d]
ferraresi81: folds 
chencovzp: calls 40
avia707: folds 
Barossi415: folds 
TURoff: folds 
Giedra85: raises 120 to 160
Mefiusto: folds 
Xam54rus: folds 
Otti193: folds 
chencovzp: calls 120
*** FLOP *** [8s Ac Jh]
chencovzp: checks 
avia707 is disconnected 
Giedra85: bets 160
chencovzp: calls 160
*** TURN *** [8s Ac Jh] [Jd]
chencovzp: checks 
Giedra85: checks 
*** RIVER *** [8s Ac Jh Jd] [6c]
chencovzp: checks 
Giedra85: bets 280
chencovzp: raises 280 to 560
Giedra85: calls 280
*** SHOW DOWN ***
chencovzp: shows [Js As] (a full house, Jacks full of Aces)
Giedra85: mucks hand 
chencovzp collected 1865 from pot
*** SUMMARY ***
Total pot 1865 | Rake 0 
Board [8s Ac Jh Jd 6c]
Seat 1: Xam54rus (small blind) folded before Flop
Seat 2: Otti193 (big blind) folded before Flop
Seat 3: ferraresi81 folded before Flop (didn't bet)
Seat 4: chencovzp showed [Js As] and won (1865) with a full house, Jacks full of Aces
Seat 5: avia707 folded before Flop (didn't bet)
Seat 6: Barossi415 folded before Flop (didn't bet)
Seat 7: TURoff folded before Flop (didn't bet)
Seat 8: Giedra85 mucked [Kd Ks]
Seat 9: Mefiusto (button) folded before Flop (didn't bet)





PokerStars Hand #177193441640: Tournament #2067822782, $1.00+$0.10 USD Hold'em No Limit - Level II (20/40) - 2017/10/21 19:04:00 CUST [2017/10/21 11:04:00 ET]
Table '2067822782 41' 9-max Seat #1 is the button
Seat 1: Xam54rus (2740 in chips) 
Seat 2: Otti193 (2810 in chips) 
Seat 3: ferraresi81 (6405 in chips) 
Seat 4: chencovzp (3586 in chips) 
Seat 5: avia707 (2824 in chips) 
Seat 6: Barossi415 (2643 in chips) 
Seat 7: TURoff (2905 in chips) 
Seat 8: Giedra85 (2115 in chips) 
Seat 9: Mefiusto (3779 in chips) 
Xam54rus: posts the ante 5
Otti193: posts the ante 5
ferraresi81: posts the ante 5
chencovzp: posts the ante 5
avia707: posts the ante 5
Barossi415: posts the ante 5
TURoff: posts the ante 5
Giedra85: posts the ante 5
Mefiusto: posts the ante 5
Otti193: posts small blind 20
ferraresi81: posts big blind 40
*** HOLE CARDS ***
Dealt to TURoff [8h 4s]
chencovzp: calls 40
avia707: folds 
Barossi415: folds 
TURoff: folds 
Giedra85: raises 2070 to 2110 and is all-in
Mefiusto: folds 
Xam54rus: folds 
Otti193: folds 
ferraresi81: folds 
chencovzp: folds 
Uncalled bet (2070) returned to Giedra85
Giedra85 collected 185 from pot
*** SUMMARY ***
Total pot 185 | Rake 0 
Seat 1: Xam54rus (button) folded before Flop (didn't bet)
Seat 2: Otti193 (small blind) folded before Flop
Seat 3: ferraresi81 (big blind) folded before Flop
Seat 4: chencovzp folded before Flop
Seat 5: avia707 folded before Flop (didn't bet)
Seat 6: Barossi415 folded before Flop (didn't bet)
Seat 7: TURoff folded before Flop (didn't bet)
Seat 8: Giedra85 collected (185)
Seat 9: Mefiusto folded before Flop (didn't bet)





PokerStars Hand #177193458231: Tournament #2067822782, $1.00+$0.10 USD Hold'em No Limit - Level II (20/40) - 2017/10/21 19:04:26 CUST [2017/10/21 11:04:26 ET]
Table '2067822782 41' 9-max Seat #2 is the button
Seat 1: Xam54rus (2735 in chips) 
Seat 2: Otti193 (2785 in chips) 
Seat 3: ferraresi81 (6360 in chips) 
Seat 4: chencovzp (3541 in chips) 
Seat 5: avia707 (2819 in chips) 
Seat 6: Barossi415 (2638 in chips) 
Seat 7: TURoff (2900 in chips) 
Seat 8: Giedra85 (2255 in chips) 
Seat 9: Mefiusto (3774 in chips) 
Xam54rus: posts the ante 5
Otti193: posts the ante 5
ferraresi81: posts the ante 5
chencovzp: posts the ante 5
avia707: posts the ante 5
Barossi415: posts the ante 5
TURoff: posts the ante 5
Giedra85: posts the ante 5
Mefiusto: posts the ante 5
ferraresi81: posts small blind 20
chencovzp: posts big blind 40
*** HOLE CARDS ***
Dealt to TURoff [Ah 5c]
avia707: calls 40
Barossi415: folds 
TURoff: folds 
Giedra85: calls 40
Mefiusto: folds 
Xam54rus: folds 
Otti193: calls 40
ferraresi81: folds 
chencovzp: checks 
*** FLOP *** [3h Ac 9h]
chencovzp: checks 
avia707: checks 
Giedra85: checks 
Otti193: bets 113
chencovzp: calls 113
avia707: folds 
Giedra85: folds 
*** TURN *** [3h Ac 9h] [3s]
chencovzp: checks 
Otti193: bets 226
chencovzp: folds 
Uncalled bet (226) returned to Otti193
Otti193 collected 451 from pot
Otti193: doesn't show hand 
*** SUMMARY ***
Total pot 451 | Rake 0 
Board [3h Ac 9h 3s]
Seat 1: Xam54rus folded before Flop (didn't bet)
Seat 2: Otti193 (button) collected (451)
Seat 3: ferraresi81 (small blind) folded before Flop
Seat 4: chencovzp (big blind) folded on the Turn
Seat 5: avia707 folded on the Flop
Seat 6: Barossi415 folded before Flop (didn't bet)
Seat 7: TURoff folded before Flop (didn't bet)
Seat 8: Giedra85 folded on the Flop
Seat 9: Mefiusto folded before Flop (didn't bet)





PokerStars Hand #177193489387: Tournament #2067822782, $1.00+$0.10 USD Hold'em No Limit - Level II (20/40) - 2017/10/21 19:05:16 CUST [2017/10/21 11:05:16 ET]
Table '2067822782 23' 9-max Seat #3 is the button
Seat 2: -showyap- (3525 in chips) 
Seat 3: macadox-420 (3385 in chips) 
Seat 4: serzhinho (3242 in chips) 
Seat 5: Tobias/Felix (1212 in chips) 
Seat 6: Gnourt93 (3046 in chips) 
Seat 7: TURoff (2895 in chips) 
Seat 8: h@st@ baby (5470 in chips) 
Seat 9: jeprip (2870 in chips) 
-showyap-: posts the ante 5
macadox-420: posts the ante 5
serzhinho: posts the ante 5
Tobias/Felix: posts the ante 5
Gnourt93: posts the ante 5
TURoff: posts the ante 5
h@st@ baby: posts the ante 5
jeprip: posts the ante 5
serzhinho: posts small blind 20
Tobias/Felix: posts big blind 40
*** HOLE CARDS ***
Dealt to TURoff [2d Qd]
Gnourt93: folds 
TURoff: folds 
h@st@ baby: raises 80 to 120
jeprip: calls 120
-showyap-: folds 
macadox-420: folds 
serzhinho: folds 
Tobias/Felix: folds 
*** FLOP *** [6s 5h Ac]
h@st@ baby: bets 129
jeprip: raises 371 to 500
h@st@ baby: folds 
Uncalled bet (371) returned to jeprip
jeprip collected 598 from pot
*** SUMMARY ***
Total pot 598 | Rake 0 
Board [6s 5h Ac]
Seat 2: -showyap- folded before Flop (didn't bet)
Seat 3: macadox-420 (button) folded before Flop (didn't bet)
Seat 4: serzhinho (small blind) folded before Flop
Seat 5: Tobias/Felix (big blind) folded before Flop
Seat 6: Gnourt93 folded before Flop (didn't bet)
Seat 7: TURoff folded before Flop (didn't bet)
Seat 8: h@st@ baby folded on the Flop
Seat 9: jeprip collected (598)





PokerStars Hand #177193539567: Tournament #2067822782, $1.00+$0.10 USD Hold'em No Limit - Level II (20/40) - 2017/10/21 19:06:35 CUST [2017/10/21 11:06:35 ET]
Table '2067822782 23' 9-max Seat #4 is the button
Seat 1: Hawayman71 (3000 in chips) 
Seat 2: -showyap- (3520 in chips) 
Seat 3: macadox-420 (3380 in chips) 
Seat 4: serzhinho (3217 in chips) 
Seat 5: Tobias/Felix (1167 in chips) 
Seat 6: Gnourt93 (3041 in chips) 
Seat 7: TURoff (2890 in chips) 
Seat 8: h@st@ baby (5216 in chips) 
Seat 9: jeprip (3214 in chips) 
Hawayman71: posts the ante 5
-showyap-: posts the ante 5
macadox-420: posts the ante 5
serzhinho: posts the ante 5
Tobias/Felix: posts the ante 5
Gnourt93: posts the ante 5
TURoff: posts the ante 5
h@st@ baby: posts the ante 5
jeprip: posts the ante 5
Tobias/Felix: posts small blind 20
Gnourt93: posts big blind 40
*** HOLE CARDS ***
Dealt to TURoff [9d 9h]
TURoff: raises 80 to 120
h@st@ baby: folds 
jeprip: calls 120
Hawayman71: folds 
-showyap-: calls 120
macadox-420: calls 120
serzhinho: folds 
Tobias/Felix: folds 
Gnourt93: calls 80
*** FLOP *** [7h Kh Th]
Gnourt93: checks 
TURoff: checks 
jeprip: bets 700
-showyap-: folds 
macadox-420: raises 2555 to 3255 and is all-in
Gnourt93: folds 
TURoff: folds 
jeprip: folds 
Uncalled bet (2555) returned to macadox-420
macadox-420 collected 2065 from pot
macadox-420: doesn't show hand 
*** SUMMARY ***
Total pot 2065 | Rake 0 
Board [7h Kh Th]
Seat 1: Hawayman71 folded before Flop (didn't bet)
Seat 2: -showyap- folded on the Flop
Seat 3: macadox-420 collected (2065)
Seat 4: serzhinho (button) folded before Flop (didn't bet)
Seat 5: Tobias/Felix (small blind) folded before Flop
Seat 6: Gnourt93 (big blind) folded on the Flop
Seat 7: TURoff folded on the Flop
Seat 8: h@st@ baby folded before Flop (didn't bet)
Seat 9: jeprip folded on the Flop





PokerStars Hand #177193595532: Tournament #2067822782, $1.00+$0.10 USD Hold'em No Limit - Level III (25/50) - 2017/10/21 19:07:52 CUST [2017/10/21 11:07:52 ET]
Table '2067822782 23' 9-max Seat #5 is the button
Seat 1: Hawayman71 (2995 in chips) 
Seat 2: -showyap- (3395 in chips) 
Seat 3: macadox-420 (4620 in chips) 
Seat 4: serzhinho (3212 in chips) 
Seat 5: Tobias/Felix (1142 in chips) 
Seat 6: Gnourt93 (2916 in chips) 
Seat 7: TURoff (2765 in chips) 
Seat 8: h@st@ baby (5211 in chips) 
Seat 9: jeprip (2389 in chips) 
Hawayman71: posts the ante 6
-showyap-: posts the ante 6
macadox-420: posts the ante 6
serzhinho: posts the ante 6
Tobias/Felix: posts the ante 6
Gnourt93: posts the ante 6
TURoff: posts the ante 6
h@st@ baby: posts the ante 6
jeprip: posts the ante 6
Gnourt93: posts small blind 25
TURoff: posts big blind 50
*** HOLE CARDS ***
Dealt to TURoff [Jh 5d]
h@st@ baby: folds 
jeprip: folds 
Hawayman71: folds 
-showyap-: raises 50 to 100
macadox-420: folds 
serzhinho: folds 
Tobias/Felix: folds 
Gnourt93: folds 
TURoff: folds 
Uncalled bet (50) returned to -showyap-
-showyap- collected 179 from pot
-showyap-: doesn't show hand 
*** SUMMARY ***
Total pot 179 | Rake 0 
Seat 1: Hawayman71 folded before Flop (didn't bet)
Seat 2: -showyap- collected (179)
Seat 3: macadox-420 folded before Flop (didn't bet)
Seat 4: serzhinho folded before Flop (didn't bet)
Seat 5: Tobias/Felix (button) folded before Flop (didn't bet)
Seat 6: Gnourt93 (small blind) folded before Flop
Seat 7: TURoff (big blind) folded before Flop
Seat 8: h@st@ baby folded before Flop (didn't bet)
Seat 9: jeprip folded before Flop (didn't bet)





PokerStars Hand #177193612579: Tournament #2067822782, $1.00+$0.10 USD Hold'em No Limit - Level III (25/50) - 2017/10/21 19:08:18 CUST [2017/10/21 11:08:18 ET]
Table '2067822782 23' 9-max Seat #6 is the button
Seat 1: Hawayman71 (2989 in chips) 
Seat 2: -showyap- (3518 in chips) 
Seat 3: macadox-420 (4614 in chips) 
Seat 4: serzhinho (3206 in chips) 
Seat 5: Tobias/Felix (1136 in chips) 
Seat 6: Gnourt93 (2885 in chips) 
Seat 7: TURoff (2709 in chips) 
Seat 8: h@st@ baby (5205 in chips) 
Seat 9: jeprip (2383 in chips) 
Hawayman71: posts the ante 6
-showyap-: posts the ante 6
macadox-420: posts the ante 6
serzhinho: posts the ante 6
Tobias/Felix: posts the ante 6
Gnourt93: posts the ante 6
TURoff: posts the ante 6
h@st@ baby: posts the ante 6
jeprip: posts the ante 6
TURoff: posts small blind 25
h@st@ baby: posts big blind 50
*** HOLE CARDS ***
Dealt to TURoff [9c Qd]
jeprip: calls 50
Hawayman71: folds 
-showyap-: calls 50
macadox-420: calls 50
serzhinho: folds 
Tobias/Felix: calls 50
Gnourt93: folds 
TURoff: calls 25
h@st@ baby: checks 
*** FLOP *** [2d Jc Jh]
TURoff: checks 
h@st@ baby: checks 
jeprip: bets 300
-showyap-: folds 
macadox-420: folds 
Tobias/Felix: folds 
TURoff: folds 
h@st@ baby: folds 
Uncalled bet (300) returned to jeprip
jeprip collected 354 from pot
*** SUMMARY ***
Total pot 354 | Rake 0 
Board [2d Jc Jh]
Seat 1: Hawayman71 folded before Flop (didn't bet)
Seat 2: -showyap- folded on the Flop
Seat 3: macadox-420 folded on the Flop
Seat 4: serzhinho folded before Flop (didn't bet)
Seat 5: Tobias/Felix folded on the Flop
Seat 6: Gnourt93 (button) folded before Flop (didn't bet)
Seat 7: TURoff (small blind) folded on the Flop
Seat 8: h@st@ baby (big blind) folded on the Flop
Seat 9: jeprip collected (354)





PokerStars Hand #177193656962: Tournament #2067822782, $1.00+$0.10 USD Hold'em No Limit - Level III (25/50) - 2017/10/21 19:09:28 CUST [2017/10/21 11:09:28 ET]
Table '2067822782 23' 9-max Seat #7 is the button
Seat 1: Hawayman71 (2983 in chips) 
Seat 2: -showyap- (3462 in chips) 
Seat 3: macadox-420 (4558 in chips) 
Seat 4: serzhinho (3200 in chips) 
Seat 5: Tobias/Felix (1080 in chips) 
Seat 6: Gnourt93 (2879 in chips) 
Seat 7: TURoff (2653 in chips) 
Seat 8: h@st@ baby (5149 in chips) 
Seat 9: jeprip (2681 in chips) 
Hawayman71: posts the ante 6
-showyap-: posts the ante 6
macadox-420: posts the ante 6
serzhinho: posts the ante 6
Tobias/Felix: posts the ante 6
Gnourt93: posts the ante 6
TURoff: posts the ante 6
h@st@ baby: posts the ante 6
jeprip: posts the ante 6
h@st@ baby: posts small blind 25
jeprip: posts big blind 50
*** HOLE CARDS ***
Dealt to TURoff [5s Jd]
Hawayman71: raises 50 to 100
-showyap-: folds 
macadox-420: folds 
serzhinho: calls 100
Tobias/Felix: folds 
Gnourt93: folds 
TURoff: folds 
h@st@ baby: calls 75
jeprip: calls 50
*** FLOP *** [2h 9h 4s]
h@st@ baby: checks 
jeprip: checks 
Hawayman71: checks 
serzhinho: checks 
*** TURN *** [2h 9h 4s] [Qh]
h@st@ baby: checks 
jeprip: checks 
Hawayman71: bets 227
serzhinho: raises 448 to 675
h@st@ baby: folds 
jeprip: folds 
Hawayman71: folds 
Uncalled bet (448) returned to serzhinho
serzhinho collected 908 from pot
serzhinho: doesn't show hand 
*** SUMMARY ***
Total pot 908 | Rake 0 
Board [2h 9h 4s Qh]
Seat 1: Hawayman71 folded on the Turn
Seat 2: -showyap- folded before Flop (didn't bet)
Seat 3: macadox-420 folded before Flop (didn't bet)
Seat 4: serzhinho collected (908)
Seat 5: Tobias/Felix folded before Flop (didn't bet)
Seat 6: Gnourt93 folded before Flop (didn't bet)
Seat 7: TURoff (button) folded before Flop (didn't bet)
Seat 8: h@st@ baby (small blind) folded on the Turn
Seat 9: jeprip (big blind) folded on the Turn





PokerStars Hand #177193718144: Tournament #2067822782, $1.00+$0.10 USD Hold'em No Limit - Level III (25/50) - 2017/10/21 19:11:06 CUST [2017/10/21 11:11:06 ET]
Table '2067822782 23' 9-max Seat #8 is the button
Seat 1: Hawayman71 (2650 in chips) 
Seat 2: -showyap- (3456 in chips) 
Seat 3: macadox-420 (4552 in chips) 
Seat 4: serzhinho (3775 in chips) 
Seat 5: Tobias/Felix (1074 in chips) 
Seat 6: Gnourt93 (2873 in chips) 
Seat 7: TURoff (2647 in chips) 
Seat 8: h@st@ baby (5043 in chips) 
Seat 9: jeprip (2575 in chips) 
Hawayman71: posts the ante 6
-showyap-: posts the ante 6
macadox-420: posts the ante 6
serzhinho: posts the ante 6
Tobias/Felix: posts the ante 6
Gnourt93: posts the ante 6
TURoff: posts the ante 6
h@st@ baby: posts the ante 6
jeprip: posts the ante 6
jeprip: posts small blind 25
Hawayman71: posts big blind 50
*** HOLE CARDS ***
Dealt to TURoff [4d 8d]
-showyap-: folds 
macadox-420: folds 
serzhinho: folds 
Tobias/Felix: folds 
Gnourt93: folds 
TURoff has timed out
TURoff: folds 
TURoff is sitting out
TURoff has returned
h@st@ baby: folds 
jeprip: calls 25
Hawayman71: checks 
*** FLOP *** [4c 8h 8c]
jeprip: checks 
Hawayman71: bets 50
jeprip: calls 50
*** TURN *** [4c 8h 8c] [Ah]
jeprip: checks 
Hawayman71: bets 150
jeprip: folds 
Uncalled bet (150) returned to Hawayman71
Hawayman71 collected 254 from pot
*** SUMMARY ***
Total pot 254 | Rake 0 
Board [4c 8h 8c Ah]
Seat 1: Hawayman71 (big blind) collected (254)
Seat 2: -showyap- folded before Flop (didn't bet)
Seat 3: macadox-420 folded before Flop (didn't bet)
Seat 4: serzhinho folded before Flop (didn't bet)
Seat 5: Tobias/Felix folded before Flop (didn't bet)
Seat 6: Gnourt93 folded before Flop (didn't bet)
Seat 7: TURoff folded before Flop (didn't bet)
Seat 8: h@st@ baby (button) folded before Flop (didn't bet)
Seat 9: jeprip (small blind) folded on the Turn





PokerStars Hand #177193769202: Tournament #2067822782, $1.00+$0.10 USD Hold'em No Limit - Level III (25/50) - 2017/10/21 19:12:27 CUST [2017/10/21 11:12:27 ET]
Table '2067822782 23' 9-max Seat #9 is the button
Seat 1: Hawayman71 (2798 in chips) 
Seat 2: -showyap- (3450 in chips) 
Seat 3: macadox-420 (4546 in chips) 
Seat 4: serzhinho (3769 in chips) 
Seat 5: Tobias/Felix (1068 in chips) 
Seat 6: Gnourt93 (2867 in chips) 
Seat 7: TURoff (2641 in chips) 
Seat 8: h@st@ baby (5037 in chips) 
Seat 9: jeprip (2469 in chips) 
Hawayman71: posts the ante 6
-showyap-: posts the ante 6
macadox-420: posts the ante 6
serzhinho: posts the ante 6
Tobias/Felix: posts the ante 6
Gnourt93: posts the ante 6
TURoff: posts the ante 6
h@st@ baby: posts the ante 6
jeprip: posts the ante 6
Hawayman71: posts small blind 25
-showyap-: posts big blind 50
*** HOLE CARDS ***
Dealt to TURoff [Ks 5s]
macadox-420: calls 50
serzhinho: folds 
Tobias/Felix: folds 
Gnourt93: folds 
TURoff: folds 
h@st@ baby: calls 50
jeprip: raises 100 to 150
Hawayman71: folds 
-showyap-: calls 100
macadox-420: calls 100
h@st@ baby: folds 
*** FLOP *** [Kc 6d 7s]
-showyap-: bets 100
macadox-420: folds 
jeprip: raises 300 to 400
-showyap-: raises 2894 to 3294 and is all-in
jeprip: folds 
Uncalled bet (2894) returned to -showyap-
-showyap- collected 1379 from pot
-showyap-: doesn't show hand 
*** SUMMARY ***
Total pot 1379 | Rake 0 
Board [Kc 6d 7s]
Seat 1: Hawayman71 (small blind) folded before Flop
Seat 2: -showyap- (big blind) collected (1379)
Seat 3: macadox-420 folded on the Flop
Seat 4: serzhinho folded before Flop (didn't bet)
Seat 5: Tobias/Felix folded before Flop (didn't bet)
Seat 6: Gnourt93 folded before Flop (didn't bet)
Seat 7: TURoff folded before Flop (didn't bet)
Seat 8: h@st@ baby folded before Flop
Seat 9: jeprip (button) folded on the Flop





PokerStars Hand #177193812170: Tournament #2067822782, $1.00+$0.10 USD Hold'em No Limit - Level III (25/50) - 2017/10/21 19:13:36 CUST [2017/10/21 11:13:36 ET]
Table '2067822782 23' 9-max Seat #1 is the button
Seat 1: Hawayman71 (2767 in chips) 
Seat 2: -showyap- (4273 in chips) 
Seat 3: macadox-420 (4390 in chips) 
Seat 4: serzhinho (3763 in chips) 
Seat 5: Tobias/Felix (1062 in chips) 
Seat 6: Gnourt93 (2861 in chips) 
Seat 7: TURoff (2635 in chips) 
Seat 8: h@st@ baby (4981 in chips) 
Seat 9: jeprip (1913 in chips) 
Hawayman71: posts the ante 6
-showyap-: posts the ante 6
macadox-420: posts the ante 6
serzhinho: posts the ante 6
Tobias/Felix: posts the ante 6
Gnourt93: posts the ante 6
TURoff: posts the ante 6
h@st@ baby: posts the ante 6
jeprip: posts the ante 6
-showyap-: posts small blind 25
macadox-420: posts big blind 50
*** HOLE CARDS ***
Dealt to TURoff [9h 6c]
serzhinho: folds 
Tobias/Felix: folds 
Gnourt93: folds 
TURoff: folds 
h@st@ baby: folds 
jeprip: folds 
Hawayman71: raises 50 to 100
-showyap-: folds 
macadox-420: calls 50
*** FLOP *** [Kc 9s 5d]
macadox-420: checks 
Hawayman71: checks 
*** TURN *** [Kc 9s 5d] [7d]
macadox-420: checks 
Hawayman71: checks 
*** RIVER *** [Kc 9s 5d 7d] [2d]
macadox-420: checks 
Hawayman71: checks 
*** SHOW DOWN ***
macadox-420: shows [Qc 8h] (high card King)
Hawayman71: shows [4c Ah] (high card Ace)
Hawayman71 collected 279 from pot
*** SUMMARY ***
Total pot 279 | Rake 0 
Board [Kc 9s 5d 7d 2d]
Seat 1: Hawayman71 (button) showed [4c Ah] and won (279) with high card Ace
Seat 2: -showyap- (small blind) folded before Flop
Seat 3: macadox-420 (big blind) showed [Qc 8h] and lost with high card King
Seat 4: serzhinho folded before Flop (didn't bet)
Seat 5: Tobias/Felix folded before Flop (didn't bet)
Seat 6: Gnourt93 folded before Flop (didn't bet)
Seat 7: TURoff folded before Flop (didn't bet)
Seat 8: h@st@ baby folded before Flop (didn't bet)
Seat 9: jeprip folded before Flop (didn't bet)





PokerStars Hand #177193859869: Tournament #2067822782, $1.00+$0.10 USD Hold'em No Limit - Level III (25/50) - 2017/10/21 19:14:51 CUST [2017/10/21 11:14:51 ET]
Table '2067822782 23' 9-max Seat #2 is the button
Seat 1: Hawayman71 (2940 in chips) 
Seat 2: -showyap- (4242 in chips) 
Seat 3: macadox-420 (4284 in chips) 
Seat 4: serzhinho (3757 in chips) 
Seat 5: Tobias/Felix (1056 in chips) 
Seat 6: Gnourt93 (2855 in chips) 
Seat 7: TURoff (2629 in chips) 
Seat 8: h@st@ baby (4975 in chips) 
Seat 9: jeprip (1907 in chips) 
Hawayman71: posts the ante 6
-showyap-: posts the ante 6
macadox-420: posts the ante 6
serzhinho: posts the ante 6
Tobias/Felix: posts the ante 6
Gnourt93: posts the ante 6
TURoff: posts the ante 6
h@st@ baby: posts the ante 6
jeprip: posts the ante 6
macadox-420: posts small blind 25
serzhinho: posts big blind 50
*** HOLE CARDS ***
Dealt to TURoff [9h Ac]
Tobias/Felix: calls 50
Gnourt93: calls 50
TURoff: folds 
h@st@ baby: folds 
jeprip: folds 
Hawayman71: raises 50 to 100
-showyap-: raises 700 to 800
macadox-420: folds 
serzhinho: folds 
Tobias/Felix: folds 
Gnourt93: raises 2049 to 2849 and is all-in
Hawayman71: folds 
-showyap-: calls 2049
*** FLOP *** [Jd Ts 3s]
*** TURN *** [Jd Ts 3s] [9d]
*** RIVER *** [Jd Ts 3s 9d] [6c]
*** SHOW DOWN ***
Gnourt93: shows [Kd Kh] (a pair of Kings)
-showyap-: shows [Ks Ad] (high card Ace)
Gnourt93 collected 5977 from pot
*** SUMMARY ***
Total pot 5977 | Rake 0 
Board [Jd Ts 3s 9d 6c]
Seat 1: Hawayman71 folded before Flop
Seat 2: -showyap- (button) showed [Ks Ad] and lost with high card Ace
Seat 3: macadox-420 (small blind) folded before Flop
Seat 4: serzhinho (big blind) folded before Flop
Seat 5: Tobias/Felix folded before Flop
Seat 6: Gnourt93 showed [Kd Kh] and won (5977) with a pair of Kings
Seat 7: TURoff folded before Flop (didn't bet)
Seat 8: h@st@ baby folded before Flop (didn't bet)
Seat 9: jeprip folded before Flop (didn't bet)





PokerStars Hand #177193902370: Tournament #2067822782, $1.00+$0.10 USD Hold'em No Limit - Level III (25/50) - 2017/10/21 19:15:58 CUST [2017/10/21 11:15:58 ET]
Table '2067822782 23' 9-max Seat #3 is the button
Seat 1: Hawayman71 (2834 in chips) 
Seat 2: -showyap- (1387 in chips) 
Seat 3: macadox-420 (4253 in chips) 
Seat 4: serzhinho (3701 in chips) 
Seat 5: Tobias/Felix (1000 in chips) 
Seat 6: Gnourt93 (5977 in chips) 
Seat 7: TURoff (2623 in chips) 
Seat 8: h@st@ baby (4969 in chips) 
Seat 9: jeprip (1901 in chips) 
Hawayman71: posts the ante 6
-showyap-: posts the ante 6
macadox-420: posts the ante 6
serzhinho: posts the ante 6
Tobias/Felix: posts the ante 6
Gnourt93: posts the ante 6
TURoff: posts the ante 6
h@st@ baby: posts the ante 6
jeprip: posts the ante 6
serzhinho: posts small blind 25
Tobias/Felix: posts big blind 50
*** HOLE CARDS ***
Dealt to TURoff [2s Kd]
Gnourt93: folds 
TURoff: folds 
h@st@ baby: folds 
jeprip: calls 50
Hawayman71: calls 50
-showyap-: folds 
macadox-420: calls 50
serzhinho: calls 25
Tobias/Felix: checks 
*** FLOP *** [8s 4c 6d]
serzhinho: checks 
Tobias/Felix: bets 50
jeprip: calls 50
Hawayman71: folds 
macadox-420: raises 250 to 300
serzhinho: folds 
Tobias/Felix: calls 250
jeprip: calls 250
*** TURN *** [8s 4c 6d] [9s]
Tobias/Felix: checks 
jeprip: checks 
macadox-420: checks 
*** RIVER *** [8s 4c 6d 9s] [3h]
Tobias/Felix: checks 
jeprip: checks 
macadox-420: checks 
*** SHOW DOWN ***
Tobias/Felix: shows [8c Tc] (a pair of Eights)
jeprip: mucks hand 
macadox-420: mucks hand 
Tobias/Felix collected 1204 from pot
*** SUMMARY ***
Total pot 1204 | Rake 0 
Board [8s 4c 6d 9s 3h]
Seat 1: Hawayman71 folded on the Flop
Seat 2: -showyap- folded before Flop (didn't bet)
Seat 3: macadox-420 (button) mucked [7c 6c]
Seat 4: serzhinho (small blind) folded on the Flop
Seat 5: Tobias/Felix (big blind) showed [8c Tc] and won (1204) with a pair of Eights
Seat 6: Gnourt93 folded before Flop (didn't bet)
Seat 7: TURoff folded before Flop (didn't bet)
Seat 8: h@st@ baby folded before Flop (didn't bet)
Seat 9: jeprip mucked [Kc 4d]





PokerStars Hand #177193973389: Tournament #2067822782, $1.00+$0.10 USD Hold'em No Limit - Level IV (30/60) - 2017/10/21 19:17:49 CUST [2017/10/21 11:17:49 ET]
Table '2067822782 23' 9-max Seat #4 is the button
Seat 1: Hawayman71 (2778 in chips) 
Seat 2: -showyap- (1381 in chips) 
Seat 3: macadox-420 (3897 in chips) 
Seat 4: serzhinho (3645 in chips) 
Seat 5: Tobias/Felix (1848 in chips) 
Seat 6: Gnourt93 (5971 in chips) 
Seat 7: TURoff (2617 in chips) 
Seat 8: h@st@ baby (4963 in chips) 
Seat 9: jeprip (1545 in chips) 
Hawayman71: posts the ante 7
-showyap-: posts the ante 7
macadox-420: posts the ante 7
serzhinho: posts the ante 7
Tobias/Felix: posts the ante 7
Gnourt93: posts the ante 7
TURoff: posts the ante 7
h@st@ baby: posts the ante 7
jeprip: posts the ante 7
Tobias/Felix: posts small blind 30
Gnourt93: posts big blind 60
*** HOLE CARDS ***
Dealt to TURoff [Ks 2d]
TURoff: folds 
h@st@ baby: folds 
jeprip: calls 60
Hawayman71: raises 120 to 180
-showyap-: raises 1194 to 1374 and is all-in
macadox-420: folds 
serzhinho: folds 
Tobias/Felix: folds 
Gnourt93: folds 
jeprip: calls 1314
Hawayman71: calls 1194
*** FLOP *** [6d Th 3s]
jeprip: bets 164 and is all-in
Hawayman71: calls 164
*** TURN *** [6d Th 3s] [Jc]
*** RIVER *** [6d Th 3s Jc] [4d]
*** SHOW DOWN ***
jeprip: shows [3c 3h] (three of a kind, Threes)
Hawayman71: shows [8d 8c] (a pair of Eights)
jeprip collected 328 from side pot
-showyap-: shows [Kc Qs] (high card King)
jeprip collected 4275 from main pot
-showyap- finished the tournament
*** SUMMARY ***
Total pot 4603 Main pot 4275. Side pot 328. | Rake 0 
Board [6d Th 3s Jc 4d]
Seat 1: Hawayman71 showed [8d 8c] and lost with a pair of Eights
Seat 2: -showyap- showed [Kc Qs] and lost with high card King
Seat 3: macadox-420 folded before Flop (didn't bet)
Seat 4: serzhinho (button) folded before Flop (didn't bet)
Seat 5: Tobias/Felix (small blind) folded before Flop
Seat 6: Gnourt93 (big blind) folded before Flop
Seat 7: TURoff folded before Flop (didn't bet)
Seat 8: h@st@ baby folded before Flop (didn't bet)
Seat 9: jeprip showed [3c 3h] and won (4603) with three of a kind, Threes





PokerStars Hand #177194011362: Tournament #2067822782, $1.00+$0.10 USD Hold'em No Limit - Level IV (30/60) - 2017/10/21 19:18:49 CUST [2017/10/21 11:18:49 ET]
Table '2067822782 23' 9-max Seat #5 is the button
Seat 1: Hawayman71 (1233 in chips) 
Seat 3: macadox-420 (3890 in chips) 
Seat 4: serzhinho (3638 in chips) 
Seat 5: Tobias/Felix (1811 in chips) 
Seat 6: Gnourt93 (5904 in chips) 
Seat 7: TURoff (2610 in chips) 
Seat 8: h@st@ baby (4956 in chips) 
Seat 9: jeprip (4603 in chips) 
Hawayman71: posts the ante 7
macadox-420: posts the ante 7
serzhinho: posts the ante 7
Tobias/Felix: posts the ante 7
Gnourt93: posts the ante 7
TURoff: posts the ante 7
h@st@ baby: posts the ante 7
jeprip: posts the ante 7
Gnourt93: posts small blind 30
TURoff: posts big blind 60
*** HOLE CARDS ***
Dealt to TURoff [2c Qh]
h@st@ baby: folds 
jeprip: raises 2240 to 2300
Hawayman71: folds 
macadox-420: folds 
serzhinho: folds 
Tobias/Felix: folds 
Gnourt93: folds 
TURoff: folds 
Uncalled bet (2240) returned to jeprip
jeprip collected 206 from pot
*** SUMMARY ***
Total pot 206 | Rake 0 
Seat 1: Hawayman71 folded before Flop (didn't bet)
Seat 3: macadox-420 folded before Flop (didn't bet)
Seat 4: serzhinho folded before Flop (didn't bet)
Seat 5: Tobias/Felix (button) folded before Flop (didn't bet)
Seat 6: Gnourt93 (small blind) folded before Flop
Seat 7: TURoff (big blind) folded before Flop
Seat 8: h@st@ baby folded before Flop (didn't bet)
Seat 9: jeprip collected (206)





PokerStars Hand #177194029890: Tournament #2067822782, $1.00+$0.10 USD Hold'em No Limit - Level IV (30/60) - 2017/10/21 19:19:18 CUST [2017/10/21 11:19:18 ET]
Table '2067822782 23' 9-max Seat #6 is the button
Seat 1: Hawayman71 (1226 in chips) 
Seat 2: fechter70 (3000 in chips) 
Seat 3: macadox-420 (3883 in chips) 
Seat 4: serzhinho (3631 in chips) 
Seat 5: Tobias/Felix (1804 in chips) 
Seat 6: Gnourt93 (5867 in chips) 
Seat 7: TURoff (2543 in chips) 
Seat 8: h@st@ baby (4949 in chips) 
Seat 9: jeprip (4742 in chips) 
Hawayman71: posts the ante 7
fechter70: posts the ante 7
macadox-420: posts the ante 7
serzhinho: posts the ante 7
Tobias/Felix: posts the ante 7
Gnourt93: posts the ante 7
TURoff: posts the ante 7
h@st@ baby: posts the ante 7
jeprip: posts the ante 7
TURoff: posts small blind 30
h@st@ baby: posts big blind 60
*** HOLE CARDS ***
Dealt to TURoff [4s 6d]
jeprip: folds 
Hawayman71: raises 60 to 120
fechter70: folds 
macadox-420: folds 
serzhinho: folds 
Tobias/Felix: folds 
Gnourt93: folds 
TURoff: folds 
h@st@ baby: calls 60
*** FLOP *** [8d Js 2d]
h@st@ baby: bets 167
Hawayman71: raises 932 to 1099 and is all-in
h@st@ baby: calls 932
*** TURN *** [8d Js 2d] [Ad]
*** RIVER *** [8d Js 2d Ad] [As]
*** SHOW DOWN ***
h@st@ baby: shows [6c Jc] (two pair, Aces and Jacks)
Hawayman71: shows [3c 2c] (two pair, Aces and Deuces)
h@st@ baby collected 2531 from pot
Hawayman71 finished the tournament
*** SUMMARY ***
Total pot 2531 | Rake 0 
Board [8d Js 2d Ad As]
Seat 1: Hawayman71 showed [3c 2c] and lost with two pair, Aces and Deuces
Seat 2: fechter70 folded before Flop (didn't bet)
Seat 3: macadox-420 folded before Flop (didn't bet)
Seat 4: serzhinho folded before Flop (didn't bet)
Seat 5: Tobias/Felix folded before Flop (didn't bet)
Seat 6: Gnourt93 (button) folded before Flop (didn't bet)
Seat 7: TURoff (small blind) folded before Flop
Seat 8: h@st@ baby (big blind) showed [6c Jc] and won (2531) with two pair, Aces and Jacks
Seat 9: jeprip folded before Flop (didn't bet)





PokerStars Hand #177194065554: Tournament #2067822782, $1.00+$0.10 USD Hold'em No Limit - Level IV (30/60) - 2017/10/21 19:20:13 CUST [2017/10/21 11:20:13 ET]
Table '2067822782 23' 9-max Seat #7 is the button
Seat 2: fechter70 (2993 in chips) 
Seat 3: macadox-420 (3876 in chips) 
Seat 4: serzhinho (3624 in chips) 
Seat 5: Tobias/Felix (1797 in chips) 
Seat 6: Gnourt93 (5860 in chips) 
Seat 7: TURoff (2506 in chips) 
Seat 8: h@st@ baby (6254 in chips) 
Seat 9: jeprip (4735 in chips) 
fechter70: posts the ante 7
macadox-420: posts the ante 7
serzhinho: posts the ante 7
Tobias/Felix: posts the ante 7
Gnourt93: posts the ante 7
TURoff: posts the ante 7
h@st@ baby: posts the ante 7
jeprip: posts the ante 7
h@st@ baby: posts small blind 30
jeprip: posts big blind 60
*** HOLE CARDS ***
Dealt to TURoff [Qd Qh]
fechter70: folds 
macadox-420: raises 85 to 145
serzhinho: folds 
Tobias/Felix: folds 
Gnourt93: folds 
TURoff: raises 2354 to 2499 and is all-in
h@st@ baby: folds 
jeprip: folds 
macadox-420: folds 
Uncalled bet (2354) returned to TURoff
TURoff collected 436 from pot
TURoff: doesn't show hand 
*** SUMMARY ***
Total pot 436 | Rake 0 
Seat 2: fechter70 folded before Flop (didn't bet)
Seat 3: macadox-420 folded before Flop
Seat 4: serzhinho folded before Flop (didn't bet)
Seat 5: Tobias/Felix folded before Flop (didn't bet)
Seat 6: Gnourt93 folded before Flop (didn't bet)
Seat 7: TURoff (button) collected (436)
Seat 8: h@st@ baby (small blind) folded before Flop
Seat 9: jeprip (big blind) folded before Flop





PokerStars Hand #177194084077: Tournament #2067822782, $1.00+$0.10 USD Hold'em No Limit - Level IV (30/60) - 2017/10/21 19:20:42 CUST [2017/10/21 11:20:42 ET]
Table '2067822782 23' 9-max Seat #8 is the button
Seat 1: Jig@n (3000 in chips) 
Seat 2: fechter70 (2986 in chips) 
Seat 3: macadox-420 (3724 in chips) 
Seat 4: serzhinho (3617 in chips) 
Seat 5: Tobias/Felix (1790 in chips) 
Seat 6: Gnourt93 (5853 in chips) 
Seat 7: TURoff (2790 in chips) 
Seat 8: h@st@ baby (6217 in chips) 
Seat 9: jeprip (4668 in chips) 
Jig@n: posts the ante 7
fechter70: posts the ante 7
macadox-420: posts the ante 7
serzhinho: posts the ante 7
Tobias/Felix: posts the ante 7
Gnourt93: posts the ante 7
TURoff: posts the ante 7
h@st@ baby: posts the ante 7
jeprip: posts the ante 7
jeprip: posts small blind 30
Jig@n: posts big blind 60
*** HOLE CARDS ***
Dealt to TURoff [2h 4s]
fechter70: folds 
macadox-420: folds 
serzhinho: folds 
Tobias/Felix: folds 
Gnourt93: folds 
TURoff: folds 
h@st@ baby: folds 
jeprip: calls 30
Jig@n: raises 120 to 180
jeprip: calls 120
*** FLOP *** [Ts Qd 8h]
jeprip: checks 
Jig@n: bets 240
jeprip: calls 240
*** TURN *** [Ts Qd 8h] [5d]
jeprip: checks 
Jig@n: bets 600
jeprip: calls 600
*** RIVER *** [Ts Qd 8h 5d] [7c]
jeprip: checks 
Jig@n: checks 
*** SHOW DOWN ***
jeprip: shows [Kh Jh] (high card King)
Jig@n: shows [Kd Ks] (a pair of Kings)
Jig@n collected 2103 from pot
*** SUMMARY ***
Total pot 2103 | Rake 0 
Board [Ts Qd 8h 5d 7c]
Seat 1: Jig@n (big blind) showed [Kd Ks] and won (2103) with a pair of Kings
Seat 2: fechter70 folded before Flop (didn't bet)
Seat 3: macadox-420 folded before Flop (didn't bet)
Seat 4: serzhinho folded before Flop (didn't bet)
Seat 5: Tobias/Felix folded before Flop (didn't bet)
Seat 6: Gnourt93 folded before Flop (didn't bet)
Seat 7: TURoff folded before Flop (didn't bet)
Seat 8: h@st@ baby (button) folded before Flop (didn't bet)
Seat 9: jeprip (small blind) showed [Kh Jh] and lost with high card King





PokerStars Hand #177194123746: Tournament #2067822782, $1.00+$0.10 USD Hold'em No Limit - Level IV (30/60) - 2017/10/21 19:21:44 CUST [2017/10/21 11:21:44 ET]
Table '2067822782 23' 9-max Seat #9 is the button
Seat 1: Jig@n (4076 in chips) 
Seat 2: fechter70 (2979 in chips) 
Seat 3: macadox-420 (3717 in chips) 
Seat 4: serzhinho (3610 in chips) 
Seat 5: Tobias/Felix (1783 in chips) 
Seat 6: Gnourt93 (5846 in chips) 
Seat 7: TURoff (2783 in chips) 
Seat 8: h@st@ baby (6210 in chips) 
Seat 9: jeprip (3641 in chips) 
Jig@n: posts the ante 7
fechter70: posts the ante 7
macadox-420: posts the ante 7
serzhinho: posts the ante 7
Tobias/Felix: posts the ante 7
Gnourt93: posts the ante 7
TURoff: posts the ante 7
h@st@ baby: posts the ante 7
jeprip: posts the ante 7
Jig@n: posts small blind 30
fechter70: posts big blind 60
*** HOLE CARDS ***
Dealt to TURoff [As 6d]
macadox-420: folds 
serzhinho: folds 
Tobias/Felix: calls 60
Gnourt93: folds 
TURoff: folds 
h@st@ baby: folds 
jeprip: folds 
Jig@n: folds 
fechter70: checks 
*** FLOP *** [7c 8s 7s]
fechter70: checks 
Tobias/Felix: checks 
*** TURN *** [7c 8s 7s] [Td]
fechter70: bets 213
Tobias/Felix: folds 
Uncalled bet (213) returned to fechter70
fechter70 collected 213 from pot
fechter70: doesn't show hand 
*** SUMMARY ***
Total pot 213 | Rake 0 
Board [7c 8s 7s Td]
Seat 1: Jig@n (small blind) folded before Flop
Seat 2: fechter70 (big blind) collected (213)
Seat 3: macadox-420 folded before Flop (didn't bet)
Seat 4: serzhinho folded before Flop (didn't bet)
Seat 5: Tobias/Felix folded on the Turn
Seat 6: Gnourt93 folded before Flop (didn't bet)
Seat 7: TURoff folded before Flop (didn't bet)
Seat 8: h@st@ baby folded before Flop (didn't bet)
Seat 9: jeprip (button) folded before Flop (didn't bet)





PokerStars Hand #177194167821: Tournament #2067822782, $1.00+$0.10 USD Hold'em No Limit - Level IV (30/60) - 2017/10/21 19:22:54 CUST [2017/10/21 11:22:54 ET]
Table '2067822782 23' 9-max Seat #1 is the button
Seat 1: Jig@n (4039 in chips) 
Seat 2: fechter70 (3125 in chips) 
Seat 3: macadox-420 (3710 in chips) 
Seat 4: serzhinho (3603 in chips) 
Seat 5: Tobias/Felix (1716 in chips) 
Seat 6: Gnourt93 (5839 in chips) 
Seat 7: TURoff (2776 in chips) 
Seat 8: h@st@ baby (6203 in chips) 
Seat 9: jeprip (3634 in chips) 
Jig@n: posts the ante 7
fechter70: posts the ante 7
macadox-420: posts the ante 7
serzhinho: posts the ante 7
Tobias/Felix: posts the ante 7
Gnourt93: posts the ante 7
TURoff: posts the ante 7
h@st@ baby: posts the ante 7
jeprip: posts the ante 7
fechter70: posts small blind 30
macadox-420: posts big blind 60
*** HOLE CARDS ***
Dealt to TURoff [4d 3h]
serzhinho: folds 
Tobias/Felix: folds 
Gnourt93: folds 
TURoff: folds 
h@st@ baby: folds 
jeprip: calls 60
Jig@n: raises 162 to 222
fechter70: folds 
macadox-420: calls 162
jeprip: calls 162
*** FLOP *** [Td Kc 8s]
macadox-420: checks 
jeprip: bets 350
Jig@n: folds 
macadox-420: folds 
Uncalled bet (350) returned to jeprip
jeprip collected 759 from pot
*** SUMMARY ***
Total pot 759 | Rake 0 
Board [Td Kc 8s]
Seat 1: Jig@n (button) folded on the Flop
Seat 2: fechter70 (small blind) folded before Flop
Seat 3: macadox-420 (big blind) folded on the Flop
Seat 4: serzhinho folded before Flop (didn't bet)
Seat 5: Tobias/Felix folded before Flop (didn't bet)
Seat 6: Gnourt93 folded before Flop (didn't bet)
Seat 7: TURoff folded before Flop (didn't bet)
Seat 8: h@st@ baby folded before Flop (didn't bet)
Seat 9: jeprip collected (759)





PokerStars Hand #177194204891: Tournament #2067822782, $1.00+$0.10 USD Hold'em No Limit - Level IV (30/60) - 2017/10/21 19:23:52 CUST [2017/10/21 11:23:52 ET]
Table '2067822782 23' 9-max Seat #2 is the button
Seat 1: Jig@n (3810 in chips) 
Seat 2: fechter70 (3088 in chips) 
Seat 3: macadox-420 (3481 in chips) 
Seat 4: serzhinho (3596 in chips) 
Seat 5: Tobias/Felix (1709 in chips) 
Seat 6: Gnourt93 (5832 in chips) 
Seat 7: TURoff (2769 in chips) 
Seat 8: h@st@ baby (6196 in chips) 
Seat 9: jeprip (4164 in chips) 
Jig@n: posts the ante 7
fechter70: posts the ante 7
macadox-420: posts the ante 7
serzhinho: posts the ante 7
Tobias/Felix: posts the ante 7
Gnourt93: posts the ante 7
TURoff: posts the ante 7
h@st@ baby: posts the ante 7
jeprip: posts the ante 7
macadox-420: posts small blind 30
serzhinho: posts big blind 60
*** HOLE CARDS ***
Dealt to TURoff [Ah 5s]
Tobias/Felix: calls 60
Gnourt93: folds 
TURoff: folds 
h@st@ baby: folds 
jeprip: calls 60
Jig@n: folds 
fechter70: folds 
macadox-420: folds 
serzhinho: checks 
*** FLOP *** [3c 3d 3s]
serzhinho: checks 
Tobias/Felix: checks 
jeprip: checks 
*** TURN *** [3c 3d 3s] [5d]
serzhinho: bets 150
Tobias/Felix: calls 150
jeprip: calls 150
*** RIVER *** [3c 3d 3s 5d] [Qc]
serzhinho: checks 
Tobias/Felix: checks 
jeprip: checks 
*** SHOW DOWN ***
serzhinho: shows [2s 8s] (three of a kind, Threes)
Tobias/Felix: shows [9s Ac] (three of a kind, Threes - Ace kicker)
jeprip: mucks hand 
Tobias/Felix collected 723 from pot
*** SUMMARY ***
Total pot 723 | Rake 0 
Board [3c 3d 3s 5d Qc]
Seat 1: Jig@n folded before Flop (didn't bet)
Seat 2: fechter70 (button) folded before Flop (didn't bet)
Seat 3: macadox-420 (small blind) folded before Flop
Seat 4: serzhinho (big blind) showed [2s 8s] and lost with three of a kind, Threes
Seat 5: Tobias/Felix showed [9s Ac] and won (723) with three of a kind, Threes
Seat 6: Gnourt93 folded before Flop (didn't bet)
Seat 7: TURoff folded before Flop (didn't bet)
Seat 8: h@st@ baby folded before Flop (didn't bet)
Seat 9: jeprip mucked [7c Kh]





PokerStars Hand #177194267634: Tournament #2067822782, $1.00+$0.10 USD Hold'em No Limit - Level IV (30/60) - 2017/10/21 19:25:30 CUST [2017/10/21 11:25:30 ET]
Table '2067822782 23' 9-max Seat #3 is the button
Seat 1: Jig@n (3803 in chips) 
Seat 2: fechter70 (3081 in chips) 
Seat 3: macadox-420 (3444 in chips) 
Seat 4: serzhinho (3379 in chips) 
Seat 5: Tobias/Felix (2215 in chips) 
Seat 6: Gnourt93 (5825 in chips) 
Seat 7: TURoff (2762 in chips) 
Seat 9: jeprip (3947 in chips) 
Jig@n: posts the ante 7
fechter70: posts the ante 7
macadox-420: posts the ante 7
serzhinho: posts the ante 7
Tobias/Felix: posts the ante 7
Gnourt93: posts the ante 7
TURoff: posts the ante 7
jeprip: posts the ante 7
serzhinho: posts small blind 30
Tobias/Felix: posts big blind 60
*** HOLE CARDS ***
Dealt to TURoff [Qh 6c]
Gnourt93: folds 
TURoff: folds 
jeprip: folds 
Jig@n: folds 
fechter70: calls 60
macadox-420: folds 
serzhinho: folds 
Tobias/Felix: checks 
*** FLOP *** [7c 7h Qs]
macadox-420 said, "i flopped quads lol"
Tobias/Felix: checks 
macadox-420 said, "10 3 off"
fechter70: checks 
*** TURN *** [7c 7h Qs] [2s]
Tobias/Felix: checks 
fechter70: checks 
*** RIVER *** [7c 7h Qs 2s] [3s]
Tobias/Felix: checks 
fechter70: checks 
*** SHOW DOWN ***
Tobias/Felix: shows [6d 6s] (two pair, Sevens and Sixes)
fechter70: mucks hand 
Tobias/Felix collected 206 from pot
*** SUMMARY ***
Total pot 206 | Rake 0 
Board [7c 7h Qs 2s 3s]
Seat 1: Jig@n folded before Flop (didn't bet)
Seat 2: fechter70 mucked [Js Th]
Seat 3: macadox-420 (button) folded before Flop (didn't bet)
Seat 4: serzhinho (small blind) folded before Flop
Seat 5: Tobias/Felix (big blind) showed [6d 6s] and won (206) with two pair, Sevens and Sixes
Seat 6: Gnourt93 folded before Flop (didn't bet)
Seat 7: TURoff folded before Flop (didn't bet)
Seat 9: jeprip folded before Flop (didn't bet)





PokerStars Hand #177194288195: Tournament #2067822782, $1.00+$0.10 USD Hold'em No Limit - Level IV (30/60) - 2017/10/21 19:26:03 CUST [2017/10/21 11:26:03 ET]
Table '2067822782 23' 9-max Seat #4 is the button
Seat 1: Jig@n (3796 in chips) 
Seat 2: fechter70 (3014 in chips) 
Seat 3: macadox-420 (3437 in chips) 
Seat 4: serzhinho (3342 in chips) 
Seat 5: Tobias/Felix (2354 in chips) 
Seat 6: Gnourt93 (5818 in chips) 
Seat 7: TURoff (2755 in chips) 
Seat 9: jeprip (3940 in chips) 
Jig@n: posts the ante 7
fechter70: posts the ante 7
macadox-420: posts the ante 7
serzhinho: posts the ante 7
Tobias/Felix: posts the ante 7
Gnourt93: posts the ante 7
TURoff: posts the ante 7
jeprip: posts the ante 7
Tobias/Felix: posts small blind 30
Gnourt93: posts big blind 60
*** HOLE CARDS ***
Dealt to TURoff [Th 2d]
TURoff: folds 
jeprip: folds 
Jig@n: folds 
fechter70: folds 
macadox-420: folds 
serzhinho: folds 
Tobias/Felix: folds 
Uncalled bet (30) returned to Gnourt93
Gnourt93 collected 116 from pot
Gnourt93: doesn't show hand 
*** SUMMARY ***
Total pot 116 | Rake 0 
Seat 1: Jig@n folded before Flop (didn't bet)
Seat 2: fechter70 folded before Flop (didn't bet)
Seat 3: macadox-420 folded before Flop (didn't bet)
Seat 4: serzhinho (button) folded before Flop (didn't bet)
Seat 5: Tobias/Felix (small blind) folded before Flop
Seat 6: Gnourt93 (big blind) collected (116)
Seat 7: TURoff folded before Flop (didn't bet)
Seat 9: jeprip folded before Flop (didn't bet)





PokerStars Hand #177194296975: Tournament #2067822782, $1.00+$0.10 USD Hold'em No Limit - Level IV (30/60) - 2017/10/21 19:26:17 CUST [2017/10/21 11:26:17 ET]
Table '2067822782 23' 9-max Seat #5 is the button
Seat 1: Jig@n (3789 in chips) 
Seat 2: fechter70 (3007 in chips) 
Seat 3: macadox-420 (3430 in chips) 
Seat 4: serzhinho (3335 in chips) 
Seat 5: Tobias/Felix (2317 in chips) 
Seat 6: Gnourt93 (5897 in chips) 
Seat 7: TURoff (2748 in chips) 
Seat 9: jeprip (3933 in chips) 
Jig@n: posts the ante 7
fechter70: posts the ante 7
macadox-420: posts the ante 7
serzhinho: posts the ante 7
Tobias/Felix: posts the ante 7
Gnourt93: posts the ante 7
TURoff: posts the ante 7
jeprip: posts the ante 7
Gnourt93: posts small blind 30
TURoff: posts big blind 60
*** HOLE CARDS ***
Dealt to TURoff [7c 2h]
jeprip: calls 60
Jig@n: raises 120 to 180
fechter70: raises 120 to 300
macadox-420: folds 
serzhinho: folds 
Tobias/Felix: calls 300
Gnourt93: folds 
TURoff: folds 
jeprip: calls 240
Jig@n: calls 120
*** FLOP *** [Qc Js 5s]
jeprip: checks 
Jig@n: checks 
fechter70: checks 
Tobias/Felix: checks 
*** TURN *** [Qc Js 5s] [3s]
jeprip: bets 350
Jig@n: folds 
fechter70: folds 
Tobias/Felix: calls 350
*** RIVER *** [Qc Js 5s 3s] [Qd]
jeprip: bets 350
Tobias/Felix: calls 350
*** SHOW DOWN ***
jeprip: shows [2d Ad] (a pair of Queens)
Tobias/Felix: shows [Ac Ks] (a pair of Queens - Ace+King kicker)
Tobias/Felix collected 2746 from pot
*** SUMMARY ***
Total pot 2746 | Rake 0 
Board [Qc Js 5s 3s Qd]
Seat 1: Jig@n folded on the Turn
Seat 2: fechter70 folded on the Turn
Seat 3: macadox-420 folded before Flop (didn't bet)
Seat 4: serzhinho folded before Flop (didn't bet)
Seat 5: Tobias/Felix (button) showed [Ac Ks] and won (2746) with a pair of Queens
Seat 6: Gnourt93 (small blind) folded before Flop
Seat 7: TURoff (big blind) folded before Flop
Seat 9: jeprip showed [2d Ad] and lost with a pair of Queens





PokerStars Hand #177194355337: Tournament #2067822782, $1.00+$0.10 USD Hold'em No Limit - Level V (40/80) - 2017/10/21 19:27:48 CUST [2017/10/21 11:27:48 ET]
Table '2067822782 23' 9-max Seat #6 is the button
Seat 1: Jig@n (3482 in chips) 
Seat 2: fechter70 (2700 in chips) 
Seat 3: macadox-420 (3423 in chips) 
Seat 4: serzhinho (3328 in chips) 
Seat 5: Tobias/Felix (4056 in chips) 
Seat 6: Gnourt93 (5860 in chips) 
Seat 7: TURoff (2681 in chips) 
Seat 8: A10xST3VE (3000 in chips) 
Seat 9: jeprip (2926 in chips) 
Jig@n: posts the ante 10
fechter70: posts the ante 10
macadox-420: posts the ante 10
serzhinho: posts the ante 10
Tobias/Felix: posts the ante 10
Gnourt93: posts the ante 10
TURoff: posts the ante 10
A10xST3VE: posts the ante 10
jeprip: posts the ante 10
TURoff: posts small blind 40
A10xST3VE: posts big blind 80
*** HOLE CARDS ***
Dealt to TURoff [3c 7c]
jeprip: folds 
Jig@n: raises 80 to 160
fechter70: calls 160
macadox-420: folds 
serzhinho: calls 160
Tobias/Felix: folds 
Gnourt93: folds 
TURoff: calls 120
A10xST3VE: calls 80
*** FLOP *** [2d Kc Jd]
TURoff: checks 
A10xST3VE: checks 
Jig@n: bets 445
fechter70: folds 
serzhinho: calls 445
TURoff: folds 
A10xST3VE: calls 445
*** TURN *** [2d Kc Jd] [5c]
A10xST3VE: checks 
Jig@n: bets 888
serzhinho: folds 
A10xST3VE: raises 1497 to 2385 and is all-in
Jig@n: calls 1497
*** RIVER *** [2d Kc Jd 5c] [Ks]
*** SHOW DOWN ***
A10xST3VE: shows [Td Jh] (two pair, Kings and Jacks)
Jig@n: shows [5s 5h] (a full house, Fives full of Kings)
Jig@n collected 6995 from pot
A10xST3VE finished the tournament
*** SUMMARY ***
Total pot 6995 | Rake 0 
Board [2d Kc Jd 5c Ks]
Seat 1: Jig@n showed [5s 5h] and won (6995) with a full house, Fives full of Kings
Seat 2: fechter70 folded on the Flop
Seat 3: macadox-420 folded before Flop (didn't bet)
Seat 4: serzhinho folded on the Turn
Seat 5: Tobias/Felix folded before Flop (didn't bet)
Seat 6: Gnourt93 (button) folded before Flop (didn't bet)
Seat 7: TURoff (small blind) folded on the Flop
Seat 8: A10xST3VE (big blind) showed [Td Jh] and lost with two pair, Kings and Jacks
Seat 9: jeprip folded before Flop (didn't bet)





PokerStars Hand #177194398773: Tournament #2067822782, $1.00+$0.10 USD Hold'em No Limit - Level V (40/80) - 2017/10/21 19:28:56 CUST [2017/10/21 11:28:56 ET]
Table '2067822782 23' 9-max Seat #7 is the button
Seat 1: Jig@n (7477 in chips) 
Seat 2: fechter70 (2530 in chips) 
Seat 3: macadox-420 (3413 in chips) 
Seat 4: serzhinho (2713 in chips) 
Seat 5: Tobias/Felix (4046 in chips) 
Seat 6: Gnourt93 (5850 in chips) 
Seat 7: TURoff (2511 in chips) 
Seat 9: jeprip (2916 in chips) 
Jig@n: posts the ante 10
fechter70: posts the ante 10
macadox-420: posts the ante 10
serzhinho: posts the ante 10
Tobias/Felix: posts the ante 10
Gnourt93: posts the ante 10
TURoff: posts the ante 10
jeprip: posts the ante 10
jeprip: posts small blind 40
Jig@n: posts big blind 80
*** HOLE CARDS ***
Dealt to TURoff [4h 3h]
fechter70: calls 80
macadox-420: folds 
serzhinho: folds 
Tobias/Felix: folds 
Gnourt93: folds 
TURoff: calls 80
jeprip: calls 40
Jig@n: checks 
*** FLOP *** [Qd 8d Tc]
jeprip: checks 
Jig@n: checks 
fechter70: bets 400
TURoff: folds 
jeprip: folds 
Jig@n: folds 
Uncalled bet (400) returned to fechter70
fechter70 collected 400 from pot
fechter70: doesn't show hand 
*** SUMMARY ***
Total pot 400 | Rake 0 
Board [Qd 8d Tc]
Seat 1: Jig@n (big blind) folded on the Flop
Seat 2: fechter70 collected (400)
Seat 3: macadox-420 folded before Flop (didn't bet)
Seat 4: serzhinho folded before Flop (didn't bet)
Seat 5: Tobias/Felix folded before Flop (didn't bet)
Seat 6: Gnourt93 folded before Flop (didn't bet)
Seat 7: TURoff (button) folded on the Flop
Seat 9: jeprip (small blind) folded on the Flop





PokerStars Hand #177194420937: Tournament #2067822782, $1.00+$0.10 USD Hold'em No Limit - Level V (40/80) - 2017/10/21 19:29:31 CUST [2017/10/21 11:29:31 ET]
Table '2067822782 23' 9-max Seat #9 is the button
Seat 1: Jig@n (7387 in chips) 
Seat 2: fechter70 (2840 in chips) 
Seat 3: macadox-420 (3403 in chips) 
Seat 4: serzhinho (2703 in chips) 
Seat 5: Tobias/Felix (4036 in chips) 
Seat 6: Gnourt93 (5840 in chips) 
Seat 7: TURoff (2421 in chips) 
Seat 8: tomike23111 (3000 in chips) 
Seat 9: jeprip (2826 in chips) 
Jig@n: posts the ante 10
fechter70: posts the ante 10
macadox-420: posts the ante 10
serzhinho: posts the ante 10
Tobias/Felix: posts the ante 10
Gnourt93: posts the ante 10
TURoff: posts the ante 10
tomike23111: posts the ante 10
jeprip: posts the ante 10
Jig@n: posts small blind 40
fechter70: posts big blind 80
*** HOLE CARDS ***
Dealt to TURoff [Ah 4c]
macadox-420: folds 
serzhinho: raises 80 to 160
Tobias/Felix: folds 
Gnourt93: folds 
TURoff: folds 
tomike23111: folds 
jeprip: calls 160
Jig@n: folds 
fechter70: calls 80
*** FLOP *** [Qs 8c 2c]
fechter70: checks 
serzhinho: checks 
jeprip: checks 
*** TURN *** [Qs 8c 2c] [9h]
fechter70: checks 
serzhinho: checks 
jeprip: bets 80
fechter70: calls 80
serzhinho: calls 80
*** RIVER *** [Qs 8c 2c 9h] [3d]
fechter70: checks 
serzhinho: checks 
jeprip: checks 
*** SHOW DOWN ***
fechter70: shows [9d Jc] (a pair of Nines)
serzhinho: mucks hand 
jeprip: mucks hand 
fechter70 collected 850 from pot
*** SUMMARY ***
Total pot 850 | Rake 0 
Board [Qs 8c 2c 9h 3d]
Seat 1: Jig@n (small blind) folded before Flop
Seat 2: fechter70 (big blind) showed [9d Jc] and won (850) with a pair of Nines
Seat 3: macadox-420 folded before Flop (didn't bet)
Seat 4: serzhinho mucked [Ac Td]
Seat 5: Tobias/Felix folded before Flop (didn't bet)
Seat 6: Gnourt93 folded before Flop (didn't bet)
Seat 7: TURoff folded before Flop (didn't bet)
Seat 8: tomike23111 folded before Flop (didn't bet)
Seat 9: jeprip (button) mucked [Ks 6d]





PokerStars Hand #177194457992: Tournament #2067822782, $1.00+$0.10 USD Hold'em No Limit - Level V (40/80) - 2017/10/21 19:30:29 CUST [2017/10/21 11:30:29 ET]
Table '2067822782 23' 9-max Seat #1 is the button
Seat 1: Jig@n (7337 in chips) 
Seat 2: fechter70 (3440 in chips) 
Seat 3: macadox-420 (3393 in chips) 
Seat 4: serzhinho (2453 in chips) 
Seat 5: Tobias/Felix (4026 in chips) 
Seat 6: Gnourt93 (5830 in chips) 
Seat 7: TURoff (2411 in chips) 
Seat 8: tomike23111 (2990 in chips) 
Seat 9: jeprip (2576 in chips) 
Jig@n: posts the ante 10
fechter70: posts the ante 10
macadox-420: posts the ante 10
serzhinho: posts the ante 10
Tobias/Felix: posts the ante 10
Gnourt93: posts the ante 10
TURoff: posts the ante 10
tomike23111: posts the ante 10
jeprip: posts the ante 10
fechter70: posts small blind 40
macadox-420: posts big blind 80
*** HOLE CARDS ***
Dealt to TURoff [6c Th]
serzhinho: folds 
Tobias/Felix: folds 
Gnourt93: raises 81 to 161
TURoff: folds 
tomike23111: folds 
jeprip: folds 
Jig@n: folds 
fechter70: folds 
macadox-420: folds 
Uncalled bet (81) returned to Gnourt93
Gnourt93 collected 290 from pot
Gnourt93: doesn't show hand 
*** SUMMARY ***
Total pot 290 | Rake 0 
Seat 1: Jig@n (button) folded before Flop (didn't bet)
Seat 2: fechter70 (small blind) folded before Flop
Seat 3: macadox-420 (big blind) folded before Flop
Seat 4: serzhinho folded before Flop (didn't bet)
Seat 5: Tobias/Felix folded before Flop (didn't bet)
Seat 6: Gnourt93 collected (290)
Seat 7: TURoff folded before Flop (didn't bet)
Seat 8: tomike23111 folded before Flop (didn't bet)
Seat 9: jeprip folded before Flop (didn't bet)





PokerStars Hand #177194479985: Tournament #2067822782, $1.00+$0.10 USD Hold'em No Limit - Level V (40/80) - 2017/10/21 19:31:03 CUST [2017/10/21 11:31:03 ET]
Table '2067822782 23' 9-max Seat #2 is the button
Seat 1: Jig@n (7327 in chips) 
Seat 2: fechter70 (3390 in chips) 
Seat 3: macadox-420 (3303 in chips) 
Seat 4: serzhinho (2443 in chips) 
Seat 5: Tobias/Felix (4016 in chips) 
Seat 6: Gnourt93 (6030 in chips) 
Seat 7: TURoff (2401 in chips) 
Seat 8: tomike23111 (2980 in chips) 
Seat 9: jeprip (2566 in chips) 
Jig@n: posts the ante 10
fechter70: posts the ante 10
macadox-420: posts the ante 10
serzhinho: posts the ante 10
Tobias/Felix: posts the ante 10
Gnourt93: posts the ante 10
TURoff: posts the ante 10
tomike23111: posts the ante 10
jeprip: posts the ante 10
macadox-420: posts small blind 40
serzhinho: posts big blind 80
*** HOLE CARDS ***
Dealt to TURoff [2h 5h]
Tobias/Felix: calls 80
Gnourt93: folds 
TURoff: folds 
tomike23111: folds 
jeprip: folds 
Jig@n: folds 
fechter70: folds 
macadox-420: calls 40
serzhinho: checks 
*** FLOP *** [8h 2s 6c]
macadox-420: bets 160
serzhinho: calls 160
Tobias/Felix: calls 160
*** TURN *** [8h 2s 6c] [2d]
macadox-420: checks 
serzhinho: checks 
Tobias/Felix: checks 
*** RIVER *** [8h 2s 6c 2d] [7h]
macadox-420: checks 
serzhinho: checks 
Tobias/Felix: checks 
*** SHOW DOWN ***
macadox-420: shows [Ts Qs] (a pair of Deuces)
serzhinho: shows [6s Ac] (two pair, Sixes and Deuces)
Tobias/Felix: mucks hand 
serzhinho collected 810 from pot
*** SUMMARY ***
Total pot 810 | Rake 0 
Board [8h 2s 6c 2d 7h]
Seat 1: Jig@n folded before Flop (didn't bet)
Seat 2: fechter70 (button) folded before Flop (didn't bet)
Seat 3: macadox-420 (small blind) showed [Ts Qs] and lost with a pair of Deuces
Seat 4: serzhinho (big blind) showed [6s Ac] and won (810) with two pair, Sixes and Deuces
Seat 5: Tobias/Felix mucked [Jc Ad]
Seat 6: Gnourt93 folded before Flop (didn't bet)
Seat 7: TURoff folded before Flop (didn't bet)
Seat 8: tomike23111 folded before Flop (didn't bet)
Seat 9: jeprip folded before Flop (didn't bet)





PokerStars Hand #177194514686: Tournament #2067822782, $1.00+$0.10 USD Hold'em No Limit - Level V (40/80) - 2017/10/21 19:31:57 CUST [2017/10/21 11:31:57 ET]
Table '2067822782 23' 9-max Seat #3 is the button
Seat 1: Jig@n (7317 in chips) 
Seat 2: fechter70 (3380 in chips) 
Seat 3: macadox-420 (3053 in chips) 
Seat 4: serzhinho (3003 in chips) 
Seat 5: Tobias/Felix (3766 in chips) 
Seat 6: Gnourt93 (6020 in chips) 
Seat 7: TURoff (2391 in chips) 
Seat 8: tomike23111 (2970 in chips) 
Seat 9: jeprip (2556 in chips) 
Jig@n: posts the ante 10
fechter70: posts the ante 10
macadox-420: posts the ante 10
serzhinho: posts the ante 10
Tobias/Felix: posts the ante 10
Gnourt93: posts the ante 10
TURoff: posts the ante 10
tomike23111: posts the ante 10
jeprip: posts the ante 10
serzhinho: posts small blind 40
Tobias/Felix: posts big blind 80
*** HOLE CARDS ***
Dealt to TURoff [Qc 4d]
Gnourt93: folds 
TURoff: folds 
tomike23111: folds 
jeprip: calls 80
Jig@n: folds 
fechter70: folds 
macadox-420: folds 
serzhinho: folds 
Tobias/Felix: checks 
*** FLOP *** [Ac 9d 9s]
Tobias/Felix: checks 
jeprip: checks 
*** TURN *** [Ac 9d 9s] [5d]
Tobias/Felix: checks 
jeprip: checks 
*** RIVER *** [Ac 9d 9s 5d] [Kc]
Tobias/Felix: checks 
jeprip: bets 80
Tobias/Felix: folds 
Uncalled bet (80) returned to jeprip
jeprip collected 290 from pot
*** SUMMARY ***
Total pot 290 | Rake 0 
Board [Ac 9d 9s 5d Kc]
Seat 1: Jig@n folded before Flop (didn't bet)
Seat 2: fechter70 folded before Flop (didn't bet)
Seat 3: macadox-420 (button) folded before Flop (didn't bet)
Seat 4: serzhinho (small blind) folded before Flop
Seat 5: Tobias/Felix (big blind) folded on the River
Seat 6: Gnourt93 folded before Flop (didn't bet)
Seat 7: TURoff folded before Flop (didn't bet)
Seat 8: tomike23111 folded before Flop (didn't bet)
Seat 9: jeprip collected (290)





PokerStars Hand #177194538743: Tournament #2067822782, $1.00+$0.10 USD Hold'em No Limit - Level V (40/80) - 2017/10/21 19:32:35 CUST [2017/10/21 11:32:35 ET]
Table '2067822782 23' 9-max Seat #4 is the button
Seat 1: Jig@n (7307 in chips) 
Seat 2: fechter70 (3370 in chips) 
Seat 3: macadox-420 (3043 in chips) 
Seat 4: serzhinho (2953 in chips) 
Seat 5: Tobias/Felix (3676 in chips) 
Seat 6: Gnourt93 (6010 in chips) 
Seat 7: TURoff (2381 in chips) 
Seat 8: tomike23111 (2960 in chips) 
Seat 9: jeprip (2756 in chips) 
Jig@n: posts the ante 10
fechter70: posts the ante 10
macadox-420: posts the ante 10
serzhinho: posts the ante 10
Tobias/Felix: posts the ante 10
Gnourt93: posts the ante 10
TURoff: posts the ante 10
tomike23111: posts the ante 10
jeprip: posts the ante 10
Tobias/Felix: posts small blind 40
Gnourt93: posts big blind 80
*** HOLE CARDS ***
Dealt to TURoff [9c 9d]
TURoff: raises 120 to 200
tomike23111: folds 
jeprip: folds 
Jig@n: folds 
fechter70: folds 
macadox-420: folds 
serzhinho: folds 
Tobias/Felix: calls 160
Gnourt93: calls 120
*** FLOP *** [4c 5c 2d]
Tobias/Felix: checks 
Gnourt93: checks 
TURoff: bets 345
Tobias/Felix: folds 
Gnourt93: folds 
Uncalled bet (345) returned to TURoff
TURoff collected 690 from pot
TURoff: doesn't show hand 
*** SUMMARY ***
Total pot 690 | Rake 0 
Board [4c 5c 2d]
Seat 1: Jig@n folded before Flop (didn't bet)
Seat 2: fechter70 folded before Flop (didn't bet)
Seat 3: macadox-420 folded before Flop (didn't bet)
Seat 4: serzhinho (button) folded before Flop (didn't bet)
Seat 5: Tobias/Felix (small blind) folded on the Flop
Seat 6: Gnourt93 (big blind) folded on the Flop
Seat 7: TURoff collected (690)
Seat 8: tomike23111 folded before Flop (didn't bet)
Seat 9: jeprip folded before Flop (didn't bet)





PokerStars Hand #177194569879: Tournament #2067822782, $1.00+$0.10 USD Hold'em No Limit - Level V (40/80) - 2017/10/21 19:33:23 CUST [2017/10/21 11:33:23 ET]
Table '2067822782 23' 9-max Seat #5 is the button
Seat 1: Jig@n (7297 in chips) 
Seat 2: fechter70 (3360 in chips) 
Seat 3: macadox-420 (3033 in chips) 
Seat 4: serzhinho (2943 in chips) 
Seat 5: Tobias/Felix (3466 in chips) 
Seat 6: Gnourt93 (5800 in chips) 
Seat 7: TURoff (2861 in chips) 
Seat 8: tomike23111 (2950 in chips) 
Seat 9: jeprip (2746 in chips) 
Jig@n: posts the ante 10
fechter70: posts the ante 10
macadox-420: posts the ante 10
serzhinho: posts the ante 10
Tobias/Felix: posts the ante 10
Gnourt93: posts the ante 10
TURoff: posts the ante 10
tomike23111: posts the ante 10
jeprip: posts the ante 10
Gnourt93: posts small blind 40
TURoff: posts big blind 80
*** HOLE CARDS ***
Dealt to TURoff [Kd Jc]
tomike23111: raises 80 to 160
jeprip: calls 160
Jig@n: folds 
fechter70: folds 
macadox-420: folds 
serzhinho: folds 
Tobias/Felix: folds 
Gnourt93: folds 
TURoff: calls 80
*** FLOP *** [9c Jh Js]
TURoff: checks 
tomike23111: bets 240
jeprip: calls 240
TURoff: raises 400 to 640
tomike23111: folds 
jeprip: folds 
Uncalled bet (400) returned to TURoff
TURoff collected 1330 from pot
TURoff: doesn't show hand 
*** SUMMARY ***
Total pot 1330 | Rake 0 
Board [9c Jh Js]
Seat 1: Jig@n folded before Flop (didn't bet)
Seat 2: fechter70 folded before Flop (didn't bet)
Seat 3: macadox-420 folded before Flop (didn't bet)
Seat 4: serzhinho folded before Flop (didn't bet)
Seat 5: Tobias/Felix (button) folded before Flop (didn't bet)
Seat 6: Gnourt93 (small blind) folded before Flop
Seat 7: TURoff (big blind) collected (1330)
Seat 8: tomike23111 folded on the Flop
Seat 9: jeprip folded on the Flop





PokerStars Hand #177194613188: Tournament #2067822782, $1.00+$0.10 USD Hold'em No Limit - Level V (40/80) - 2017/10/21 19:34:30 CUST [2017/10/21 11:34:30 ET]
Table '2067822782 23' 9-max Seat #6 is the button
Seat 1: Jig@n (7287 in chips) 
Seat 2: fechter70 (3350 in chips) 
Seat 3: macadox-420 (3023 in chips) 
Seat 4: serzhinho (2933 in chips) 
Seat 5: Tobias/Felix (3456 in chips) 
Seat 6: Gnourt93 (5750 in chips) 
Seat 7: TURoff (3781 in chips) 
Seat 8: tomike23111 (2540 in chips) 
Seat 9: jeprip (2336 in chips) 
Jig@n: posts the ante 10
fechter70: posts the ante 10
macadox-420: posts the ante 10
serzhinho: posts the ante 10
Tobias/Felix: posts the ante 10
Gnourt93: posts the ante 10
TURoff: posts the ante 10
tomike23111: posts the ante 10
jeprip: posts the ante 10
TURoff: posts small blind 40
tomike23111: posts big blind 80
*** HOLE CARDS ***
Dealt to TURoff [5c 3d]
jeprip: calls 80
Jig@n: folds 
fechter70: folds 
macadox-420: folds 
serzhinho is connected 
serzhinho: folds 
Tobias/Felix: folds 
Gnourt93: folds 
TURoff: folds 
tomike23111: checks 
*** FLOP *** [4h 7d Ts]
tomike23111: checks 
jeprip: checks 
*** TURN *** [4h 7d Ts] [Jc]
tomike23111: bets 160
jeprip: calls 160
*** RIVER *** [4h 7d Ts Jc] [4s]
tomike23111: checks 
jeprip: checks 
*** SHOW DOWN ***
tomike23111: shows [Kh 7h] (two pair, Sevens and Fours)
jeprip: mucks hand 
tomike23111 collected 610 from pot
*** SUMMARY ***
Total pot 610 | Rake 0 
Board [4h 7d Ts Jc 4s]
Seat 1: Jig@n folded before Flop (didn't bet)
Seat 2: fechter70 folded before Flop (didn't bet)
Seat 3: macadox-420 folded before Flop (didn't bet)
Seat 4: serzhinho folded before Flop (didn't bet)
Seat 5: Tobias/Felix folded before Flop (didn't bet)
Seat 6: Gnourt93 (button) folded before Flop (didn't bet)
Seat 7: TURoff (small blind) folded before Flop
Seat 8: tomike23111 (big blind) showed [Kh 7h] and won (610) with two pair, Sevens and Fours
Seat 9: jeprip mucked [9h 6h]





PokerStars Hand #177194650680: Tournament #2067822782, $1.00+$0.10 USD Hold'em No Limit - Level V (40/80) - 2017/10/21 19:35:29 CUST [2017/10/21 11:35:29 ET]
Table '2067822782 23' 9-max Seat #7 is the button
Seat 1: Jig@n (7277 in chips) 
Seat 2: fechter70 (3340 in chips) 
Seat 3: macadox-420 (3013 in chips) 
Seat 4: serzhinho (2923 in chips) 
Seat 5: Tobias/Felix (3446 in chips) 
Seat 6: Gnourt93 (5740 in chips) 
Seat 7: TURoff (3731 in chips) 
Seat 8: tomike23111 (2900 in chips) 
Seat 9: jeprip (2086 in chips) 
Jig@n: posts the ante 10
fechter70: posts the ante 10
macadox-420: posts the ante 10
serzhinho: posts the ante 10
Tobias/Felix: posts the ante 10
Gnourt93: posts the ante 10
TURoff: posts the ante 10
tomike23111: posts the ante 10
jeprip: posts the ante 10
tomike23111: posts small blind 40
jeprip: posts big blind 80
*** HOLE CARDS ***
Dealt to TURoff [6h 5d]
Jig@n: folds 
fechter70: folds 
macadox-420: raises 113 to 193
serzhinho: calls 193
Tobias/Felix: folds 
Gnourt93: folds 
TURoff: folds 
tomike23111: calls 153
jeprip: folds 
*** FLOP *** [Qc 6d 9h]
tomike23111: checks 
macadox-420: bets 360
serzhinho: folds 
tomike23111: folds 
Uncalled bet (360) returned to macadox-420
macadox-420 collected 749 from pot
macadox-420: doesn't show hand 
*** SUMMARY ***
Total pot 749 | Rake 0 
Board [Qc 6d 9h]
Seat 1: Jig@n folded before Flop (didn't bet)
Seat 2: fechter70 folded before Flop (didn't bet)
Seat 3: macadox-420 collected (749)
Seat 4: serzhinho folded on the Flop
Seat 5: Tobias/Felix folded before Flop (didn't bet)
Seat 6: Gnourt93 folded before Flop (didn't bet)
Seat 7: TURoff (button) folded before Flop (didn't bet)
Seat 8: tomike23111 (small blind) folded on the Flop
Seat 9: jeprip (big blind) folded before Flop





PokerStars Hand #177194671249: Tournament #2067822782, $1.00+$0.10 USD Hold'em No Limit - Level V (40/80) - 2017/10/21 19:36:01 CUST [2017/10/21 11:36:01 ET]
Table '2067822782 23' 9-max Seat #8 is the button
Seat 1: Jig@n (7267 in chips) 
Seat 2: fechter70 (3330 in chips) 
Seat 3: macadox-420 (3559 in chips) 
Seat 4: serzhinho (2720 in chips) 
Seat 5: Tobias/Felix (3436 in chips) 
Seat 6: Gnourt93 (5730 in chips) 
Seat 7: TURoff (3721 in chips) 
Seat 8: tomike23111 (2697 in chips) 
Seat 9: jeprip (1996 in chips) 
Jig@n: posts the ante 10
fechter70: posts the ante 10
macadox-420: posts the ante 10
serzhinho: posts the ante 10
Tobias/Felix: posts the ante 10
Gnourt93: posts the ante 10
TURoff: posts the ante 10
tomike23111: posts the ante 10
jeprip: posts the ante 10
jeprip: posts small blind 40
Jig@n: posts big blind 80
*** HOLE CARDS ***
Dealt to TURoff [8d 7d]
fechter70: folds 
macadox-420: folds 
serzhinho: folds 
Tobias/Felix: folds 
Gnourt93: folds 
TURoff: raises 120 to 200
tomike23111: calls 200
jeprip: folds 
Jig@n: folds 
*** FLOP *** [Kd Qh 9h]
TURoff: bets 240
tomike23111: raises 320 to 560
TURoff: folds 
Uncalled bet (320) returned to tomike23111
tomike23111 collected 1090 from pot
*** SUMMARY ***
Total pot 1090 | Rake 0 
Board [Kd Qh 9h]
Seat 1: Jig@n (big blind) folded before Flop
Seat 2: fechter70 folded before Flop (didn't bet)
Seat 3: macadox-420 folded before Flop (didn't bet)
Seat 4: serzhinho folded before Flop (didn't bet)
Seat 5: Tobias/Felix folded before Flop (didn't bet)
Seat 6: Gnourt93 folded before Flop (didn't bet)
Seat 7: TURoff folded on the Flop
Seat 8: tomike23111 (button) collected (1090)
Seat 9: jeprip (small blind) folded before Flop





PokerStars Hand #177194691234: Tournament #2067822782, $1.00+$0.10 USD Hold'em No Limit - Level V (40/80) - 2017/10/21 19:36:32 CUST [2017/10/21 11:36:32 ET]
Table '2067822782 23' 9-max Seat #9 is the button
Seat 1: Jig@n (7177 in chips) 
Seat 2: fechter70 (3320 in chips) 
Seat 3: macadox-420 (3549 in chips) 
Seat 4: serzhinho (2710 in chips) 
Seat 5: Tobias/Felix (3426 in chips) 
Seat 6: Gnourt93 (5720 in chips) 
Seat 7: TURoff (3271 in chips) 
Seat 8: tomike23111 (3337 in chips) 
Seat 9: jeprip (1946 in chips) 
Jig@n: posts the ante 10
fechter70: posts the ante 10
macadox-420: posts the ante 10
serzhinho: posts the ante 10
Tobias/Felix: posts the ante 10
Gnourt93: posts the ante 10
TURoff: posts the ante 10
tomike23111: posts the ante 10
jeprip: posts the ante 10
Jig@n: posts small blind 40
fechter70: posts big blind 80
*** HOLE CARDS ***
Dealt to TURoff [8s As]
macadox-420: folds 
serzhinho: folds 
Tobias/Felix: folds 
Gnourt93: raises 81 to 161
TURoff: calls 161
tomike23111: calls 161
jeprip: folds 
Jig@n: folds 
fechter70: folds 
*** FLOP *** [Th Ad 2d]
Gnourt93: checks 
TURoff: bets 240
tomike23111: folds 
Gnourt93: calls 240
*** TURN *** [Th Ad 2d] [9d]
Gnourt93: checks 
TURoff: checks 
*** RIVER *** [Th Ad 2d 9d] [3s]
Gnourt93: checks 
TURoff: checks 
*** SHOW DOWN ***
Gnourt93: shows [Kc Kh] (a pair of Kings)
TURoff: shows [8s As] (a pair of Aces)
TURoff collected 1173 from pot
*** SUMMARY ***
Total pot 1173 | Rake 0 
Board [Th Ad 2d 9d 3s]
Seat 1: Jig@n (small blind) folded before Flop
Seat 2: fechter70 (big blind) folded before Flop
Seat 3: macadox-420 folded before Flop (didn't bet)
Seat 4: serzhinho folded before Flop (didn't bet)
Seat 5: Tobias/Felix folded before Flop (didn't bet)
Seat 6: Gnourt93 showed [Kc Kh] and lost with a pair of Kings
Seat 7: TURoff showed [8s As] and won (1173) with a pair of Aces
Seat 8: tomike23111 folded on the Flop
Seat 9: jeprip (button) folded before Flop (didn't bet)





PokerStars Hand #177194718463: Tournament #2067822782, $1.00+$0.10 USD Hold'em No Limit - Level V (40/80) - 2017/10/21 19:37:15 CUST [2017/10/21 11:37:15 ET]
Table '2067822782 23' 9-max Seat #1 is the button
Seat 1: Jig@n (7127 in chips) 
Seat 2: fechter70 (3230 in chips) 
Seat 3: macadox-420 (3539 in chips) 
Seat 4: serzhinho (2700 in chips) 
Seat 5: Tobias/Felix (3416 in chips) 
Seat 6: Gnourt93 (5309 in chips) 
Seat 7: TURoff (4033 in chips) 
Seat 8: tomike23111 (3166 in chips) 
Seat 9: jeprip (1936 in chips) 
Jig@n: posts the ante 10
fechter70: posts the ante 10
macadox-420: posts the ante 10
serzhinho: posts the ante 10
Tobias/Felix: posts the ante 10
Gnourt93: posts the ante 10
TURoff: posts the ante 10
tomike23111: posts the ante 10
jeprip: posts the ante 10
fechter70: posts small blind 40
macadox-420: posts big blind 80
*** HOLE CARDS ***
Dealt to TURoff [Th Ks]
serzhinho: raises 80 to 160
Tobias/Felix: folds 
Gnourt93: folds 
TURoff: folds 
tomike23111: folds 
jeprip: calls 160
Jig@n: folds 
fechter70: calls 120
macadox-420: calls 80
*** FLOP *** [5c 3h 3s]
fechter70: checks 
macadox-420: bets 350
serzhinho: calls 350
jeprip: calls 350
fechter70: folds 
*** TURN *** [5c 3h 3s] [3c]
macadox-420: checks 
serzhinho: bets 640
jeprip: calls 640
macadox-420: raises 2379 to 3019 and is all-in
serzhinho: calls 1540 and is all-in
jeprip: calls 776 and is all-in
Uncalled bet (839) returned to macadox-420
*** RIVER *** [5c 3h 3s 3c] [As]
*** SHOW DOWN ***
macadox-420: shows [5d Js] (a full house, Threes full of Fives)
serzhinho: shows [Kc Kh] (a full house, Threes full of Kings)
serzhinho collected 1528 from side pot
jeprip: shows [Ah 2s] (a full house, Threes full of Aces)
jeprip collected 6028 from main pot
*** SUMMARY ***
Total pot 7556 Main pot 6028. Side pot 1528. | Rake 0 
Board [5c 3h 3s 3c As]
Seat 1: Jig@n (button) folded before Flop (didn't bet)
Seat 2: fechter70 (small blind) folded on the Flop
Seat 3: macadox-420 (big blind) showed [5d Js] and lost with a full house, Threes full of Fives
Seat 4: serzhinho showed [Kc Kh] and won (1528) with a full house, Threes full of Kings
Seat 5: Tobias/Felix folded before Flop (didn't bet)
Seat 6: Gnourt93 folded before Flop (didn't bet)
Seat 7: TURoff folded before Flop (didn't bet)
Seat 8: tomike23111 folded before Flop (didn't bet)
Seat 9: jeprip showed [Ah 2s] and won (6028) with a full house, Threes full of Aces





PokerStars Hand #177194779741: Tournament #2067822782, $1.00+$0.10 USD Hold'em No Limit - Level VI (50/100) - 2017/10/21 19:38:50 CUST [2017/10/21 11:38:50 ET]
Table '2067822782 23' 9-max Seat #2 is the button
Seat 1: Jig@n (7117 in chips) 
Seat 2: fechter70 (3060 in chips) 
Seat 3: macadox-420 (839 in chips) 
Seat 5: Tobias/Felix (3406 in chips) 
Seat 6: Gnourt93 (5299 in chips) 
Seat 7: TURoff (4023 in chips) 
Seat 8: tomike23111 (3156 in chips) 
Seat 9: jeprip (6028 in chips) 
Jig@n: posts the ante 12
fechter70: posts the ante 12
macadox-420: posts the ante 12
Tobias/Felix: posts the ante 12
Gnourt93: posts the ante 12
TURoff: posts the ante 12
tomike23111: posts the ante 12
jeprip: posts the ante 12
macadox-420: posts small blind 50
Tobias/Felix: posts big blind 100
*** HOLE CARDS ***
Dealt to TURoff [Js Th]
Gnourt93: folds 
TURoff: folds 
tomike23111: folds 
jeprip: calls 100
Jig@n: folds 
fechter70: folds 
macadox-420: calls 50
Tobias/Felix: raises 100 to 200
jeprip: calls 100
macadox-420: raises 627 to 827 and is all-in
Tobias/Felix: calls 627
jeprip: folds 
*** FLOP *** [4h 6d 7h]
*** TURN *** [4h 6d 7h] [Td]
*** RIVER *** [4h 6d 7h Td] [Ah]
*** SHOW DOWN ***
macadox-420: shows [Qc 9c] (high card Ace)
Tobias/Felix: shows [Kh Kd] (a pair of Kings)
macadox-420 is sitting out
Tobias/Felix collected 1950 from pot
macadox-420 finished the tournament
*** SUMMARY ***
Total pot 1950 | Rake 0 
Board [4h 6d 7h Td Ah]
Seat 1: Jig@n folded before Flop (didn't bet)
Seat 2: fechter70 (button) folded before Flop (didn't bet)
Seat 3: macadox-420 (small blind) showed [Qc 9c] and lost with high card Ace
Seat 5: Tobias/Felix (big blind) showed [Kh Kd] and won (1950) with a pair of Kings
Seat 6: Gnourt93 folded before Flop (didn't bet)
Seat 7: TURoff folded before Flop (didn't bet)
Seat 8: tomike23111 folded before Flop (didn't bet)
Seat 9: jeprip folded before Flop





PokerStars Hand #177194809052: Tournament #2067822782, $1.00+$0.10 USD Hold'em No Limit - Level VI (50/100) - 2017/10/21 19:39:36 CUST [2017/10/21 11:39:36 ET]
Table '2067822782 23' 9-max Seat #5 is the button
Seat 1: Jig@n (7105 in chips) 
Seat 2: fechter70 (3048 in chips) 
Seat 4: Zirte (3000 in chips) 
Seat 5: Tobias/Felix (4517 in chips) 
Seat 6: Gnourt93 (5287 in chips) 
Seat 7: TURoff (4011 in chips) 
Seat 8: tomike23111 (3144 in chips) 
Seat 9: jeprip (5816 in chips) 
Jig@n: posts the ante 12
fechter70: posts the ante 12
Zirte: posts the ante 12
Tobias/Felix: posts the ante 12
Gnourt93: posts the ante 12
TURoff: posts the ante 12
tomike23111: posts the ante 12
jeprip: posts the ante 12
Gnourt93: posts small blind 50
TURoff: posts big blind 100
*** HOLE CARDS ***
Dealt to TURoff [2c 9s]
tomike23111: folds 
jeprip: calls 100
Jig@n: folds 
fechter70: folds 
Zirte: calls 100
Tobias/Felix: folds 
Gnourt93: calls 50
TURoff: checks 
*** FLOP *** [3s 6s Ad]
Gnourt93: checks 
TURoff: checks 
jeprip: checks 
Zirte: bets 248
Gnourt93: folds 
TURoff: folds 
jeprip: folds 
Uncalled bet (248) returned to Zirte
Zirte collected 496 from pot
*** SUMMARY ***
Total pot 496 | Rake 0 
Board [3s 6s Ad]
Seat 1: Jig@n folded before Flop (didn't bet)
Seat 2: fechter70 folded before Flop (didn't bet)
Seat 4: Zirte collected (496)
Seat 5: Tobias/Felix (button) folded before Flop (didn't bet)
Seat 6: Gnourt93 (small blind) folded on the Flop
Seat 7: TURoff (big blind) folded on the Flop
Seat 8: tomike23111 folded before Flop (didn't bet)
Seat 9: jeprip folded on the Flop





PokerStars Hand #177194832889: Tournament #2067822782, $1.00+$0.10 USD Hold'em No Limit - Level VI (50/100) - 2017/10/21 19:40:14 CUST [2017/10/21 11:40:14 ET]
Table '2067822782 23' 9-max Seat #6 is the button
Seat 1: Jig@n (7093 in chips) 
Seat 2: fechter70 (3036 in chips) 
Seat 3: goodfet (3000 in chips) 
Seat 4: Zirte (3384 in chips) 
Seat 5: Tobias/Felix (4505 in chips) 
Seat 6: Gnourt93 (5175 in chips) 
Seat 7: TURoff (3899 in chips) 
Seat 8: tomike23111 (3132 in chips) 
Seat 9: jeprip (5704 in chips) 
Jig@n: posts the ante 12
fechter70: posts the ante 12
goodfet: posts the ante 12
Zirte: posts the ante 12
Tobias/Felix: posts the ante 12
Gnourt93: posts the ante 12
TURoff: posts the ante 12
tomike23111: posts the ante 12
jeprip: posts the ante 12
TURoff: posts small blind 50
tomike23111: posts big blind 100
*** HOLE CARDS ***
Dealt to TURoff [Th 8h]
jeprip: folds 
Jig@n: folds 
fechter70: folds 
goodfet: folds 
Zirte: folds 
Tobias/Felix: folds 
Gnourt93: raises 102 to 202
TURoff: calls 152
tomike23111: folds 
*** FLOP *** [3h 5h 4h]
TURoff: checks 
Gnourt93: checks 
*** TURN *** [3h 5h 4h] [Ac]
TURoff: checks 
Gnourt93: bets 220
TURoff: raises 701 to 921
Gnourt93: calls 701
*** RIVER *** [3h 5h 4h Ac] [7d]
TURoff: bets 2764 and is all-in
Gnourt93: folds 
Uncalled bet (2764) returned to TURoff
TURoff collected 2454 from pot
TURoff: doesn't show hand 
*** SUMMARY ***
Total pot 2454 | Rake 0 
Board [3h 5h 4h Ac 7d]
Seat 1: Jig@n folded before Flop (didn't bet)
Seat 2: fechter70 folded before Flop (didn't bet)
Seat 3: goodfet folded before Flop (didn't bet)
Seat 4: Zirte folded before Flop (didn't bet)
Seat 5: Tobias/Felix folded before Flop (didn't bet)
Seat 6: Gnourt93 (button) folded on the River
Seat 7: TURoff (small blind) collected (2454)
Seat 8: tomike23111 (big blind) folded before Flop
Seat 9: jeprip folded before Flop (didn't bet)





PokerStars Hand #177194867824: Tournament #2067822782, $1.00+$0.10 USD Hold'em No Limit - Level VI (50/100) - 2017/10/21 19:41:08 CUST [2017/10/21 11:41:08 ET]
Table '2067822782 23' 9-max Seat #7 is the button
Seat 1: Jig@n (7081 in chips) 
Seat 2: fechter70 (3024 in chips) 
Seat 3: goodfet (2988 in chips) 
Seat 4: Zirte (3372 in chips) 
Seat 5: Tobias/Felix (4493 in chips) 
Seat 6: Gnourt93 (4040 in chips) 
Seat 7: TURoff (5218 in chips) 
Seat 8: tomike23111 (3020 in chips) 
Seat 9: jeprip (5692 in chips) 
Jig@n: posts the ante 12
fechter70: posts the ante 12
goodfet: posts the ante 12
Zirte: posts the ante 12
Tobias/Felix: posts the ante 12
Gnourt93: posts the ante 12
TURoff: posts the ante 12
tomike23111: posts the ante 12
jeprip: posts the ante 12
tomike23111: posts small blind 50
jeprip: posts big blind 100
*** HOLE CARDS ***
Dealt to TURoff [3c Jd]
Jig@n: folds 
fechter70: folds 
goodfet: folds 
Zirte: raises 200 to 300
Tobias/Felix: folds 
Gnourt93: folds 
TURoff: folds 
tomike23111: folds 
jeprip: calls 200
*** FLOP *** [9c 6s 4d]
jeprip: bets 100
Zirte: calls 100
*** TURN *** [9c 6s 4d] [8s]
jeprip: bets 100
Zirte: calls 100
*** RIVER *** [9c 6s 4d 8s] [Qc]
jeprip: checks 
Zirte: checks 
*** SHOW DOWN ***
jeprip: shows [2d Jh] (high card Queen)
Zirte: shows [Kh Ac] (high card Ace)
Zirte collected 1158 from pot
*** SUMMARY ***
Total pot 1158 | Rake 0 
Board [9c 6s 4d 8s Qc]
Seat 1: Jig@n folded before Flop (didn't bet)
Seat 2: fechter70 folded before Flop (didn't bet)
Seat 3: goodfet folded before Flop (didn't bet)
Seat 4: Zirte showed [Kh Ac] and won (1158) with high card Ace
Seat 5: Tobias/Felix folded before Flop (didn't bet)
Seat 6: Gnourt93 folded before Flop (didn't bet)
Seat 7: TURoff (button) folded before Flop (didn't bet)
Seat 8: tomike23111 (small blind) folded before Flop
Seat 9: jeprip (big blind) showed [2d Jh] and lost with high card Queen





PokerStars Hand #177194907504: Tournament #2067822782, $1.00+$0.10 USD Hold'em No Limit - Level VI (50/100) - 2017/10/21 19:42:10 CUST [2017/10/21 11:42:10 ET]
Table '2067822782 23' 9-max Seat #8 is the button
Seat 1: Jig@n (7069 in chips) 
Seat 2: fechter70 (3012 in chips) 
Seat 3: goodfet (2976 in chips) 
Seat 4: Zirte (4018 in chips) 
Seat 5: Tobias/Felix (4481 in chips) 
Seat 6: Gnourt93 (4028 in chips) 
Seat 7: TURoff (5206 in chips) 
Seat 8: tomike23111 (2958 in chips) 
Seat 9: jeprip (5180 in chips) 
Jig@n: posts the ante 12
fechter70: posts the ante 12
goodfet: posts the ante 12
Zirte: posts the ante 12
Tobias/Felix: posts the ante 12
Gnourt93: posts the ante 12
TURoff: posts the ante 12
tomike23111: posts the ante 12
jeprip: posts the ante 12
jeprip: posts small blind 50
Jig@n: posts big blind 100
*** HOLE CARDS ***
Dealt to TURoff [3s 3c]
fechter70: calls 100
goodfet: folds 
Zirte: folds 
Tobias/Felix: calls 100
Gnourt93: folds 
TURoff: calls 100
tomike23111: calls 100
jeprip: calls 50
Jig@n: checks 
*** FLOP *** [As Ts Jh]
jeprip: bets 300
Jig@n: calls 300
fechter70: calls 300
Tobias/Felix: folds 
TURoff: folds 
tomike23111: folds 
*** TURN *** [As Ts Jh] [8s]
jeprip: bets 3000
Jig@n: folds 
fechter70: folds 
Uncalled bet (3000) returned to jeprip
jeprip collected 1608 from pot
*** SUMMARY ***
Total pot 1608 | Rake 0 
Board [As Ts Jh 8s]
Seat 1: Jig@n (big blind) folded on the Turn
Seat 2: fechter70 folded on the Turn
Seat 3: goodfet folded before Flop (didn't bet)
Seat 4: Zirte folded before Flop (didn't bet)
Seat 5: Tobias/Felix folded on the Flop
Seat 6: Gnourt93 folded before Flop (didn't bet)
Seat 7: TURoff folded on the Flop
Seat 8: tomike23111 (button) folded on the Flop
Seat 9: jeprip (small blind) collected (1608)





PokerStars Hand #177194956583: Tournament #2067822782, $1.00+$0.10 USD Hold'em No Limit - Level VI (50/100) - 2017/10/21 19:43:26 CUST [2017/10/21 11:43:26 ET]
Table '2067822782 23' 9-max Seat #9 is the button
Seat 1: Jig@n (6657 in chips) 
Seat 2: fechter70 (2600 in chips) 
Seat 3: goodfet (2964 in chips) 
Seat 4: Zirte (4006 in chips) 
Seat 5: Tobias/Felix (4369 in chips) 
Seat 6: Gnourt93 (4016 in chips) 
Seat 7: TURoff (5094 in chips) 
Seat 8: tomike23111 (2846 in chips) 
Seat 9: jeprip (6376 in chips) 
Jig@n: posts the ante 12
fechter70: posts the ante 12
goodfet: posts the ante 12
Zirte: posts the ante 12
Tobias/Felix: posts the ante 12
Gnourt93: posts the ante 12
TURoff: posts the ante 12
tomike23111: posts the ante 12
jeprip: posts the ante 12
Jig@n: posts small blind 50
fechter70: posts big blind 100
*** HOLE CARDS ***
Dealt to TURoff [Js 5h]
goodfet: folds 
Zirte: raises 100 to 200
Tobias/Felix: folds 
Gnourt93: folds 
TURoff: folds 
tomike23111: folds 
jeprip: calls 200
Jig@n: folds 
fechter70: folds 
*** FLOP *** [7h 5c 4c]
Zirte: bets 658
jeprip: folds 
Uncalled bet (658) returned to Zirte
Zirte collected 658 from pot
*** SUMMARY ***
Total pot 658 | Rake 0 
Board [7h 5c 4c]
Seat 1: Jig@n (small blind) folded before Flop
Seat 2: fechter70 (big blind) folded before Flop
Seat 3: goodfet folded before Flop (didn't bet)
Seat 4: Zirte collected (658)
Seat 5: Tobias/Felix folded before Flop (didn't bet)
Seat 6: Gnourt93 folded before Flop (didn't bet)
Seat 7: TURoff folded before Flop (didn't bet)
Seat 8: tomike23111 folded before Flop (didn't bet)
Seat 9: jeprip (button) folded on the Flop





PokerStars Hand #177194979792: Tournament #2067822782, $1.00+$0.10 USD Hold'em No Limit - Level VI (50/100) - 2017/10/21 19:44:01 CUST [2017/10/21 11:44:01 ET]
Table '2067822782 23' 9-max Seat #1 is the button
Seat 1: Jig@n (6595 in chips) 
Seat 2: fechter70 (2488 in chips) 
Seat 3: goodfet (2952 in chips) 
Seat 4: Zirte (4452 in chips) 
Seat 5: Tobias/Felix (4357 in chips) 
Seat 6: Gnourt93 (4004 in chips) 
Seat 7: TURoff (5082 in chips) 
Seat 8: tomike23111 (2834 in chips) 
Seat 9: jeprip (6164 in chips) 
Jig@n: posts the ante 12
fechter70: posts the ante 12
goodfet: posts the ante 12
Zirte: posts the ante 12
Tobias/Felix: posts the ante 12
Gnourt93: posts the ante 12
TURoff: posts the ante 12
tomike23111: posts the ante 12
jeprip: posts the ante 12
fechter70: posts small blind 50
goodfet: posts big blind 100
*** HOLE CARDS ***
Dealt to TURoff [8s 3h]
Zirte: folds 
Tobias/Felix: folds 
Gnourt93: folds 
TURoff: folds 
tomike23111: folds 
jeprip: calls 100
Jig@n: folds 
fechter70: folds 
goodfet: checks 
*** FLOP *** [3s Js 7s]
goodfet: checks 
jeprip: checks 
*** TURN *** [3s Js 7s] [9c]
goodfet: checks 
jeprip: bets 100
goodfet: calls 100
*** RIVER *** [3s Js 7s 9c] [4h]
goodfet: checks 
jeprip: checks 
*** SHOW DOWN ***
goodfet: shows [Ks 8d] (high card King)
jeprip: shows [As 3d] (a pair of Threes)
jeprip collected 558 from pot
*** SUMMARY ***
Total pot 558 | Rake 0 
Board [3s Js 7s 9c 4h]
Seat 1: Jig@n (button) folded before Flop (didn't bet)
Seat 2: fechter70 (small blind) folded before Flop
Seat 3: goodfet (big blind) showed [Ks 8d] and lost with high card King
Seat 4: Zirte folded before Flop (didn't bet)
Seat 5: Tobias/Felix folded before Flop (didn't bet)
Seat 6: Gnourt93 folded before Flop (didn't bet)
Seat 7: TURoff folded before Flop (didn't bet)
Seat 8: tomike23111 folded before Flop (didn't bet)
Seat 9: jeprip showed [As 3d] and won (558) with a pair of Threes





PokerStars Hand #177195009907: Tournament #2067822782, $1.00+$0.10 USD Hold'em No Limit - Level VI (50/100) - 2017/10/21 19:44:48 CUST [2017/10/21 11:44:48 ET]
Table '2067822782 23' 9-max Seat #2 is the button
Seat 1: Jig@n (6583 in chips) 
Seat 2: fechter70 (2426 in chips) 
Seat 3: goodfet (2740 in chips) 
Seat 4: Zirte (4440 in chips) 
Seat 5: Tobias/Felix (4345 in chips) 
Seat 6: Gnourt93 (3992 in chips) 
Seat 7: TURoff (5070 in chips) 
Seat 8: tomike23111 (2822 in chips) 
Seat 9: jeprip (6510 in chips) 
Jig@n: posts the ante 12
fechter70: posts the ante 12
goodfet: posts the ante 12
Zirte: posts the ante 12
Tobias/Felix: posts the ante 12
Gnourt93: posts the ante 12
TURoff: posts the ante 12
tomike23111: posts the ante 12
jeprip: posts the ante 12
goodfet: posts small blind 50
Zirte: posts big blind 100
*** HOLE CARDS ***
Dealt to TURoff [8d 7d]
Tobias/Felix: calls 100
Gnourt93: folds 
TURoff: raises 300 to 400
tomike23111: folds 
jeprip: calls 400
Jig@n: folds 
fechter70: folds 
goodfet: raises 2328 to 2728 and is all-in
Zirte: folds 
Tobias/Felix: folds 
TURoff: folds 
jeprip: folds 
Uncalled bet (2328) returned to goodfet
goodfet collected 1508 from pot
*** SUMMARY ***
Total pot 1508 | Rake 0 
Seat 1: Jig@n folded before Flop (didn't bet)
Seat 2: fechter70 (button) folded before Flop (didn't bet)
Seat 3: goodfet (small blind) collected (1508)
Seat 4: Zirte (big blind) folded before Flop
Seat 5: Tobias/Felix folded before Flop
Seat 6: Gnourt93 folded before Flop (didn't bet)
Seat 7: TURoff folded before Flop
Seat 8: tomike23111 folded before Flop (didn't bet)
Seat 9: jeprip folded before Flop





PokerStars Hand #177195038404: Tournament #2067822782, $1.00+$0.10 USD Hold'em No Limit - Level VI (50/100) - 2017/10/21 19:45:33 CUST [2017/10/21 11:45:33 ET]
Table '2067822782 23' 9-max Seat #3 is the button
Seat 1: Jig@n (6571 in chips) 
Seat 2: fechter70 (2414 in chips) 
Seat 3: goodfet (3836 in chips) 
Seat 4: Zirte (4328 in chips) 
Seat 5: Tobias/Felix (4233 in chips) 
Seat 6: Gnourt93 (3980 in chips) 
Seat 7: TURoff (4658 in chips) 
Seat 8: tomike23111 (2810 in chips) 
Seat 9: jeprip (6098 in chips) 
Jig@n: posts the ante 12
fechter70: posts the ante 12
goodfet: posts the ante 12
Zirte: posts the ante 12
Tobias/Felix: posts the ante 12
Gnourt93: posts the ante 12
TURoff: posts the ante 12
tomike23111: posts the ante 12
jeprip: posts the ante 12
Zirte: posts small blind 50
Tobias/Felix: posts big blind 100
*** HOLE CARDS ***
Dealt to TURoff [Kh 5h]
Gnourt93: folds 
TURoff: folds 
tomike23111: folds 
jeprip: folds 
Jig@n: raises 100 to 200
fechter70: folds 
goodfet: folds 
Zirte: folds 
Tobias/Felix: calls 100
*** FLOP *** [3s 4h Jh]
Tobias/Felix: checks 
Jig@n: checks 
*** TURN *** [3s 4h Jh] [Ts]
Tobias/Felix: checks 
Jig@n: bets 279
Tobias/Felix: calls 279
*** RIVER *** [3s 4h Jh Ts] [7s]
Tobias/Felix: checks 
Jig@n: bets 600
Tobias/Felix: folds 
Uncalled bet (600) returned to Jig@n
Jig@n collected 1116 from pot
Jig@n: doesn't show hand 
*** SUMMARY ***
Total pot 1116 | Rake 0 
Board [3s 4h Jh Ts 7s]
Seat 1: Jig@n collected (1116)
Seat 2: fechter70 folded before Flop (didn't bet)
Seat 3: goodfet (button) folded before Flop (didn't bet)
Seat 4: Zirte (small blind) folded before Flop
Seat 5: Tobias/Felix (big blind) folded on the River
Seat 6: Gnourt93 folded before Flop (didn't bet)
Seat 7: TURoff folded before Flop (didn't bet)
Seat 8: tomike23111 folded before Flop (didn't bet)
Seat 9: jeprip folded before Flop (didn't bet)





PokerStars Hand #177195073858: Tournament #2067822782, $1.00+$0.10 USD Hold'em No Limit - Level VI (50/100) - 2017/10/21 19:46:28 CUST [2017/10/21 11:46:28 ET]
Table '2067822782 23' 9-max Seat #4 is the button
Seat 1: Jig@n (7196 in chips) 
Seat 2: fechter70 (2402 in chips) 
Seat 3: goodfet (3824 in chips) 
Seat 4: Zirte (4266 in chips) 
Seat 5: Tobias/Felix (3742 in chips) 
Seat 6: Gnourt93 (3968 in chips) 
Seat 7: TURoff (4646 in chips) 
Seat 8: tomike23111 (2798 in chips) 
Seat 9: jeprip (6086 in chips) 
Jig@n: posts the ante 12
fechter70: posts the ante 12
goodfet: posts the ante 12
Zirte: posts the ante 12
Tobias/Felix: posts the ante 12
Gnourt93: posts the ante 12
TURoff: posts the ante 12
tomike23111: posts the ante 12
jeprip: posts the ante 12
Tobias/Felix: posts small blind 50
Gnourt93: posts big blind 100
*** HOLE CARDS ***
Dealt to TURoff [Ah Tc]
TURoff: raises 150 to 250
tomike23111: folds 
jeprip: folds 
Jig@n: folds 
fechter70: folds 
goodfet: folds 
Zirte: folds 
Tobias/Felix: folds 
Gnourt93: folds 
Uncalled bet (150) returned to TURoff
TURoff collected 358 from pot
TURoff: doesn't show hand 
*** SUMMARY ***
Total pot 358 | Rake 0 
Seat 1: Jig@n folded before Flop (didn't bet)
Seat 2: fechter70 folded before Flop (didn't bet)
Seat 3: goodfet folded before Flop (didn't bet)
Seat 4: Zirte (button) folded before Flop (didn't bet)
Seat 5: Tobias/Felix (small blind) folded before Flop
Seat 6: Gnourt93 (big blind) folded before Flop
Seat 7: TURoff collected (358)
Seat 8: tomike23111 folded before Flop (didn't bet)
Seat 9: jeprip folded before Flop (didn't bet)





PokerStars Hand #177195085829: Tournament #2067822782, $1.00+$0.10 USD Hold'em No Limit - Level VI (50/100) - 2017/10/21 19:46:46 CUST [2017/10/21 11:46:46 ET]
Table '2067822782 23' 9-max Seat #5 is the button
Seat 1: Jig@n (7184 in chips) 
Seat 2: fechter70 (2390 in chips) 
Seat 3: goodfet (3812 in chips) 
Seat 4: Zirte (4254 in chips) 
Seat 5: Tobias/Felix (3680 in chips) 
Seat 6: Gnourt93 (3856 in chips) 
Seat 7: TURoff (4892 in chips) 
Seat 8: tomike23111 (2786 in chips) 
Seat 9: jeprip (6074 in chips) 
Jig@n: posts the ante 12
fechter70: posts the ante 12
goodfet: posts the ante 12
Zirte: posts the ante 12
Tobias/Felix: posts the ante 12
Gnourt93: posts the ante 12
TURoff: posts the ante 12
tomike23111: posts the ante 12
jeprip: posts the ante 12
Gnourt93: posts small blind 50
TURoff: posts big blind 100
*** HOLE CARDS ***
Dealt to TURoff [Jc 5c]
tomike23111: folds 
jeprip: folds 
Jig@n: folds 
fechter70: folds 
goodfet: folds 
Zirte: raises 100 to 200
Tobias/Felix: folds 
Gnourt93: folds 
TURoff: calls 100
*** FLOP *** [Ah 9c 6d]
TURoff: checks 
Zirte: bets 200
TURoff: raises 300 to 500
Zirte: folds 
Uncalled bet (300) returned to TURoff
TURoff collected 958 from pot
TURoff: doesn't show hand 
*** SUMMARY ***
Total pot 958 | Rake 0 
Board [Ah 9c 6d]
Seat 1: Jig@n folded before Flop (didn't bet)
Seat 2: fechter70 folded before Flop (didn't bet)
Seat 3: goodfet folded before Flop (didn't bet)
Seat 4: Zirte folded on the Flop
Seat 5: Tobias/Felix (button) folded before Flop (didn't bet)
Seat 6: Gnourt93 (small blind) folded before Flop
Seat 7: TURoff (big blind) collected (958)
Seat 8: tomike23111 folded before Flop (didn't bet)
Seat 9: jeprip folded before Flop (didn't bet)





PokerStars Hand #177195108576: Tournament #2067822782, $1.00+$0.10 USD Hold'em No Limit - Level VII (60/120) - 2017/10/21 19:47:21 CUST [2017/10/21 11:47:21 ET]
Table '2067822782 23' 9-max Seat #6 is the button
Seat 1: Jig@n (7172 in chips) 
Seat 2: fechter70 (2378 in chips) 
Seat 3: goodfet (3800 in chips) 
Seat 4: Zirte (3842 in chips) 
Seat 5: Tobias/Felix (3668 in chips) 
Seat 6: Gnourt93 (3794 in chips) 
Seat 7: TURoff (5438 in chips) 
Seat 8: tomike23111 (2774 in chips) 
Seat 9: jeprip (6062 in chips) 
Jig@n: posts the ante 15
fechter70: posts the ante 15
goodfet: posts the ante 15
Zirte: posts the ante 15
Tobias/Felix: posts the ante 15
Gnourt93: posts the ante 15
TURoff: posts the ante 15
tomike23111: posts the ante 15
jeprip: posts the ante 15
TURoff: posts small blind 60
tomike23111: posts big blind 120
*** HOLE CARDS ***
Dealt to TURoff [7h 5c]
jeprip: folds 
Jig@n: folds 
fechter70: folds 
goodfet: raises 120 to 240
Zirte: folds 
Tobias/Felix: folds 
Gnourt93: raises 540 to 780
TURoff: folds 
tomike23111: folds 
goodfet: folds 
Uncalled bet (540) returned to Gnourt93
Gnourt93 collected 795 from pot
Gnourt93: doesn't show hand 
*** SUMMARY ***
Total pot 795 | Rake 0 
Seat 1: Jig@n folded before Flop (didn't bet)
Seat 2: fechter70 folded before Flop (didn't bet)
Seat 3: goodfet folded before Flop
Seat 4: Zirte folded before Flop (didn't bet)
Seat 5: Tobias/Felix folded before Flop (didn't bet)
Seat 6: Gnourt93 (button) collected (795)
Seat 7: TURoff (small blind) folded before Flop
Seat 8: tomike23111 (big blind) folded before Flop
Seat 9: jeprip folded before Flop (didn't bet)





PokerStars Hand #177195131048: Tournament #2067822782, $1.00+$0.10 USD Hold'em No Limit - Level VII (60/120) - 2017/10/21 19:47:56 CUST [2017/10/21 11:47:56 ET]
Table '2067822782 23' 9-max Seat #7 is the button
Seat 1: Jig@n (7157 in chips) 
Seat 2: fechter70 (2363 in chips) 
Seat 3: goodfet (3545 in chips) 
Seat 4: Zirte (3827 in chips) 
Seat 5: Tobias/Felix (3653 in chips) 
Seat 6: Gnourt93 (4334 in chips) 
Seat 7: TURoff (5363 in chips) 
Seat 8: tomike23111 (2639 in chips) 
Seat 9: jeprip (6047 in chips) 
Jig@n: posts the ante 15
fechter70: posts the ante 15
goodfet: posts the ante 15
Zirte: posts the ante 15
Tobias/Felix: posts the ante 15
Gnourt93: posts the ante 15
TURoff: posts the ante 15
tomike23111: posts the ante 15
jeprip: posts the ante 15
tomike23111: posts small blind 60
jeprip: posts big blind 120
*** HOLE CARDS ***
Dealt to TURoff [4c Kh]
Jig@n: folds 
fechter70: folds 
goodfet: folds 
Zirte: folds 
Tobias/Felix: folds 
Gnourt93: folds 
TURoff: folds 
tomike23111: calls 60
jeprip: raises 240 to 360
tomike23111: calls 240
*** FLOP *** [2d 6s Qh]
tomike23111: bets 120
jeprip: calls 120
*** TURN *** [2d 6s Qh] [Td]
tomike23111: bets 120
jeprip: calls 120
*** RIVER *** [2d 6s Qh Td] [As]
tomike23111: bets 480
jeprip: raises 720 to 1200
tomike23111: folds 
Uncalled bet (720) returned to jeprip
jeprip collected 2295 from pot
*** SUMMARY ***
Total pot 2295 | Rake 0 
Board [2d 6s Qh Td As]
Seat 1: Jig@n folded before Flop (didn't bet)
Seat 2: fechter70 folded before Flop (didn't bet)
Seat 3: goodfet folded before Flop (didn't bet)
Seat 4: Zirte folded before Flop (didn't bet)
Seat 5: Tobias/Felix folded before Flop (didn't bet)
Seat 6: Gnourt93 folded before Flop (didn't bet)
Seat 7: TURoff (button) folded before Flop (didn't bet)
Seat 8: tomike23111 (small blind) folded on the River
Seat 9: jeprip (big blind) collected (2295)





PokerStars Hand #177195174968: Tournament #2067822782, $1.00+$0.10 USD Hold'em No Limit - Level VII (60/120) - 2017/10/21 19:49:04 CUST [2017/10/21 11:49:04 ET]
Table '2067822782 23' 9-max Seat #8 is the button
Seat 1: Jig@n (7142 in chips) 
Seat 2: fechter70 (2348 in chips) 
Seat 3: goodfet (3530 in chips) 
Seat 4: Zirte (3812 in chips) 
Seat 5: Tobias/Felix (3638 in chips) 
Seat 6: Gnourt93 (4319 in chips) 
Seat 7: TURoff (5348 in chips) 
Seat 8: tomike23111 (1544 in chips) 
Seat 9: jeprip (7247 in chips) 
Jig@n: posts the ante 15
fechter70: posts the ante 15
goodfet: posts the ante 15
Zirte: posts the ante 15
Tobias/Felix: posts the ante 15
Gnourt93: posts the ante 15
TURoff: posts the ante 15
tomike23111: posts the ante 15
jeprip: posts the ante 15
jeprip: posts small blind 60
Jig@n: posts big blind 120
*** HOLE CARDS ***
Dealt to TURoff [2d 4s]
fechter70: calls 120
goodfet: folds 
Zirte: folds 
Tobias/Felix: folds 
Gnourt93: folds 
TURoff: folds 
tomike23111: folds 
jeprip: folds 
Jig@n: raises 7007 to 7127 and is all-in
fechter70: folds 
Uncalled bet (7007) returned to Jig@n
Jig@n collected 435 from pot
Jig@n: doesn't show hand 
*** SUMMARY ***
Total pot 435 | Rake 0 
Seat 1: Jig@n (big blind) collected (435)
Seat 2: fechter70 folded before Flop
Seat 3: goodfet folded before Flop (didn't bet)
Seat 4: Zirte folded before Flop (didn't bet)
Seat 5: Tobias/Felix folded before Flop (didn't bet)
Seat 6: Gnourt93 folded before Flop (didn't bet)
Seat 7: TURoff folded before Flop (didn't bet)
Seat 8: tomike23111 (button) folded before Flop (didn't bet)
Seat 9: jeprip (small blind) folded before Flop





PokerStars Hand #177195197081: Tournament #2067822782, $1.00+$0.10 USD Hold'em No Limit - Level VII (60/120) - 2017/10/21 19:49:39 CUST [2017/10/21 11:49:39 ET]
Table '2067822782 23' 9-max Seat #9 is the button
Seat 1: Jig@n (7442 in chips) 
Seat 2: fechter70 (2213 in chips) 
Seat 3: goodfet (3515 in chips) 
Seat 4: Zirte (3797 in chips) 
Seat 5: Tobias/Felix (3623 in chips) 
Seat 6: Gnourt93 (4304 in chips) 
Seat 7: TURoff (5333 in chips) 
Seat 8: tomike23111 (1529 in chips) 
Seat 9: jeprip (7172 in chips) 
Jig@n: posts the ante 15
fechter70: posts the ante 15
goodfet: posts the ante 15
Zirte: posts the ante 15
Tobias/Felix: posts the ante 15
Gnourt93: posts the ante 15
TURoff: posts the ante 15
tomike23111: posts the ante 15
jeprip: posts the ante 15
Jig@n: posts small blind 60
fechter70: posts big blind 120
*** HOLE CARDS ***
Dealt to TURoff [Kc As]
goodfet: folds 
Zirte: folds 
Tobias/Felix: calls 120
Gnourt93: folds 
TURoff: raises 360 to 480
tomike23111: folds 
jeprip: folds 
Jig@n: raises 1080 to 1560
fechter70: raises 638 to 2198 and is all-in
Tobias/Felix: calls 2078
TURoff: folds 
Jig@n: calls 638
*** FLOP *** [5h 4c 7d]
Jig@n: bets 3605
Tobias/Felix: calls 1410 and is all-in
Uncalled bet (2195) returned to Jig@n
*** TURN *** [5h 4c 7d] [3d]
*** RIVER *** [5h 4c 7d 3d] [Jd]
*** SHOW DOWN ***
Jig@n: shows [Ac Ah] (a pair of Aces)
Tobias/Felix: shows [8h 8c] (a pair of Eights)
Jig@n collected 2820 from side pot
fechter70: shows [Ad 4d] (a flush, Ace high)
fechter70 collected 7209 from main pot
Tobias/Felix finished the tournament
*** SUMMARY ***
Total pot 10029 Main pot 7209. Side pot 2820. | Rake 0 
Board [5h 4c 7d 3d Jd]
Seat 1: Jig@n (small blind) showed [Ac Ah] and won (2820) with a pair of Aces
Seat 2: fechter70 (big blind) showed [Ad 4d] and won (7209) with a flush, Ace high
Seat 3: goodfet folded before Flop (didn't bet)
Seat 4: Zirte folded before Flop (didn't bet)
Seat 5: Tobias/Felix showed [8h 8c] and lost with a pair of Eights
Seat 6: Gnourt93 folded before Flop (didn't bet)
Seat 7: TURoff folded before Flop
Seat 8: tomike23111 folded before Flop (didn't bet)
Seat 9: jeprip (button) folded before Flop (didn't bet)





PokerStars Hand #177195232636: Tournament #2067822782, $1.00+$0.10 USD Hold'em No Limit - Level VII (60/120) - 2017/10/21 19:50:34 CUST [2017/10/21 11:50:34 ET]
Table '2067822782 23' 9-max Seat #1 is the button
Seat 1: Jig@n (6639 in chips) 
Seat 2: fechter70 (7209 in chips) 
Seat 3: goodfet (3500 in chips) 
Seat 4: Zirte (3782 in chips) 
Seat 6: Gnourt93 (4289 in chips) 
Seat 7: TURoff (4838 in chips) 
Seat 8: tomike23111 (1514 in chips) 
Seat 9: jeprip (7157 in chips) 
Jig@n: posts the ante 15
fechter70: posts the ante 15
goodfet: posts the ante 15
Zirte: posts the ante 15
Gnourt93: posts the ante 15
TURoff: posts the ante 15
tomike23111: posts the ante 15
jeprip: posts the ante 15
fechter70: posts small blind 60
goodfet: posts big blind 120
*** HOLE CARDS ***
Dealt to TURoff [2h Qs]
Zirte: raises 240 to 360
Gnourt93: folds 
TURoff: folds 
tomike23111: folds 
jeprip: calls 360
Jig@n: folds 
fechter70: folds 
goodfet: folds 
*** FLOP *** [As 8c 8s]
Zirte: checks 
jeprip: checks 
*** TURN *** [As 8c 8s] [Ah]
Zirte: checks 
jeprip: checks 
*** RIVER *** [As 8c 8s Ah] [Tc]
Zirte: bets 240
jeprip: calls 240
*** SHOW DOWN ***
Zirte: shows [Kc Ks] (two pair, Aces and Kings)
jeprip: mucks hand 
Zirte collected 1500 from pot
*** SUMMARY ***
Total pot 1500 | Rake 0 
Board [As 8c 8s Ah Tc]
Seat 1: Jig@n (button) folded before Flop (didn't bet)
Seat 2: fechter70 (small blind) folded before Flop
Seat 3: goodfet (big blind) folded before Flop
Seat 4: Zirte showed [Kc Ks] and won (1500) with two pair, Aces and Kings
Seat 6: Gnourt93 folded before Flop (didn't bet)
Seat 7: TURoff folded before Flop (didn't bet)
Seat 8: tomike23111 folded before Flop (didn't bet)
Seat 9: jeprip mucked [9s Td]





PokerStars Hand #177195268861: Tournament #2067822782, $1.00+$0.10 USD Hold'em No Limit - Level VII (60/120) - 2017/10/21 19:51:30 CUST [2017/10/21 11:51:30 ET]
Table '2067822782 23' 9-max Seat #2 is the button
Seat 1: Jig@n (6624 in chips) 
Seat 2: fechter70 (7134 in chips) 
Seat 3: goodfet (3365 in chips) 
Seat 4: Zirte (4667 in chips) 
Seat 5: EulerL (3000 in chips) 
Seat 6: Gnourt93 (4274 in chips) 
Seat 7: TURoff (4823 in chips) 
Seat 8: tomike23111 (1499 in chips) 
Seat 9: jeprip (6542 in chips) 
Jig@n: posts the ante 15
fechter70: posts the ante 15
goodfet: posts the ante 15
Zirte: posts the ante 15
EulerL: posts the ante 15
Gnourt93: posts the ante 15
TURoff: posts the ante 15
tomike23111: posts the ante 15
jeprip: posts the ante 15
goodfet: posts small blind 60
Zirte: posts big blind 120
*** HOLE CARDS ***
Dealt to TURoff [8d 8h]
EulerL: raises 180 to 300
Gnourt93: folds 
TURoff: calls 300
tomike23111: folds 
jeprip: folds 
Jig@n: folds 
fechter70: folds 
goodfet: folds 
Zirte: folds 
*** FLOP *** [7s 6s Jc]
EulerL: bets 549
TURoff: calls 549
*** TURN *** [7s 6s Jc] [Ac]
EulerL: checks 
TURoff: checks 
*** RIVER *** [7s 6s Jc Ac] [9c]
EulerL: bets 1208
TURoff: folds 
Uncalled bet (1208) returned to EulerL
EulerL collected 2013 from pot
EulerL: doesn't show hand 
*** SUMMARY ***
Total pot 2013 | Rake 0 
Board [7s 6s Jc Ac 9c]
Seat 1: Jig@n folded before Flop (didn't bet)
Seat 2: fechter70 (button) folded before Flop (didn't bet)
Seat 3: goodfet (small blind) folded before Flop
Seat 4: Zirte (big blind) folded before Flop
Seat 5: EulerL collected (2013)
Seat 6: Gnourt93 folded before Flop (didn't bet)
Seat 7: TURoff folded on the River
Seat 8: tomike23111 folded before Flop (didn't bet)
Seat 9: jeprip folded before Flop (didn't bet)





PokerStars Hand #177195290721: Tournament #2067822782, $1.00+$0.10 USD Hold'em No Limit - Level VII (60/120) - 2017/10/21 19:52:05 CUST [2017/10/21 11:52:05 ET]
Table '2067822782 23' 9-max Seat #3 is the button
Seat 1: Jig@n (6609 in chips) 
Seat 2: fechter70 (7119 in chips) 
Seat 3: goodfet (3290 in chips) 
Seat 4: Zirte (4532 in chips) 
Seat 5: EulerL (4149 in chips) 
Seat 6: Gnourt93 (4259 in chips) 
Seat 7: TURoff (3959 in chips) 
Seat 8: tomike23111 (1484 in chips) 
Seat 9: jeprip (6527 in chips) 
Jig@n: posts the ante 15
fechter70: posts the ante 15
goodfet: posts the ante 15
Zirte: posts the ante 15
EulerL: posts the ante 15
Gnourt93: posts the ante 15
TURoff: posts the ante 15
tomike23111: posts the ante 15
jeprip: posts the ante 15
Zirte: posts small blind 60
EulerL: posts big blind 120
*** HOLE CARDS ***
Dealt to TURoff [8s As]
Gnourt93: folds 
TURoff: raises 180 to 300
tomike23111: folds 
jeprip: calls 300
Jig@n: folds 
fechter70: folds 
goodfet: folds 
Zirte: folds 
EulerL: folds 
*** FLOP *** [Ah Qh 8h]
TURoff: bets 480
jeprip: folds 
Uncalled bet (480) returned to TURoff
TURoff collected 915 from pot
TURoff: doesn't show hand 
*** SUMMARY ***
Total pot 915 | Rake 0 
Board [Ah Qh 8h]
Seat 1: Jig@n folded before Flop (didn't bet)
Seat 2: fechter70 folded before Flop (didn't bet)
Seat 3: goodfet (button) folded before Flop (didn't bet)
Seat 4: Zirte (small blind) folded before Flop
Seat 5: EulerL (big blind) folded before Flop
Seat 6: Gnourt93 folded before Flop (didn't bet)
Seat 7: TURoff collected (915)
Seat 8: tomike23111 folded before Flop (didn't bet)
Seat 9: jeprip folded on the Flop





PokerStars Hand #177195312781: Tournament #2067822782, $1.00+$0.10 USD Hold'em No Limit - Level VII (60/120) - 2017/10/21 19:52:39 CUST [2017/10/21 11:52:39 ET]
Table '2067822782 23' 9-max Seat #4 is the button
Seat 1: Jig@n (6594 in chips) 
Seat 2: fechter70 (7104 in chips) 
Seat 3: goodfet (3275 in chips) 
Seat 4: Zirte (4457 in chips) 
Seat 5: EulerL (4014 in chips) 
Seat 6: Gnourt93 (4244 in chips) 
Seat 7: TURoff (4559 in chips) 
Seat 8: tomike23111 (1469 in chips) 
Seat 9: jeprip (6212 in chips) 
Jig@n: posts the ante 15
fechter70: posts the ante 15
goodfet: posts the ante 15
Zirte: posts the ante 15
EulerL: posts the ante 15
Gnourt93: posts the ante 15
TURoff: posts the ante 15
tomike23111: posts the ante 15
jeprip: posts the ante 15
EulerL: posts small blind 60
Gnourt93: posts big blind 120
*** HOLE CARDS ***
Dealt to TURoff [Tc 7h]
TURoff: folds 
tomike23111: raises 360 to 480
jeprip: folds 
Jig@n: folds 
fechter70: folds 
goodfet: folds 
Zirte: folds 
EulerL: folds 
Gnourt93: folds 
Uncalled bet (360) returned to tomike23111
tomike23111 collected 435 from pot
*** SUMMARY ***
Total pot 435 | Rake 0 
Seat 1: Jig@n folded before Flop (didn't bet)
Seat 2: fechter70 folded before Flop (didn't bet)
Seat 3: goodfet folded before Flop (didn't bet)
Seat 4: Zirte (button) folded before Flop (didn't bet)
Seat 5: EulerL (small blind) folded before Flop
Seat 6: Gnourt93 (big blind) folded before Flop
Seat 7: TURoff folded before Flop (didn't bet)
Seat 8: tomike23111 collected (435)
Seat 9: jeprip folded before Flop (didn't bet)





PokerStars Hand #177195326315: Tournament #2067822782, $1.00+$0.10 USD Hold'em No Limit - Level VII (60/120) - 2017/10/21 19:53:01 CUST [2017/10/21 11:53:01 ET]
Table '2067822782 23' 9-max Seat #5 is the button
Seat 1: Jig@n (6579 in chips) 
Seat 2: fechter70 (7089 in chips) 
Seat 3: goodfet (3260 in chips) 
Seat 4: Zirte (4442 in chips) 
Seat 5: EulerL (3939 in chips) 
Seat 6: Gnourt93 (4109 in chips) 
Seat 7: TURoff (4544 in chips) 
Seat 8: tomike23111 (1769 in chips) 
Seat 9: jeprip (6197 in chips) 
Jig@n: posts the ante 15
fechter70: posts the ante 15
goodfet: posts the ante 15
Zirte: posts the ante 15
EulerL: posts the ante 15
Gnourt93: posts the ante 15
TURoff: posts the ante 15
tomike23111: posts the ante 15
jeprip: posts the ante 15
Gnourt93: posts small blind 60
TURoff: posts big blind 120
*** HOLE CARDS ***
Dealt to TURoff [6s Kc]
tomike23111: folds 
jeprip: folds 
Jig@n: folds 
fechter70: folds 
goodfet: raises 120 to 240
Zirte: calls 240
EulerL: folds 
Gnourt93: folds 
TURoff: calls 120
*** FLOP *** [Qh Qc Ks]
TURoff: checks 
goodfet: bets 485
Zirte: folds 
TURoff: raises 3804 to 4289 and is all-in
goodfet: folds 
Uncalled bet (3804) returned to TURoff
TURoff collected 1885 from pot
TURoff: doesn't show hand 
*** SUMMARY ***
Total pot 1885 | Rake 0 
Board [Qh Qc Ks]
Seat 1: Jig@n folded before Flop (didn't bet)
Seat 2: fechter70 folded before Flop (didn't bet)
Seat 3: goodfet folded on the Flop
Seat 4: Zirte folded on the Flop
Seat 5: EulerL (button) folded before Flop (didn't bet)
Seat 6: Gnourt93 (small blind) folded before Flop
Seat 7: TURoff (big blind) collected (1885)
Seat 8: tomike23111 folded before Flop (didn't bet)
Seat 9: jeprip folded before Flop (didn't bet)





PokerStars Hand #177195349743: Tournament #2067822782, $1.00+$0.10 USD Hold'em No Limit - Level VII (60/120) - 2017/10/21 19:53:37 CUST [2017/10/21 11:53:37 ET]
Table '2067822782 23' 9-max Seat #6 is the button
Seat 1: Jig@n (6564 in chips) 
Seat 2: fechter70 (7074 in chips) 
Seat 3: goodfet (2520 in chips) 
Seat 4: Zirte (4187 in chips) 
Seat 5: EulerL (3924 in chips) 
Seat 6: Gnourt93 (4034 in chips) 
Seat 7: TURoff (5689 in chips) 
Seat 8: tomike23111 (1754 in chips) 
Seat 9: jeprip (6182 in chips) 
Jig@n: posts the ante 15
fechter70: posts the ante 15
goodfet: posts the ante 15
Zirte: posts the ante 15
EulerL: posts the ante 15
Gnourt93: posts the ante 15
TURoff: posts the ante 15
tomike23111: posts the ante 15
jeprip: posts the ante 15
TURoff: posts small blind 60
tomike23111: posts big blind 120
*** HOLE CARDS ***
Dealt to TURoff [2c Js]
jeprip: folds 
Jig@n: folds 
fechter70: folds 
goodfet: raises 120 to 240
Zirte: folds 
EulerL: folds 
Gnourt93: calls 240
TURoff: folds 
tomike23111: calls 120
*** FLOP *** [Ad Ah Qd]
tomike23111: checks 
goodfet: bets 600
Gnourt93: calls 600
tomike23111: folds 
*** TURN *** [Ad Ah Qd] [7d]
goodfet: checks 
Gnourt93: bets 761
goodfet: calls 761
*** RIVER *** [Ad Ah Qd 7d] [3s]
goodfet: checks 
Gnourt93: bets 1309
goodfet: folds 
Uncalled bet (1309) returned to Gnourt93
Gnourt93 collected 3637 from pot
Gnourt93: doesn't show hand 
*** SUMMARY ***
Total pot 3637 | Rake 0 
Board [Ad Ah Qd 7d 3s]
Seat 1: Jig@n folded before Flop (didn't bet)
Seat 2: fechter70 folded before Flop (didn't bet)
Seat 3: goodfet folded on the River
Seat 4: Zirte folded before Flop (didn't bet)
Seat 5: EulerL folded before Flop (didn't bet)
Seat 6: Gnourt93 (button) collected (3637)
Seat 7: TURoff (small blind) folded before Flop
Seat 8: tomike23111 (big blind) folded on the Flop
Seat 9: jeprip folded before Flop (didn't bet)





PokerStars Hand #177195394079: Tournament #2067822782, $1.00+$0.10 USD Hold'em No Limit - Level VII (60/120) - 2017/10/21 19:54:46 CUST [2017/10/21 11:54:46 ET]
Table '2067822782 23' 9-max Seat #7 is the button
Seat 1: Jig@n (6549 in chips) 
Seat 2: fechter70 (7059 in chips) 
Seat 3: goodfet (904 in chips) 
Seat 4: Zirte (4172 in chips) 
Seat 5: EulerL (3909 in chips) 
Seat 6: Gnourt93 (6055 in chips) 
Seat 7: TURoff (5614 in chips) 
Seat 8: tomike23111 (1499 in chips) 
Seat 9: jeprip (6167 in chips) 
Jig@n: posts the ante 15
fechter70: posts the ante 15
goodfet: posts the ante 15
Zirte: posts the ante 15
EulerL: posts the ante 15
Gnourt93: posts the ante 15
TURoff: posts the ante 15
tomike23111: posts the ante 15
jeprip: posts the ante 15
tomike23111: posts small blind 60
jeprip: posts big blind 120
*** HOLE CARDS ***
Dealt to TURoff [Ac Kc]
Jig@n: raises 120 to 240
fechter70: folds 
goodfet: folds 
Zirte: folds 
EulerL: calls 240
Gnourt93: folds 
TURoff: raises 600 to 840
tomike23111: folds 
jeprip: folds 
Jig@n: folds 
EulerL: calls 600
*** FLOP *** [Js Jc 4c]
EulerL: checks 
TURoff: bets 1118
EulerL: raises 1936 to 3054 and is all-in
TURoff: calls 1936
*** TURN *** [Js Jc 4c] [6s]
*** RIVER *** [Js Jc 4c 6s] [5s]
*** SHOW DOWN ***
EulerL: shows [8s Ts] (a flush, Jack high)
TURoff: shows [Ac Kc] (a pair of Jacks)
EulerL collected 8343 from pot
*** SUMMARY ***
Total pot 8343 | Rake 0 
Board [Js Jc 4c 6s 5s]
Seat 1: Jig@n folded before Flop
Seat 2: fechter70 folded before Flop (didn't bet)
Seat 3: goodfet folded before Flop (didn't bet)
Seat 4: Zirte folded before Flop (didn't bet)
Seat 5: EulerL showed [8s Ts] and won (8343) with a flush, Jack high
Seat 6: Gnourt93 folded before Flop (didn't bet)
Seat 7: TURoff (button) showed [Ac Kc] and lost with a pair of Jacks
Seat 8: tomike23111 (small blind) folded before Flop
Seat 9: jeprip (big blind) folded before Flop





PokerStars Hand #177195652334: Tournament #2067822782, $1.00+$0.10 USD Hold'em No Limit - Level VII (60/120) - 2017/10/21 20:02:25 CUST [2017/10/21 12:02:25 ET]
Table '2067822782 23' 9-max Seat #8 is the button
Seat 1: Jig@n (6294 in chips) 
Seat 2: fechter70 (7044 in chips) 
Seat 3: goodfet (889 in chips) 
Seat 4: Zirte (4157 in chips) 
Seat 5: EulerL (8343 in chips) 
Seat 6: Gnourt93 (6040 in chips) 
Seat 7: TURoff (1705 in chips) 
Seat 8: tomike23111 (1424 in chips) 
Seat 9: jeprip (6032 in chips) 
Jig@n: posts the ante 15
fechter70: posts the ante 15
goodfet: posts the ante 15
Zirte: posts the ante 15
EulerL: posts the ante 15
Gnourt93: posts the ante 15
TURoff: posts the ante 15
tomike23111: posts the ante 15
jeprip: posts the ante 15
jeprip: posts small blind 60
Jig@n: posts big blind 120
*** HOLE CARDS ***
Dealt to TURoff [Kh 4s]
fechter70: calls 120
goodfet: folds 
Zirte: folds 
EulerL: folds 
Gnourt93: folds 
TURoff: folds 
tomike23111: folds 
jeprip: calls 60
Jig@n: checks 
*** FLOP *** [Jd Js Jh]
jeprip: checks 
Jig@n: checks 
fechter70: bets 495
jeprip: folds 
Jig@n: folds 
Uncalled bet (495) returned to fechter70
fechter70 collected 495 from pot
fechter70: doesn't show hand 
*** SUMMARY ***
Total pot 495 | Rake 0 
Board [Jd Js Jh]
Seat 1: Jig@n (big blind) folded on the Flop
Seat 2: fechter70 collected (495)
Seat 3: goodfet folded before Flop (didn't bet)
Seat 4: Zirte folded before Flop (didn't bet)
Seat 5: EulerL folded before Flop (didn't bet)
Seat 6: Gnourt93 folded before Flop (didn't bet)
Seat 7: TURoff folded before Flop (didn't bet)
Seat 8: tomike23111 (button) folded before Flop (didn't bet)
Seat 9: jeprip (small blind) folded on the Flop





PokerStars Hand #177195679616: Tournament #2067822782, $1.00+$0.10 USD Hold'em No Limit - Level VII (60/120) - 2017/10/21 20:03:07 CUST [2017/10/21 12:03:07 ET]
Table '2067822782 23' 9-max Seat #9 is the button
Seat 1: Jig@n (6159 in chips) 
Seat 2: fechter70 (7404 in chips) 
Seat 3: goodfet (874 in chips) 
Seat 4: Zirte (4142 in chips) 
Seat 6: Gnourt93 (6025 in chips) 
Seat 7: TURoff (1690 in chips) 
Seat 8: tomike23111 (1409 in chips) 
Seat 9: jeprip (5897 in chips) 
Jig@n: posts the ante 15
fechter70: posts the ante 15
goodfet: posts the ante 15
Zirte: posts the ante 15
Gnourt93: posts the ante 15
TURoff: posts the ante 15
tomike23111: posts the ante 15
jeprip: posts the ante 15
Jig@n: posts small blind 60
fechter70: posts big blind 120
*** HOLE CARDS ***
Dealt to TURoff [3s 8d]
goodfet: folds 
Zirte: folds 
Gnourt93: folds 
TURoff: folds 
tomike23111: raises 240 to 360
jeprip: calls 360
Jig@n: folds 
fechter70: folds 
*** FLOP *** [8h Td 6h]
tomike23111: checks 
jeprip: checks 
*** TURN *** [8h Td 6h] [7h]
tomike23111: bets 120
jeprip: calls 120
*** RIVER *** [8h Td 6h 7h] [2c]
tomike23111: bets 720
jeprip: calls 720
*** SHOW DOWN ***
tomike23111: shows [4c Ah] (high card Ace)
jeprip: shows [6d Jd] (a pair of Sixes)
jeprip collected 2700 from pot
*** SUMMARY ***
Total pot 2700 | Rake 0 
Board [8h Td 6h 7h 2c]
Seat 1: Jig@n (small blind) folded before Flop
Seat 2: fechter70 (big blind) folded before Flop
Seat 3: goodfet folded before Flop (didn't bet)
Seat 4: Zirte folded before Flop (didn't bet)
Seat 6: Gnourt93 folded before Flop (didn't bet)
Seat 7: TURoff folded before Flop (didn't bet)
Seat 8: tomike23111 showed [4c Ah] and lost with high card Ace
Seat 9: jeprip (button) showed [6d Jd] and won (2700) with a pair of Sixes





PokerStars Hand #177195734048: Tournament #2067822782, $1.00+$0.10 USD Hold'em No Limit - Level VII (60/120) - 2017/10/21 20:04:30 CUST [2017/10/21 12:04:30 ET]
Table '2067822782 23' 9-max Seat #1 is the button
Seat 1: Jig@n (6084 in chips) 
Seat 2: fechter70 (7269 in chips) 
Seat 3: goodfet (859 in chips) 
Seat 4: Zirte (4127 in chips) 
Seat 5: ScarHelm (3000 in chips) 
Seat 6: Gnourt93 (6010 in chips) 
Seat 7: TURoff (1675 in chips) 
Seat 8: tomike23111 (194 in chips) 
Seat 9: jeprip (7382 in chips) 
Jig@n: posts the ante 15
fechter70: posts the ante 15
goodfet: posts the ante 15
Zirte: posts the ante 15
ScarHelm: posts the ante 15
Gnourt93: posts the ante 15
TURoff: posts the ante 15
tomike23111: posts the ante 15
jeprip: posts the ante 15
fechter70: posts small blind 60
goodfet: posts big blind 120
*** HOLE CARDS ***
Dealt to TURoff [3d 3h]
Zirte: folds 
ScarHelm: calls 120
Gnourt93: folds 
TURoff: raises 1540 to 1660 and is all-in
tomike23111: folds 
jeprip: folds 
Jig@n: folds 
fechter70: folds 
goodfet: folds 
ScarHelm: calls 1540
*** FLOP *** [6c Jd Js]
*** TURN *** [6c Jd Js] [8d]
*** RIVER *** [6c Jd Js 8d] [4h]
*** SHOW DOWN ***
ScarHelm: shows [Kd 9h] (a pair of Jacks)
TURoff: shows [3d 3h] (two pair, Jacks and Threes)
TURoff collected 3635 from pot
*** SUMMARY ***
Total pot 3635 | Rake 0 
Board [6c Jd Js 8d 4h]
Seat 1: Jig@n (button) folded before Flop (didn't bet)
Seat 2: fechter70 (small blind) folded before Flop
Seat 3: goodfet (big blind) folded before Flop
Seat 4: Zirte folded before Flop (didn't bet)
Seat 5: ScarHelm showed [Kd 9h] and lost with a pair of Jacks
Seat 6: Gnourt93 folded before Flop (didn't bet)
Seat 7: TURoff showed [3d 3h] and won (3635) with two pair, Jacks and Threes
Seat 8: tomike23111 folded before Flop (didn't bet)
Seat 9: jeprip folded before Flop (didn't bet)





PokerStars Hand #177195763942: Tournament #2067822782, $1.00+$0.10 USD Hold'em No Limit - Level VIII (75/150) - 2017/10/21 20:05:12 CUST [2017/10/21 12:05:12 ET]
Table '2067822782 23' 9-max Seat #2 is the button
Seat 1: Jig@n (6069 in chips) 
Seat 2: fechter70 (7194 in chips) 
Seat 3: goodfet (724 in chips) 
Seat 4: Zirte (4112 in chips) 
Seat 5: ScarHelm (1325 in chips) 
Seat 6: Gnourt93 (5995 in chips) 
Seat 7: TURoff (3635 in chips) 
Seat 8: tomike23111 (179 in chips) 
Seat 9: jeprip (7367 in chips) 
Jig@n: posts the ante 20
fechter70: posts the ante 20
goodfet: posts the ante 20
Zirte: posts the ante 20
ScarHelm: posts the ante 20
Gnourt93: posts the ante 20
TURoff: posts the ante 20
tomike23111: posts the ante 20
jeprip: posts the ante 20
goodfet: posts small blind 75
Zirte: posts big blind 150
*** HOLE CARDS ***
Dealt to TURoff [3d 9d]
ScarHelm: calls 150
Gnourt93: folds 
TURoff: folds 
tomike23111: raises 9 to 159 and is all-in
jeprip: calls 159
Jig@n: folds 
fechter70: folds 
goodfet: raises 545 to 704 and is all-in
Zirte: folds 
ScarHelm: calls 554
jeprip: calls 545
*** FLOP *** [7c As Js]
ScarHelm: checks 
jeprip: bets 600
ScarHelm: folds 
Uncalled bet (600) returned to jeprip
*** TURN *** [7c As Js] [3h]
*** RIVER *** [7c As Js 3h] [8d]
*** SHOW DOWN ***
goodfet: shows [8s 8h] (three of a kind, Eights)
jeprip: shows [Tc Jc] (a pair of Jacks)
goodfet collected 1635 from side pot
tomike23111: shows [2d 2c] (a pair of Deuces)
goodfet collected 966 from main pot
tomike23111 finished the tournament
*** SUMMARY ***
Total pot 2601 Main pot 966. Side pot 1635. | Rake 0 
Board [7c As Js 3h 8d]
Seat 1: Jig@n folded before Flop (didn't bet)
Seat 2: fechter70 (button) folded before Flop (didn't bet)
Seat 3: goodfet (small blind) showed [8s 8h] and won (2601) with three of a kind, Eights
Seat 4: Zirte (big blind) folded before Flop
Seat 5: ScarHelm folded on the Flop
Seat 6: Gnourt93 folded before Flop (didn't bet)
Seat 7: TURoff folded before Flop (didn't bet)
Seat 8: tomike23111 showed [2d 2c] and lost with a pair of Deuces
Seat 9: jeprip showed [Tc Jc] and lost with a pair of Jacks





PokerStars Hand #177195803250: Tournament #2067822782, $1.00+$0.10 USD Hold'em No Limit - Level VIII (75/150) - 2017/10/21 20:06:09 CUST [2017/10/21 12:06:09 ET]
Table '2067822782 23' 9-max Seat #3 is the button
Seat 1: Jig@n (6049 in chips) 
Seat 2: fechter70 (7174 in chips) 
Seat 3: goodfet (2601 in chips) 
Seat 4: Zirte (3942 in chips) 
Seat 5: ScarHelm (601 in chips) 
Seat 6: Gnourt93 (5975 in chips) 
Seat 7: TURoff (3615 in chips) 
Seat 8: carp10 (9913 in chips) 
Jig@n: posts the ante 20
fechter70: posts the ante 20
goodfet: posts the ante 20
Zirte: posts the ante 20
ScarHelm: posts the ante 20
Gnourt93: posts the ante 20
TURoff: posts the ante 20
carp10: posts the ante 20
Zirte: posts small blind 75
ScarHelm: posts big blind 150
*** HOLE CARDS ***
Dealt to TURoff [6d Jh]
Gnourt93: folds 
TURoff: folds 
carp10: calls 150
Jig@n: folds 
fechter70: folds 
goodfet: folds 
Zirte: raises 300 to 450
ScarHelm: raises 131 to 581 and is all-in
carp10: calls 431
Zirte: calls 131
*** FLOP *** [8s 6h 6c]
Zirte: checks 
carp10: checks 
*** TURN *** [8s 6h 6c] [9c]
Zirte: checks 
carp10: checks 
*** RIVER *** [8s 6h 6c 9c] [Tc]
Zirte: checks 
carp10: checks 
*** SHOW DOWN ***
Zirte: shows [Ks As] (a pair of Sixes)
ScarHelm: mucks hand 
carp10: shows [2h 2c] (two pair, Sixes and Deuces)
carp10 collected 1903 from pot
ScarHelm finished the tournament
*** SUMMARY ***
Total pot 1903 | Rake 0 
Board [8s 6h 6c 9c Tc]
Seat 1: Jig@n folded before Flop (didn't bet)
Seat 2: fechter70 folded before Flop (didn't bet)
Seat 3: goodfet (button) folded before Flop (didn't bet)
Seat 4: Zirte (small blind) showed [Ks As] and lost with a pair of Sixes
Seat 5: ScarHelm (big blind) mucked [Ac Qd]
Seat 6: Gnourt93 folded before Flop (didn't bet)
Seat 7: TURoff folded before Flop (didn't bet)
Seat 8: carp10 showed [2h 2c] and won (1903) with two pair, Sixes and Deuces





PokerStars Hand #177195839914: Tournament #2067822782, $1.00+$0.10 USD Hold'em No Limit - Level VIII (75/150) - 2017/10/21 20:07:03 CUST [2017/10/21 12:07:03 ET]
Table '2067822782 23' 9-max Seat #4 is the button
Seat 1: Jig@n (6029 in chips) 
Seat 2: fechter70 (7154 in chips) 
Seat 3: goodfet (2581 in chips) 
Seat 4: Zirte (3341 in chips) 
Seat 6: Gnourt93 (5955 in chips) 
Seat 7: TURoff (3595 in chips) 
Seat 8: carp10 (11215 in chips) 
Seat 9: KlassikGG (2710 in chips) 
Jig@n: posts the ante 20
fechter70: posts the ante 20
goodfet: posts the ante 20
Zirte: posts the ante 20
Gnourt93: posts the ante 20
TURoff: posts the ante 20
carp10: posts the ante 20
KlassikGG: posts the ante 20
Gnourt93: posts small blind 75
TURoff: posts big blind 150
*** HOLE CARDS ***
Dealt to TURoff [Qh 4h]
carp10: calls 150
KlassikGG: raises 2540 to 2690 and is all-in
Jig@n: folds 
fechter70: folds 
goodfet: folds 
Zirte: folds 
Gnourt93: folds 
TURoff: folds 
carp10: calls 2540
*** FLOP *** [3c 2h Jd]
*** TURN *** [3c 2h Jd] [6d]
*** RIVER *** [3c 2h Jd 6d] [3h]
*** SHOW DOWN ***
carp10: shows [Jc Kh] (two pair, Jacks and Threes)
KlassikGG: shows [7h Ah] (a pair of Threes)
carp10 collected 5765 from pot
KlassikGG finished the tournament
*** SUMMARY ***
Total pot 5765 | Rake 0 
Board [3c 2h Jd 6d 3h]
Seat 1: Jig@n folded before Flop (didn't bet)
Seat 2: fechter70 folded before Flop (didn't bet)
Seat 3: goodfet folded before Flop (didn't bet)
Seat 4: Zirte (button) folded before Flop (didn't bet)
Seat 6: Gnourt93 (small blind) folded before Flop
Seat 7: TURoff (big blind) folded before Flop
Seat 8: carp10 showed [Jc Kh] and won (5765) with two pair, Jacks and Threes
Seat 9: KlassikGG showed [7h Ah] and lost with a pair of Threes





PokerStars Hand #177195860202: Tournament #2067822782, $1.00+$0.10 USD Hold'em No Limit - Level VIII (75/150) - 2017/10/21 20:07:32 CUST [2017/10/21 12:07:32 ET]
Table '2067822782 23' 9-max Seat #6 is the button
Seat 1: Jig@n (6009 in chips) 
Seat 2: fechter70 (7134 in chips) 
Seat 3: goodfet (2561 in chips) 
Seat 4: Zirte (3321 in chips) 
Seat 5: giannislena (3000 in chips) 
Seat 6: Gnourt93 (5860 in chips) 
Seat 7: TURoff (3425 in chips) 
Seat 8: carp10 (14270 in chips) 
Jig@n: posts the ante 20
fechter70: posts the ante 20
goodfet: posts the ante 20
Zirte: posts the ante 20
giannislena: posts the ante 20
Gnourt93: posts the ante 20
TURoff: posts the ante 20
carp10: posts the ante 20
TURoff: posts small blind 75
carp10: posts big blind 150
*** HOLE CARDS ***
Dealt to TURoff [Ah 5c]
Jig@n: folds 
fechter70: folds 
goodfet: folds 
Zirte: folds 
giannislena: calls 150
Gnourt93: raises 375 to 525
TURoff: folds 
carp10: folds 
giannislena: calls 375
*** FLOP *** [9c 9d 2s]
giannislena: checks 
Gnourt93: bets 517
giannislena: folds 
Uncalled bet (517) returned to Gnourt93
Gnourt93 collected 1435 from pot
Gnourt93: doesn't show hand 
*** SUMMARY ***
Total pot 1435 | Rake 0 
Board [9c 9d 2s]
Seat 1: Jig@n folded before Flop (didn't bet)
Seat 2: fechter70 folded before Flop (didn't bet)
Seat 3: goodfet folded before Flop (didn't bet)
Seat 4: Zirte folded before Flop (didn't bet)
Seat 5: giannislena folded on the Flop
Seat 6: Gnourt93 (button) collected (1435)
Seat 7: TURoff (small blind) folded before Flop
Seat 8: carp10 (big blind) folded before Flop





PokerStars Hand #177195890352: Tournament #2067822782, $1.00+$0.10 USD Hold'em No Limit - Level VIII (75/150) - 2017/10/21 20:08:16 CUST [2017/10/21 12:08:16 ET]
Table '2067822782 23' 9-max Seat #7 is the button
Seat 1: Jig@n (5989 in chips) 
Seat 2: fechter70 (7114 in chips) 
Seat 3: goodfet (2541 in chips) 
Seat 4: Zirte (3301 in chips) 
Seat 5: giannislena (2455 in chips) 
Seat 6: Gnourt93 (6750 in chips) 
Seat 7: TURoff (3330 in chips) 
Seat 8: carp10 (14100 in chips) 
Jig@n: posts the ante 20
fechter70: posts the ante 20
goodfet: posts the ante 20
Zirte: posts the ante 20
giannislena: posts the ante 20
Gnourt93: posts the ante 20
TURoff: posts the ante 20
carp10: posts the ante 20
carp10: posts small blind 75
Jig@n: posts big blind 150
*** HOLE CARDS ***
Dealt to TURoff [3s 7c]
fechter70: folds 
goodfet: folds 
Zirte: folds 
giannislena: folds 
Gnourt93: raises 153 to 303
TURoff: folds 
carp10: calls 228
Jig@n: folds 
*** FLOP *** [6d Jh Ts]
carp10: checks 
Gnourt93: checks 
*** TURN *** [6d Jh Ts] [4h]
carp10: checks 
Gnourt93: bets 458
carp10: calls 458
*** RIVER *** [6d Jh Ts 4h] [8c]
carp10: bets 13319 and is all-in
Gnourt93: folds 
Uncalled bet (13319) returned to carp10
carp10 collected 1832 from pot
*** SUMMARY ***
Total pot 1832 | Rake 0 
Board [6d Jh Ts 4h 8c]
Seat 1: Jig@n (big blind) folded before Flop
Seat 2: fechter70 folded before Flop (didn't bet)
Seat 3: goodfet folded before Flop (didn't bet)
Seat 4: Zirte folded before Flop (didn't bet)
Seat 5: giannislena folded before Flop (didn't bet)
Seat 6: Gnourt93 folded on the River
Seat 7: TURoff (button) folded before Flop (didn't bet)
Seat 8: carp10 (small blind) collected (1832)





PokerStars Hand #177195943028: Tournament #2067822782, $1.00+$0.10 USD Hold'em No Limit - Level VIII (75/150) - 2017/10/21 20:09:35 CUST [2017/10/21 12:09:35 ET]
Table '2067822782 23' 9-max Seat #8 is the button
Seat 1: Jig@n (5819 in chips) 
Seat 2: fechter70 (7094 in chips) 
Seat 3: goodfet (2521 in chips) 
Seat 4: Zirte (3281 in chips) 
Seat 5: giannislena (2435 in chips) 
Seat 6: Gnourt93 (5969 in chips) 
Seat 7: TURoff (3310 in chips) 
Seat 8: carp10 (15151 in chips) 
Seat 9: Zhyszhak (3000 in chips) out of hand (moved from another table into small blind)
Jig@n: posts the ante 20
fechter70: posts the ante 20
goodfet: posts the ante 20
Zirte: posts the ante 20
giannislena: posts the ante 20
Gnourt93: posts the ante 20
TURoff: posts the ante 20
carp10: posts the ante 20
Jig@n: posts small blind 75
fechter70: posts big blind 150
*** HOLE CARDS ***
Dealt to TURoff [5s 3d]
goodfet: raises 150 to 300
Zirte: folds 
giannislena: folds 
Gnourt93: folds 
TURoff: folds 
carp10: folds 
Jig@n: folds 
fechter70: calls 150
*** FLOP *** [Ks Qd 8d]
fechter70: checks 
goodfet: checks 
*** TURN *** [Ks Qd 8d] [Qh]
fechter70: bets 150
goodfet: calls 150
*** RIVER *** [Ks Qd 8d Qh] [8s]
fechter70: checks 
goodfet: checks 
*** SHOW DOWN ***
fechter70: shows [2s 2c] (two pair, Queens and Eights)
goodfet: shows [Ah Js] (two pair, Queens and Eights - Ace kicker)
goodfet collected 1135 from pot
*** SUMMARY ***
Total pot 1135 | Rake 0 
Board [Ks Qd 8d Qh 8s]
Seat 1: Jig@n (small blind) folded before Flop
Seat 2: fechter70 (big blind) showed [2s 2c] and lost with two pair, Queens and Eights
Seat 3: goodfet showed [Ah Js] and won (1135) with two pair, Queens and Eights
Seat 4: Zirte folded before Flop (didn't bet)
Seat 5: giannislena folded before Flop (didn't bet)
Seat 6: Gnourt93 folded before Flop (didn't bet)
Seat 7: TURoff folded before Flop (didn't bet)
Seat 8: carp10 (button) folded before Flop (didn't bet)





PokerStars Hand #177195975363: Tournament #2067822782, $1.00+$0.10 USD Hold'em No Limit - Level VIII (75/150) - 2017/10/21 20:10:23 CUST [2017/10/21 12:10:23 ET]
Table '2067822782 23' 9-max Seat #1 is the button
Seat 1: Jig@n (5724 in chips) 
Seat 2: fechter70 (6624 in chips) 
Seat 3: goodfet (3186 in chips) 
Seat 4: Zirte (3261 in chips) 
Seat 5: giannislena (2415 in chips) 
Seat 6: Gnourt93 (5949 in chips) 
Seat 7: TURoff (3290 in chips) 
Seat 8: carp10 (15131 in chips) 
Seat 9: Zhyszhak (3000 in chips) 
Jig@n: posts the ante 20
fechter70: posts the ante 20
goodfet: posts the ante 20
Zirte: posts the ante 20
giannislena: posts the ante 20
Gnourt93: posts the ante 20
TURoff: posts the ante 20
carp10: posts the ante 20
Zhyszhak: posts the ante 20
fechter70: posts small blind 75
goodfet: posts big blind 150
*** HOLE CARDS ***
Dealt to TURoff [Kc 4c]
Zirte: raises 150 to 300
giannislena: raises 2095 to 2395 and is all-in
Gnourt93: folds 
TURoff: folds 
carp10: folds 
Zhyszhak: folds 
Jig@n: folds 
fechter70: folds 
goodfet: folds 
Zirte: calls 2095
*** FLOP *** [Qs Kh Js]
*** TURN *** [Qs Kh Js] [Qh]
*** RIVER *** [Qs Kh Js Qh] [Ah]
*** SHOW DOWN ***
Zirte: shows [Ac Kd] (two pair, Aces and Kings)
giannislena: shows [7c 7h] (two pair, Queens and Sevens)
Zirte collected 5195 from pot
giannislena finished the tournament
*** SUMMARY ***
Total pot 5195 | Rake 0 
Board [Qs Kh Js Qh Ah]
Seat 1: Jig@n (button) folded before Flop (didn't bet)
Seat 2: fechter70 (small blind) folded before Flop
Seat 3: goodfet (big blind) folded before Flop
Seat 4: Zirte showed [Ac Kd] and won (5195) with two pair, Aces and Kings
Seat 5: giannislena showed [7c 7h] and lost with two pair, Queens and Sevens
Seat 6: Gnourt93 folded before Flop (didn't bet)
Seat 7: TURoff folded before Flop (didn't bet)
Seat 8: carp10 folded before Flop (didn't bet)
Seat 9: Zhyszhak folded before Flop (didn't bet)





PokerStars Hand #177196001292: Tournament #2067822782, $1.00+$0.10 USD Hold'em No Limit - Level VIII (75/150) - 2017/10/21 20:11:02 CUST [2017/10/21 12:11:02 ET]
Table '2067822782 23' 9-max Seat #2 is the button
Seat 1: Jig@n (5704 in chips) 
Seat 2: fechter70 (6529 in chips) 
Seat 3: goodfet (3016 in chips) 
Seat 4: Zirte (6041 in chips) 
Seat 6: Gnourt93 (5929 in chips) 
Seat 7: TURoff (3270 in chips) 
Seat 8: carp10 (15111 in chips) 
Seat 9: Zhyszhak (2980 in chips) 
Jig@n: posts the ante 20
fechter70: posts the ante 20
goodfet: posts the ante 20
Zirte: posts the ante 20
Gnourt93: posts the ante 20
TURoff: posts the ante 20
carp10: posts the ante 20
Zhyszhak: posts the ante 20
goodfet: posts small blind 75
Zirte: posts big blind 150
*** HOLE CARDS ***
Dealt to TURoff [2h Qs]
Gnourt93: folds 
TURoff: folds 
carp10: folds 
Zhyszhak: folds 
Jig@n: folds 
fechter70: folds 
goodfet: raises 150 to 300
Zirte: calls 150
*** FLOP *** [5c 4d 4h]
goodfet: bets 450
Zirte: calls 450
*** TURN *** [5c 4d 4h] [6c]
goodfet: checks 
Zirte: bets 450
goodfet: calls 450
*** RIVER *** [5c 4d 4h 6c] [2s]
goodfet: checks 
Zirte: checks 
*** SHOW DOWN ***
goodfet: shows [Qh Ad] (a pair of Fours)
Zirte: shows [7h 7c] (two pair, Sevens and Fours)
Zirte collected 2560 from pot
*** SUMMARY ***
Total pot 2560 | Rake 0 
Board [5c 4d 4h 6c 2s]
Seat 1: Jig@n folded before Flop (didn't bet)
Seat 2: fechter70 (button) folded before Flop (didn't bet)
Seat 3: goodfet (small blind) showed [Qh Ad] and lost with a pair of Fours
Seat 4: Zirte (big blind) showed [7h 7c] and won (2560) with two pair, Sevens and Fours
Seat 6: Gnourt93 folded before Flop (didn't bet)
Seat 7: TURoff folded before Flop (didn't bet)
Seat 8: carp10 folded before Flop (didn't bet)
Seat 9: Zhyszhak folded before Flop (didn't bet)





PokerStars Hand #177196041548: Tournament #2067822782, $1.00+$0.10 USD Hold'em No Limit - Level VIII (75/150) - 2017/10/21 20:12:02 CUST [2017/10/21 12:12:02 ET]
Table '2067822782 23' 9-max Seat #3 is the button
Seat 1: Jig@n (5684 in chips) 
Seat 2: fechter70 (6509 in chips) 
Seat 3: goodfet (1796 in chips) 
Seat 4: Zirte (7381 in chips) 
Seat 5: KREZ 911 (3000 in chips) 
Seat 6: Gnourt93 (5909 in chips) 
Seat 7: TURoff (3250 in chips) 
Seat 8: carp10 (15091 in chips) 
Seat 9: Zhyszhak (2960 in chips) 
Jig@n: posts the ante 20
fechter70: posts the ante 20
goodfet: posts the ante 20
Zirte: posts the ante 20
KREZ 911: posts the ante 20
Gnourt93: posts the ante 20
TURoff: posts the ante 20
carp10: posts the ante 20
Zhyszhak: posts the ante 20
Zirte: posts small blind 75
KREZ 911: posts big blind 150
*** HOLE CARDS ***
Dealt to TURoff [5c 3c]
Gnourt93: folds 
TURoff: folds 
carp10: folds 
Zhyszhak: raises 180 to 330
Jig@n: folds 
fechter70: folds 
goodfet: folds 
Zirte: folds 
KREZ 911: calls 180
*** FLOP *** [9h 9c Kd]
KREZ 911: bets 1050
Zhyszhak: folds 
Uncalled bet (1050) returned to KREZ 911
KREZ 911 collected 915 from pot
KREZ 911: doesn't show hand 
*** SUMMARY ***
Total pot 915 | Rake 0 
Board [9h 9c Kd]
Seat 1: Jig@n folded before Flop (didn't bet)
Seat 2: fechter70 folded before Flop (didn't bet)
Seat 3: goodfet (button) folded before Flop (didn't bet)
Seat 4: Zirte (small blind) folded before Flop
Seat 5: KREZ 911 (big blind) collected (915)
Seat 6: Gnourt93 folded before Flop (didn't bet)
Seat 7: TURoff folded before Flop (didn't bet)
Seat 8: carp10 folded before Flop (didn't bet)
Seat 9: Zhyszhak folded on the Flop





PokerStars Hand #177196078175: Tournament #2067822782, $1.00+$0.10 USD Hold'em No Limit - Level VIII (75/150) - 2017/10/21 20:12:57 CUST [2017/10/21 12:12:57 ET]
Table '2067822782 23' 9-max Seat #4 is the button
Seat 1: Jig@n (5664 in chips) 
Seat 2: fechter70 (6489 in chips) 
Seat 3: goodfet (1776 in chips) 
Seat 4: Zirte (7286 in chips) 
Seat 5: KREZ 911 (3565 in chips) 
Seat 6: Gnourt93 (5889 in chips) 
Seat 7: TURoff (3230 in chips) 
Seat 8: carp10 (15071 in chips) 
Seat 9: Zhyszhak (2610 in chips) 
Jig@n: posts the ante 20
fechter70: posts the ante 20
goodfet: posts the ante 20
Zirte: posts the ante 20
KREZ 911: posts the ante 20
Gnourt93: posts the ante 20
TURoff: posts the ante 20
carp10: posts the ante 20
Zhyszhak: posts the ante 20
KREZ 911: posts small blind 75
Gnourt93: posts big blind 150
*** HOLE CARDS ***
Dealt to TURoff [Jh 5d]
TURoff: folds 
carp10: folds 
Zhyszhak: raises 150 to 300
Jig@n: folds 
fechter70: folds 
goodfet: folds 
Zirte: folds 
KREZ 911: calls 225
Gnourt93: calls 150
*** FLOP *** [Ac 9s 4c]
KREZ 911: bets 450
Gnourt93: folds 
Zhyszhak: folds 
Uncalled bet (450) returned to KREZ 911
KREZ 911 collected 1080 from pot
KREZ 911: doesn't show hand 
*** SUMMARY ***
Total pot 1080 | Rake 0 
Board [Ac 9s 4c]
Seat 1: Jig@n folded before Flop (didn't bet)
Seat 2: fechter70 folded before Flop (didn't bet)
Seat 3: goodfet folded before Flop (didn't bet)
Seat 4: Zirte (button) folded before Flop (didn't bet)
Seat 5: KREZ 911 (small blind) collected (1080)
Seat 6: Gnourt93 (big blind) folded on the Flop
Seat 7: TURoff folded before Flop (didn't bet)
Seat 8: carp10 folded before Flop (didn't bet)
Seat 9: Zhyszhak folded on the Flop





PokerStars Hand #177196121849: Tournament #2067822782, $1.00+$0.10 USD Hold'em No Limit - Level VIII (75/150) - 2017/10/21 20:14:02 CUST [2017/10/21 12:14:02 ET]
Table '2067822782 23' 9-max Seat #5 is the button
Seat 1: Jig@n (5644 in chips) 
Seat 2: fechter70 (6469 in chips) 
Seat 3: goodfet (1756 in chips) 
Seat 4: Zirte (7266 in chips) 
Seat 5: KREZ 911 (4325 in chips) 
Seat 6: Gnourt93 (5569 in chips) 
Seat 7: TURoff (3210 in chips) 
Seat 8: carp10 (15051 in chips) 
Seat 9: Zhyszhak (2290 in chips) 
Jig@n: posts the ante 20
fechter70: posts the ante 20
goodfet: posts the ante 20
Zirte: posts the ante 20
KREZ 911: posts the ante 20
Gnourt93: posts the ante 20
TURoff: posts the ante 20
carp10: posts the ante 20
Zhyszhak: posts the ante 20
Gnourt93: posts small blind 75
TURoff: posts big blind 150
*** HOLE CARDS ***
Dealt to TURoff [8h 2d]
carp10 has timed out
carp10: folds 
carp10 is sitting out
Zhyszhak: folds 
carp10 has returned
Jig@n: folds 
fechter70: folds 
goodfet: folds 
Zirte: folds 
KREZ 911: calls 150
Gnourt93: calls 75
TURoff: checks 
*** FLOP *** [Ah 6d 2s]
Gnourt93: checks 
TURoff: checks 
KREZ 911: bets 450
Gnourt93: folds 
TURoff: folds 
Uncalled bet (450) returned to KREZ 911
KREZ 911 collected 630 from pot
KREZ 911: doesn't show hand 
*** SUMMARY ***
Total pot 630 | Rake 0 
Board [Ah 6d 2s]
Seat 1: Jig@n folded before Flop (didn't bet)
Seat 2: fechter70 folded before Flop (didn't bet)
Seat 3: goodfet folded before Flop (didn't bet)
Seat 4: Zirte folded before Flop (didn't bet)
Seat 5: KREZ 911 (button) collected (630)
Seat 6: Gnourt93 (small blind) folded on the Flop
Seat 7: TURoff (big blind) folded on the Flop
Seat 8: carp10 folded before Flop (didn't bet)
Seat 9: Zhyszhak folded before Flop (didn't bet)





PokerStars Hand #177196161097: Tournament #2067822782, $1.00+$0.10 USD Hold'em No Limit - Level IX (100/200) - 2017/10/21 20:15:01 CUST [2017/10/21 12:15:01 ET]
Table '2067822782 23' 9-max Seat #6 is the button
Seat 1: Jig@n (5624 in chips) 
Seat 2: fechter70 (6449 in chips) 
Seat 3: goodfet (1736 in chips) 
Seat 4: Zirte (7246 in chips) 
Seat 5: KREZ 911 (4785 in chips) 
Seat 6: Gnourt93 (5399 in chips) 
Seat 7: TURoff (3040 in chips) 
Seat 8: carp10 (15031 in chips) 
Seat 9: Zhyszhak (2270 in chips) 
Jig@n: posts the ante 25
fechter70: posts the ante 25
goodfet: posts the ante 25
Zirte: posts the ante 25
KREZ 911: posts the ante 25
Gnourt93: posts the ante 25
TURoff: posts the ante 25
carp10: posts the ante 25
Zhyszhak: posts the ante 25
TURoff: posts small blind 100
carp10: posts big blind 200
*** HOLE CARDS ***
Dealt to TURoff [6h 3d]
Zhyszhak: folds 
Jig@n: folds 
fechter70: folds 
goodfet: folds 
Zirte: calls 200
KREZ 911: calls 200
Gnourt93: folds 
TURoff: folds 
carp10: checks 
*** FLOP *** [2c 7h 3s]
carp10: checks 
Zirte: checks 
KREZ 911: bets 400
carp10: calls 400
Zirte: folds 
*** TURN *** [2c 7h 3s] [8c]
carp10: checks 
KREZ 911: bets 200
carp10: calls 200
*** RIVER *** [2c 7h 3s 8c] [Kh]
carp10: checks 
KREZ 911: bets 200
carp10: calls 200
*** SHOW DOWN ***
KREZ 911: shows [7s Th] (a pair of Sevens)
carp10: mucks hand 
KREZ 911 collected 2525 from pot
*** SUMMARY ***
Total pot 2525 | Rake 0 
Board [2c 7h 3s 8c Kh]
Seat 1: Jig@n folded before Flop (didn't bet)
Seat 2: fechter70 folded before Flop (didn't bet)
Seat 3: goodfet folded before Flop (didn't bet)
Seat 4: Zirte folded on the Flop
Seat 5: KREZ 911 showed [7s Th] and won (2525) with a pair of Sevens
Seat 6: Gnourt93 (button) folded before Flop (didn't bet)
Seat 7: TURoff (small blind) folded before Flop
Seat 8: carp10 (big blind) mucked [6d 6s]
Seat 9: Zhyszhak folded before Flop (didn't bet)





PokerStars Hand #177196199768: Tournament #2067822782, $1.00+$0.10 USD Hold'em No Limit - Level IX (100/200) - 2017/10/21 20:15:59 CUST [2017/10/21 12:15:59 ET]
Table '2067822782 23' 9-max Seat #7 is the button
Seat 1: Jig@n (5599 in chips) 
Seat 2: fechter70 (6424 in chips) 
Seat 3: goodfet (1711 in chips) 
Seat 4: Zirte (7021 in chips) 
Seat 5: KREZ 911 (6285 in chips) 
Seat 6: Gnourt93 (5374 in chips) 
Seat 7: TURoff (2915 in chips) 
Seat 8: carp10 (14006 in chips) 
Seat 9: Zhyszhak (2245 in chips) 
Jig@n: posts the ante 25
fechter70: posts the ante 25
goodfet: posts the ante 25
Zirte: posts the ante 25
KREZ 911: posts the ante 25
Gnourt93: posts the ante 25
TURoff: posts the ante 25
carp10: posts the ante 25
Zhyszhak: posts the ante 25
carp10: posts small blind 100
Zhyszhak: posts big blind 200
*** HOLE CARDS ***
Dealt to TURoff [8s Qc]
Jig@n: folds 
fechter70: folds 
goodfet: folds 
Zirte: folds 
KREZ 911: calls 200
Gnourt93: folds 
TURoff: folds 
carp10: calls 100
Zhyszhak: checks 
*** FLOP *** [6h 4s Kh]
carp10 has timed out
carp10: checks 
Zhyszhak: checks 
KREZ 911: bets 200
carp10: folds 
Zhyszhak: calls 200
*** TURN *** [6h 4s Kh] [3c]
Zhyszhak: checks 
KREZ 911: bets 400
Zhyszhak: raises 1420 to 1820 and is all-in
KREZ 911: folds 
Uncalled bet (1420) returned to Zhyszhak
Zhyszhak collected 2025 from pot
Zhyszhak: doesn't show hand 
*** SUMMARY ***
Total pot 2025 | Rake 0 
Board [6h 4s Kh 3c]
Seat 1: Jig@n folded before Flop (didn't bet)
Seat 2: fechter70 folded before Flop (didn't bet)
Seat 3: goodfet folded before Flop (didn't bet)
Seat 4: Zirte folded before Flop (didn't bet)
Seat 5: KREZ 911 folded on the Turn
Seat 6: Gnourt93 folded before Flop (didn't bet)
Seat 7: TURoff (button) folded before Flop (didn't bet)
Seat 8: carp10 (small blind) folded on the Flop
Seat 9: Zhyszhak (big blind) collected (2025)





PokerStars Hand #177196246681: Tournament #2067822782, $1.00+$0.10 USD Hold'em No Limit - Level IX (100/200) - 2017/10/21 20:17:09 CUST [2017/10/21 12:17:09 ET]
Table '2067822782 23' 9-max Seat #8 is the button
Seat 1: Jig@n (5574 in chips) 
Seat 2: fechter70 (6399 in chips) 
Seat 3: goodfet (1686 in chips) 
Seat 4: Zirte (6996 in chips) 
Seat 5: KREZ 911 (5460 in chips) 
Seat 6: Gnourt93 (5349 in chips) 
Seat 7: TURoff (2890 in chips) 
Seat 8: carp10 (13781 in chips) 
Seat 9: Zhyszhak (3445 in chips) 
Jig@n: posts the ante 25
fechter70: posts the ante 25
goodfet: posts the ante 25
Zirte: posts the ante 25
KREZ 911: posts the ante 25
Gnourt93: posts the ante 25
TURoff: posts the ante 25
carp10: posts the ante 25
Zhyszhak: posts the ante 25
Zhyszhak: posts small blind 100
Jig@n: posts big blind 200
*** HOLE CARDS ***
Dealt to TURoff [Jd Qd]
fechter70: folds 
goodfet: folds 
Zirte: folds 
KREZ 911: folds 
Gnourt93: folds 
TURoff: raises 2665 to 2865 and is all-in
carp10: folds 
Zhyszhak: folds 
Jig@n: folds 
Uncalled bet (2665) returned to TURoff
TURoff collected 725 from pot
TURoff: doesn't show hand 
*** SUMMARY ***
Total pot 725 | Rake 0 
Seat 1: Jig@n (big blind) folded before Flop
Seat 2: fechter70 folded before Flop (didn't bet)
Seat 3: goodfet folded before Flop (didn't bet)
Seat 4: Zirte folded before Flop (didn't bet)
Seat 5: KREZ 911 folded before Flop (didn't bet)
Seat 6: Gnourt93 folded before Flop (didn't bet)
Seat 7: TURoff collected (725)
Seat 8: carp10 (button) folded before Flop (didn't bet)
Seat 9: Zhyszhak (small blind) folded before Flop





PokerStars Hand #177196259889: Tournament #2067822782, $1.00+$0.10 USD Hold'em No Limit - Level IX (100/200) - 2017/10/21 20:17:29 CUST [2017/10/21 12:17:29 ET]
Table '2067822782 23' 9-max Seat #9 is the button
Seat 1: Jig@n (5349 in chips) 
Seat 2: fechter70 (6374 in chips) 
Seat 3: goodfet (1661 in chips) 
Seat 4: Zirte (6971 in chips) 
Seat 5: KREZ 911 (5435 in chips) 
Seat 6: Gnourt93 (5324 in chips) 
Seat 7: TURoff (3390 in chips) 
Seat 8: carp10 (13756 in chips) 
Seat 9: Zhyszhak (3320 in chips) 
Jig@n: posts the ante 25
fechter70: posts the ante 25
goodfet: posts the ante 25
Zirte: posts the ante 25
KREZ 911: posts the ante 25
Gnourt93: posts the ante 25
TURoff: posts the ante 25
carp10: posts the ante 25
Zhyszhak: posts the ante 25
Jig@n: posts small blind 100
fechter70: posts big blind 200
*** HOLE CARDS ***
Dealt to TURoff [Qh 7c]
goodfet: folds 
Zirte: folds 
KREZ 911: raises 200 to 400
Gnourt93: folds 
TURoff: folds 
carp10: folds 
Zhyszhak: folds 
Jig@n: calls 300
fechter70: folds 
*** FLOP *** [6d 7d Kc]
Jig@n: checks 
KREZ 911: bets 800
Jig@n: folds 
Uncalled bet (800) returned to KREZ 911
KREZ 911 collected 1225 from pot
KREZ 911: doesn't show hand 
*** SUMMARY ***
Total pot 1225 | Rake 0 
Board [6d 7d Kc]
Seat 1: Jig@n (small blind) folded on the Flop
Seat 2: fechter70 (big blind) folded before Flop
Seat 3: goodfet folded before Flop (didn't bet)
Seat 4: Zirte folded before Flop (didn't bet)
Seat 5: KREZ 911 collected (1225)
Seat 6: Gnourt93 folded before Flop (didn't bet)
Seat 7: TURoff folded before Flop (didn't bet)
Seat 8: carp10 folded before Flop (didn't bet)
Seat 9: Zhyszhak (button) folded before Flop (didn't bet)





PokerStars Hand #177196289044: Tournament #2067822782, $1.00+$0.10 USD Hold'em No Limit - Level IX (100/200) - 2017/10/21 20:18:12 CUST [2017/10/21 12:18:12 ET]
Table '2067822782 23' 9-max Seat #1 is the button
Seat 1: Jig@n (4924 in chips) 
Seat 2: fechter70 (6149 in chips) 
Seat 3: goodfet (1636 in chips) 
Seat 4: Zirte (6946 in chips) 
Seat 5: KREZ 911 (6235 in chips) 
Seat 6: Gnourt93 (5299 in chips) 
Seat 7: TURoff (3365 in chips) 
Seat 8: carp10 (13731 in chips) 
Seat 9: Zhyszhak (3295 in chips) 
Jig@n: posts the ante 25
fechter70: posts the ante 25
goodfet: posts the ante 25
Zirte: posts the ante 25
KREZ 911: posts the ante 25
Gnourt93: posts the ante 25
TURoff: posts the ante 25
carp10: posts the ante 25
Zhyszhak: posts the ante 25
fechter70: posts small blind 100
goodfet: posts big blind 200
*** HOLE CARDS ***
Dealt to TURoff [4s Ts]
Zirte: folds 
KREZ 911: calls 200
Gnourt93: folds 
TURoff: folds 
carp10: raises 925 to 1125
Zhyszhak: folds 
Jig@n: folds 
fechter70: folds 
goodfet: folds 
KREZ 911: calls 925
*** FLOP *** [9s 6d As]
KREZ 911: checks 
carp10: checks 
*** TURN *** [9s 6d As] [7c]
KREZ 911: checks 
carp10: checks 
*** RIVER *** [9s 6d As 7c] [6c]
KREZ 911: bets 800
carp10: calls 800
*** SHOW DOWN ***
KREZ 911: shows [Qh Tc] (a pair of Sixes)
carp10: shows [Jd Jh] (two pair, Jacks and Sixes)
carp10 collected 4375 from pot
*** SUMMARY ***
Total pot 4375 | Rake 0 
Board [9s 6d As 7c 6c]
Seat 1: Jig@n (button) folded before Flop (didn't bet)
Seat 2: fechter70 (small blind) folded before Flop
Seat 3: goodfet (big blind) folded before Flop
Seat 4: Zirte folded before Flop (didn't bet)
Seat 5: KREZ 911 showed [Qh Tc] and lost with a pair of Sixes
Seat 6: Gnourt93 folded before Flop (didn't bet)
Seat 7: TURoff folded before Flop (didn't bet)
Seat 8: carp10 showed [Jd Jh] and won (4375) with two pair, Jacks and Sixes
Seat 9: Zhyszhak folded before Flop (didn't bet)





PokerStars Hand #177196339906: Tournament #2067822782, $1.00+$0.10 USD Hold'em No Limit - Level IX (100/200) - 2017/10/21 20:19:28 CUST [2017/10/21 12:19:28 ET]
Table '2067822782 23' 9-max Seat #2 is the button
Seat 1: Jig@n (4899 in chips) 
Seat 2: fechter70 (6024 in chips) 
Seat 3: goodfet (1411 in chips) 
Seat 4: Zirte (6921 in chips) 
Seat 5: KREZ 911 (4285 in chips) 
Seat 6: Gnourt93 (5274 in chips) 
Seat 7: TURoff (3340 in chips) 
Seat 8: carp10 (16156 in chips) 
Seat 9: Zhyszhak (3270 in chips) 
Jig@n: posts the ante 25
fechter70: posts the ante 25
goodfet: posts the ante 25
Zirte: posts the ante 25
KREZ 911: posts the ante 25
Gnourt93: posts the ante 25
TURoff: posts the ante 25
carp10: posts the ante 25
Zhyszhak: posts the ante 25
goodfet: posts small blind 100
Zirte: posts big blind 200
*** HOLE CARDS ***
Dealt to TURoff [6c 6d]
KREZ 911: raises 200 to 400
Gnourt93: folds 
TURoff: raises 2915 to 3315 and is all-in
carp10: folds 
Zhyszhak: folds 
Jig@n: folds 
fechter70: folds 
goodfet: folds 
Zirte: folds 
KREZ 911: calls 2915
*** FLOP *** [Qc 8d Ad]
*** TURN *** [Qc 8d Ad] [Qs]
*** RIVER *** [Qc 8d Ad Qs] [Kd]
*** SHOW DOWN ***
KREZ 911: shows [9s As] (two pair, Aces and Queens)
TURoff: shows [6c 6d] (two pair, Queens and Sixes)
KREZ 911 collected 7155 from pot
TURoff finished the tournament
*** SUMMARY ***
Total pot 7155 | Rake 0 
Board [Qc 8d Ad Qs Kd]
Seat 1: Jig@n folded before Flop (didn't bet)
Seat 2: fechter70 (button) folded before Flop (didn't bet)
Seat 3: goodfet (small blind) folded before Flop
Seat 4: Zirte (big blind) folded before Flop
Seat 5: KREZ 911 showed [9s As] and won (7155) with two pair, Aces and Queens
Seat 6: Gnourt93 folded before Flop (didn't bet)
Seat 7: TURoff showed [6c 6d] and lost with two pair, Queens and Sixes
Seat 8: carp10 folded before Flop (didn't bet)
Seat 9: Zhyszhak folded before Flop (didn't bet)





PokerStars Hand #177196392528: Tournament #2067822782, $1.00+$0.10 USD Hold'em No Limit - Level IX (100/200) - 2017/10/21 20:20:46 CUST [2017/10/21 12:20:46 ET]
Table '2067822782 23' 9-max Seat #4 is the button
Seat 1: Jig@n (4849 in chips) 
Seat 2: fechter70 (5974 in chips) 
Seat 4: Zirte (6571 in chips) 
Seat 5: KREZ 911 (9636 in chips) 
Seat 6: Gnourt93 (5224 in chips) 
Seat 7: TURoff (3000 in chips) 
Seat 8: carp10 (16106 in chips) 
Seat 9: Zhyszhak (3220 in chips) 
Jig@n: posts the ante 25
fechter70: posts the ante 25
Zirte: posts the ante 25
KREZ 911: posts the ante 25
Gnourt93: posts the ante 25
TURoff: posts the ante 25
carp10: posts the ante 25
Zhyszhak: posts the ante 25
KREZ 911: posts small blind 100
Gnourt93: posts big blind 200
*** HOLE CARDS ***
Dealt to TURoff [Jh Qh]
TURoff: raises 2775 to 2975 and is all-in
carp10: raises 2775 to 5750
Zhyszhak: folds 
Jig@n: folds 
fechter70: folds 
Zirte: folds 
KREZ 911: folds 
Gnourt93: folds 
Uncalled bet (2775) returned to carp10
*** FLOP *** [8s 4c 7c]
*** TURN *** [8s 4c 7c] [Ks]
*** RIVER *** [8s 4c 7c Ks] [8c]
*** SHOW DOWN ***
TURoff: shows [Jh Qh] (a pair of Eights)
carp10: shows [Ad Kd] (two pair, Kings and Eights)
carp10 collected 6450 from pot
TURoff finished the tournament
*** SUMMARY ***
Total pot 6450 | Rake 0 
Board [8s 4c 7c Ks 8c]
Seat 1: Jig@n folded before Flop (didn't bet)
Seat 2: fechter70 folded before Flop (didn't bet)
Seat 4: Zirte (button) folded before Flop (didn't bet)
Seat 5: KREZ 911 (small blind) folded before Flop
Seat 6: Gnourt93 (big blind) folded before Flop
Seat 7: TURoff showed [Jh Qh] and lost with a pair of Eights
Seat 8: carp10 showed [Ad Kd] and won (6450) with two pair, Kings and Eights
Seat 9: Zhyszhak folded before Flop (didn't bet)





PokerStars Hand #177196428565: Tournament #2067822782, $1.00+$0.10 USD Hold'em No Limit - Level IX (100/200) - 2017/10/21 20:21:39 CUST [2017/10/21 12:21:39 ET]
Table '2067822782 79' 9-max Seat #7 is the button
Seat 1: rikyrb (22626 in chips) 
Seat 2: mattyp1986 (17258 in chips) 
Seat 3: svarnojNSI (15383 in chips) 
Seat 4: TURoff (3000 in chips) 
Seat 5: DimaMonk84 (3504 in chips) 
Seat 7: meierflo (10520 in chips) 
Seat 8: XBrunoAlvesX (4840 in chips) 
Seat 9: dhilina (2355 in chips) 
rikyrb: posts the ante 25
mattyp1986: posts the ante 25
svarnojNSI: posts the ante 25
TURoff: posts the ante 25
DimaMonk84: posts the ante 25
meierflo: posts the ante 25
XBrunoAlvesX: posts the ante 25
dhilina: posts the ante 25
XBrunoAlvesX: posts small blind 100
dhilina: posts big blind 200
*** HOLE CARDS ***
Dealt to TURoff [2d 7c]
rikyrb: calls 200
mattyp1986: folds 
svarnojNSI: calls 200
TURoff: folds 
DimaMonk84: raises 3279 to 3479 and is all-in
meierflo: folds 
XBrunoAlvesX: folds 
dhilina: folds 
rikyrb: folds 
svarnojNSI: folds 
Uncalled bet (3279) returned to DimaMonk84
DimaMonk84 collected 1100 from pot
DimaMonk84: doesn't show hand 
*** SUMMARY ***
Total pot 1100 | Rake 0 
Seat 1: rikyrb folded before Flop
Seat 2: mattyp1986 folded before Flop (didn't bet)
Seat 3: svarnojNSI folded before Flop
Seat 4: TURoff folded before Flop (didn't bet)
Seat 5: DimaMonk84 collected (1100)
Seat 7: meierflo (button) folded before Flop (didn't bet)
Seat 8: XBrunoAlvesX (small blind) folded before Flop
Seat 9: dhilina (big blind) folded before Flop





PokerStars Hand #177196450327: Tournament #2067822782, $1.00+$0.10 USD Hold'em No Limit - Level IX (100/200) - 2017/10/21 20:22:11 CUST [2017/10/21 12:22:11 ET]
Table '2067822782 79' 9-max Seat #8 is the button
Seat 1: rikyrb (22401 in chips) 
Seat 2: mattyp1986 (17233 in chips) 
Seat 3: svarnojNSI (15158 in chips) 
Seat 4: TURoff (2975 in chips) 
Seat 5: DimaMonk84 (4379 in chips) 
Seat 6: milko1951952 (6010 in chips) 
Seat 7: meierflo (10495 in chips) 
Seat 8: XBrunoAlvesX (4715 in chips) 
Seat 9: dhilina (2130 in chips) 
rikyrb: posts the ante 25
mattyp1986: posts the ante 25
svarnojNSI: posts the ante 25
TURoff: posts the ante 25
DimaMonk84: posts the ante 25
milko1951952: posts the ante 25
meierflo: posts the ante 25
XBrunoAlvesX: posts the ante 25
dhilina: posts the ante 25
dhilina: posts small blind 100
rikyrb: posts big blind 200
*** HOLE CARDS ***
Dealt to TURoff [6s 6c]
mattyp1986: folds 
svarnojNSI: folds 
TURoff: raises 2750 to 2950 and is all-in
DimaMonk84: folds 
milko1951952: folds 
meierflo: folds 
XBrunoAlvesX: raises 1740 to 4690 and is all-in
dhilina: folds 
rikyrb: folds 
Uncalled bet (1740) returned to XBrunoAlvesX
*** FLOP *** [3h 6h Qc]
*** TURN *** [3h 6h Qc] [4h]
*** RIVER *** [3h 6h Qc 4h] [7d]
*** SHOW DOWN ***
TURoff: shows [6s 6c] (three of a kind, Sixes)
XBrunoAlvesX: shows [As Ah] (a pair of Aces)
TURoff collected 6425 from pot
*** SUMMARY ***
Total pot 6425 | Rake 0 
Board [3h 6h Qc 4h 7d]
Seat 1: rikyrb (big blind) folded before Flop
Seat 2: mattyp1986 folded before Flop (didn't bet)
Seat 3: svarnojNSI folded before Flop (didn't bet)
Seat 4: TURoff showed [6s 6c] and won (6425) with three of a kind, Sixes
Seat 5: DimaMonk84 folded before Flop (didn't bet)
Seat 6: milko1951952 folded before Flop (didn't bet)
Seat 7: meierflo folded before Flop (didn't bet)
Seat 8: XBrunoAlvesX (button) showed [As Ah] and lost with a pair of Aces
Seat 9: dhilina (small blind) folded before Flop





PokerStars Hand #177196474843: Tournament #2067822782, $1.00+$0.10 USD Hold'em No Limit - Level IX (100/200) - 2017/10/21 20:22:47 CUST [2017/10/21 12:22:47 ET]
Table '2067822782 79' 9-max Seat #9 is the button
Seat 1: rikyrb (22176 in chips) 
Seat 2: mattyp1986 (17208 in chips) 
Seat 3: svarnojNSI (15133 in chips) 
Seat 4: TURoff (6425 in chips) 
Seat 5: DimaMonk84 (4354 in chips) 
Seat 6: milko1951952 (5985 in chips) 
Seat 7: meierflo (10470 in chips) 
Seat 8: XBrunoAlvesX (1740 in chips) 
Seat 9: dhilina (2005 in chips) 
rikyrb: posts the ante 25
mattyp1986: posts the ante 25
svarnojNSI: posts the ante 25
TURoff: posts the ante 25
DimaMonk84: posts the ante 25
milko1951952: posts the ante 25
meierflo: posts the ante 25
XBrunoAlvesX: posts the ante 25
dhilina: posts the ante 25
rikyrb: posts small blind 100
mattyp1986: posts big blind 200
*** HOLE CARDS ***
Dealt to TURoff [Td 3h]
svarnojNSI: folds 
TURoff: folds 
DimaMonk84: folds 
milko1951952: calls 200
meierflo: folds 
XBrunoAlvesX: folds 
dhilina: folds 
rikyrb: raises 600 to 800
mattyp1986: folds 
milko1951952: calls 600
*** FLOP *** [7c 8s 2s]
rikyrb: bets 1013
milko1951952: folds 
Uncalled bet (1013) returned to rikyrb
rikyrb collected 2025 from pot
*** SUMMARY ***
Total pot 2025 | Rake 0 
Board [7c 8s 2s]
Seat 1: rikyrb (small blind) collected (2025)
Seat 2: mattyp1986 (big blind) folded before Flop
Seat 3: svarnojNSI folded before Flop (didn't bet)
Seat 4: TURoff folded before Flop (didn't bet)
Seat 5: DimaMonk84 folded before Flop (didn't bet)
Seat 6: milko1951952 folded on the Flop
Seat 7: meierflo folded before Flop (didn't bet)
Seat 8: XBrunoAlvesX folded before Flop (didn't bet)
Seat 9: dhilina (button) folded before Flop (didn't bet)





PokerStars Hand #177196503414: Tournament #2067822782, $1.00+$0.10 USD Hold'em No Limit - Level IX (100/200) - 2017/10/21 20:23:29 CUST [2017/10/21 12:23:29 ET]
Table '2067822782 79' 9-max Seat #1 is the button
Seat 1: rikyrb (23376 in chips) 
Seat 2: mattyp1986 (16983 in chips) 
Seat 3: svarnojNSI (15108 in chips) 
Seat 4: TURoff (6400 in chips) 
Seat 5: DimaMonk84 (4329 in chips) 
Seat 6: milko1951952 (5160 in chips) 
Seat 7: meierflo (10445 in chips) 
Seat 8: XBrunoAlvesX (1715 in chips) 
Seat 9: dhilina (1980 in chips) 
rikyrb: posts the ante 25
mattyp1986: posts the ante 25
svarnojNSI: posts the ante 25
TURoff: posts the ante 25
DimaMonk84: posts the ante 25
milko1951952: posts the ante 25
meierflo: posts the ante 25
XBrunoAlvesX: posts the ante 25
dhilina: posts the ante 25
mattyp1986: posts small blind 100
svarnojNSI: posts big blind 200
*** HOLE CARDS ***
Dealt to TURoff [9s Tc]
TURoff: folds 
DimaMonk84: folds 
milko1951952: calls 200
meierflo: folds 
XBrunoAlvesX: folds 
dhilina: raises 200 to 400
rikyrb: folds 
mattyp1986: raises 1425 to 1825
svarnojNSI: folds 
milko1951952: folds 
dhilina: folds 
Uncalled bet (1425) returned to mattyp1986
mattyp1986 collected 1425 from pot
mattyp1986: doesn't show hand 
*** SUMMARY ***
Total pot 1425 | Rake 0 
Seat 1: rikyrb (button) folded before Flop (didn't bet)
Seat 2: mattyp1986 (small blind) collected (1425)
Seat 3: svarnojNSI (big blind) folded before Flop
Seat 4: TURoff folded before Flop (didn't bet)
Seat 5: DimaMonk84 folded before Flop (didn't bet)
Seat 6: milko1951952 folded before Flop
Seat 7: meierflo folded before Flop (didn't bet)
Seat 8: XBrunoAlvesX folded before Flop (didn't bet)
Seat 9: dhilina folded before Flop





PokerStars Hand #177196542360: Tournament #2067822782, $1.00+$0.10 USD Hold'em No Limit - Level IX (100/200) - 2017/10/21 20:24:27 CUST [2017/10/21 12:24:27 ET]
Table '2067822782 79' 9-max Seat #2 is the button
Seat 1: rikyrb (23351 in chips) 
Seat 2: mattyp1986 (17983 in chips) 
Seat 3: svarnojNSI (14883 in chips) 
Seat 4: TURoff (6375 in chips) 
Seat 5: DimaMonk84 (4304 in chips) 
Seat 6: milko1951952 (4935 in chips) 
Seat 7: meierflo (10420 in chips) 
Seat 8: XBrunoAlvesX (1690 in chips) 
Seat 9: dhilina (1555 in chips) 
rikyrb: posts the ante 25
mattyp1986: posts the ante 25
svarnojNSI: posts the ante 25
TURoff: posts the ante 25
DimaMonk84: posts the ante 25
milko1951952: posts the ante 25
meierflo: posts the ante 25
XBrunoAlvesX: posts the ante 25
dhilina: posts the ante 25
svarnojNSI: posts small blind 100
TURoff: posts big blind 200
*** HOLE CARDS ***
Dealt to TURoff [Th 4s]
DimaMonk84: folds 
milko1951952: calls 200
meierflo: raises 500 to 700
XBrunoAlvesX: folds 
dhilina: folds 
rikyrb: folds 
mattyp1986: folds 
svarnojNSI: folds 
TURoff: folds 
milko1951952: calls 500
*** FLOP *** [2d 6h Ah]
milko1951952: checks 
meierflo: bets 1078
milko1951952: calls 1078
*** TURN *** [2d 6h Ah] [Kh]
milko1951952: checks 
meierflo: bets 3755
milko1951952: calls 3132 and is all-in
Uncalled bet (623) returned to meierflo
*** RIVER *** [2d 6h Ah Kh] [9c]
*** SHOW DOWN ***
milko1951952: shows [9h Ac] (two pair, Aces and Nines)
meierflo: shows [Kd As] (two pair, Aces and Kings)
meierflo collected 10345 from pot
milko1951952 finished the tournament
*** SUMMARY ***
Total pot 10345 | Rake 0 
Board [2d 6h Ah Kh 9c]
Seat 1: rikyrb folded before Flop (didn't bet)
Seat 2: mattyp1986 (button) folded before Flop (didn't bet)
Seat 3: svarnojNSI (small blind) folded before Flop
Seat 4: TURoff (big blind) folded before Flop
Seat 5: DimaMonk84 folded before Flop (didn't bet)
Seat 6: milko1951952 showed [9h Ac] and lost with two pair, Aces and Nines
Seat 7: meierflo showed [Kd As] and won (10345) with two pair, Aces and Kings
Seat 8: XBrunoAlvesX folded before Flop (didn't bet)
Seat 9: dhilina folded before Flop (didn't bet)





PokerStars Hand #177196578023: Tournament #2067822782, $1.00+$0.10 USD Hold'em No Limit - Level X (125/250) - 2017/10/21 20:25:20 CUST [2017/10/21 12:25:20 ET]
Table '2067822782 79' 9-max Seat #3 is the button
Seat 1: rikyrb (23326 in chips) 
Seat 2: mattyp1986 (17958 in chips) 
Seat 3: svarnojNSI (14758 in chips) 
Seat 4: TURoff (6150 in chips) 
Seat 5: DimaMonk84 (4279 in chips) 
Seat 7: meierflo (15830 in chips) 
Seat 8: XBrunoAlvesX (1665 in chips) 
Seat 9: dhilina (1530 in chips) 
rikyrb: posts the ante 30
mattyp1986: posts the ante 30
svarnojNSI: posts the ante 30
TURoff: posts the ante 30
DimaMonk84: posts the ante 30
meierflo: posts the ante 30
XBrunoAlvesX: posts the ante 30
dhilina: posts the ante 30
TURoff: posts small blind 125
DimaMonk84: posts big blind 250
*** HOLE CARDS ***
Dealt to TURoff [5s 9c]
meierflo: raises 317 to 567
XBrunoAlvesX: folds 
dhilina: raises 933 to 1500 and is all-in
rikyrb: folds 
mattyp1986: folds 
svarnojNSI: folds 
TURoff: folds 
DimaMonk84: folds 
meierflo: calls 933
*** FLOP *** [Tc 5h 3c]
*** TURN *** [Tc 5h 3c] [6s]
*** RIVER *** [Tc 5h 3c 6s] [Ac]
*** SHOW DOWN ***
meierflo: shows [6d 6h] (three of a kind, Sixes)
dhilina: shows [Ad Kh] (a pair of Aces)
meierflo collected 3615 from pot
dhilina finished the tournament
*** SUMMARY ***
Total pot 3615 | Rake 0 
Board [Tc 5h 3c 6s Ac]
Seat 1: rikyrb folded before Flop (didn't bet)
Seat 2: mattyp1986 folded before Flop (didn't bet)
Seat 3: svarnojNSI (button) folded before Flop (didn't bet)
Seat 4: TURoff (small blind) folded before Flop
Seat 5: DimaMonk84 (big blind) folded before Flop
Seat 7: meierflo showed [6d 6h] and won (3615) with three of a kind, Sixes
Seat 8: XBrunoAlvesX folded before Flop (didn't bet)
Seat 9: dhilina showed [Ad Kh] and lost with a pair of Aces





PokerStars Hand #177196600919: Tournament #2067822782, $1.00+$0.10 USD Hold'em No Limit - Level X (125/250) - 2017/10/21 20:25:54 CUST [2017/10/21 12:25:54 ET]
Table '2067822782 79' 9-max Seat #4 is the button
Seat 1: rikyrb (23296 in chips) 
Seat 2: mattyp1986 (17928 in chips) 
Seat 3: svarnojNSI (14728 in chips) 
Seat 4: TURoff (5995 in chips) 
Seat 5: DimaMonk84 (3999 in chips) 
Seat 6: Nando_demm (3000 in chips) 
Seat 7: meierflo (17915 in chips) 
Seat 8: XBrunoAlvesX (1635 in chips) 
rikyrb: posts the ante 30
mattyp1986: posts the ante 30
svarnojNSI: posts the ante 30
TURoff: posts the ante 30
DimaMonk84: posts the ante 30
Nando_demm: posts the ante 30
meierflo: posts the ante 30
XBrunoAlvesX: posts the ante 30
DimaMonk84: posts small blind 125
Nando_demm: posts big blind 250
*** HOLE CARDS ***
Dealt to TURoff [9h 8s]
meierflo: folds 
XBrunoAlvesX: folds 
rikyrb: folds 
mattyp1986: folds 
svarnojNSI: raises 250 to 500
TURoff: folds 
DimaMonk84: raises 3469 to 3969 and is all-in
Nando_demm: calls 2720 and is all-in
svarnojNSI: calls 3469
*** FLOP *** [6d Kh Ts]
*** TURN *** [6d Kh Ts] [5s]
*** RIVER *** [6d Kh Ts 5s] [Qh]
*** SHOW DOWN ***
DimaMonk84: shows [4d 4h] (a pair of Fours)
svarnojNSI: shows [Qc As] (a pair of Queens)
svarnojNSI collected 1998 from side pot
Nando_demm: shows [Ac Qs] (a pair of Queens)
Nando_demm collected 4575 from main pot
svarnojNSI collected 4575 from main pot
DimaMonk84 finished the tournament
*** SUMMARY ***
Total pot 11148 Main pot 9150. Side pot 1998. | Rake 0 
Board [6d Kh Ts 5s Qh]
Seat 1: rikyrb folded before Flop (didn't bet)
Seat 2: mattyp1986 folded before Flop (didn't bet)
Seat 3: svarnojNSI showed [Qc As] and won (6573) with a pair of Queens
Seat 4: TURoff (button) folded before Flop (didn't bet)
Seat 5: DimaMonk84 (small blind) showed [4d 4h] and lost with a pair of Fours
Seat 6: Nando_demm (big blind) showed [Ac Qs] and won (4575) with a pair of Queens
Seat 7: meierflo folded before Flop (didn't bet)
Seat 8: XBrunoAlvesX folded before Flop (didn't bet)





PokerStars Hand #177196621842: Tournament #2067822782, $1.00+$0.10 USD Hold'em No Limit - Level X (125/250) - 2017/10/21 20:26:25 CUST [2017/10/21 12:26:25 ET]
Table '2067822782 79' 9-max Seat #6 is the button
Seat 1: rikyrb (23266 in chips) 
Seat 2: mattyp1986 (17898 in chips) 
Seat 3: svarnojNSI (17302 in chips) 
Seat 4: TURoff (5965 in chips) 
Seat 6: Nando_demm (4575 in chips) 
Seat 7: meierflo (17885 in chips) 
Seat 8: XBrunoAlvesX (1605 in chips) 
Seat 9: achkas (3000 in chips) 
rikyrb: posts the ante 30
mattyp1986: posts the ante 30
svarnojNSI: posts the ante 30
TURoff: posts the ante 30
Nando_demm: posts the ante 30
meierflo: posts the ante 30
XBrunoAlvesX: posts the ante 30
achkas: posts the ante 30
meierflo: posts small blind 125
XBrunoAlvesX: posts big blind 250
*** HOLE CARDS ***
Dealt to TURoff [7d Ac]
achkas: folds 
rikyrb: raises 250 to 500
mattyp1986: folds 
svarnojNSI: calls 500
TURoff: folds 
Nando_demm: folds 
meierflo: folds 
XBrunoAlvesX: raises 1075 to 1575 and is all-in
rikyrb: calls 1075
svarnojNSI: calls 1075
*** FLOP *** [Qs Qh 6d]
rikyrb: bets 500
svarnojNSI: calls 500
*** TURN *** [Qs Qh 6d] [7h]
rikyrb: bets 1000
svarnojNSI: calls 1000
*** RIVER *** [Qs Qh 6d 7h] [8s]
rikyrb: bets 2000
svarnojNSI: calls 2000
*** SHOW DOWN ***
rikyrb: shows [Js Jh] (two pair, Queens and Jacks)
svarnojNSI: mucks hand 
rikyrb collected 7000 from side pot
XBrunoAlvesX: shows [Kc Qd] (three of a kind, Queens)
XBrunoAlvesX collected 5090 from main pot
*** SUMMARY ***
Total pot 12090 Main pot 5090. Side pot 7000. | Rake 0 
Board [Qs Qh 6d 7h 8s]
Seat 1: rikyrb showed [Js Jh] and won (7000) with two pair, Queens and Jacks
Seat 2: mattyp1986 folded before Flop (didn't bet)
Seat 3: svarnojNSI mucked [As 7s]
Seat 4: TURoff folded before Flop (didn't bet)
Seat 6: Nando_demm (button) folded before Flop (didn't bet)
Seat 7: meierflo (small blind) folded before Flop
Seat 8: XBrunoAlvesX (big blind) showed [Kc Qd] and won (5090) with three of a kind, Queens
Seat 9: achkas folded before Flop (didn't bet)





PokerStars Hand #177196653613: Tournament #2067822782, $1.00+$0.10 USD Hold'em No Limit - Level X (125/250) - 2017/10/21 20:27:12 CUST [2017/10/21 12:27:12 ET]
Table '2067822782 79' 9-max Seat #7 is the button
Seat 1: rikyrb (25161 in chips) 
Seat 2: mattyp1986 (17868 in chips) 
Seat 3: svarnojNSI (12197 in chips) 
Seat 4: TURoff (5935 in chips) 
Seat 5: 31Kostya89 (3000 in chips) 
Seat 6: Nando_demm (4545 in chips) 
Seat 7: meierflo (17730 in chips) 
Seat 8: XBrunoAlvesX (5090 in chips) 
Seat 9: achkas (2970 in chips) 
rikyrb: posts the ante 30
mattyp1986: posts the ante 30
svarnojNSI: posts the ante 30
TURoff: posts the ante 30
31Kostya89: posts the ante 30
Nando_demm: posts the ante 30
meierflo: posts the ante 30
XBrunoAlvesX: posts the ante 30
achkas: posts the ante 30
XBrunoAlvesX: posts small blind 125
achkas: posts big blind 250
*** HOLE CARDS ***
Dealt to TURoff [7c Td]
rikyrb: folds 
mattyp1986: folds 
svarnojNSI: calls 250
TURoff: folds 
31Kostya89: folds 
Nando_demm: folds 
meierflo: folds 
XBrunoAlvesX: calls 125
achkas: raises 750 to 1000
svarnojNSI: calls 750
XBrunoAlvesX: folds 
*** FLOP *** [5s Jd Ac]
achkas: bets 1940 and is all-in
svarnojNSI: calls 1940
*** TURN *** [5s Jd Ac] [7d]
*** RIVER *** [5s Jd Ac 7d] [Qs]
*** SHOW DOWN ***
achkas: shows [Kd Ks] (a pair of Kings)
svarnojNSI: shows [As 2c] (a pair of Aces)
svarnojNSI collected 6400 from pot
achkas finished the tournament
*** SUMMARY ***
Total pot 6400 | Rake 0 
Board [5s Jd Ac 7d Qs]
Seat 1: rikyrb folded before Flop (didn't bet)
Seat 2: mattyp1986 folded before Flop (didn't bet)
Seat 3: svarnojNSI showed [As 2c] and won (6400) with a pair of Aces
Seat 4: TURoff folded before Flop (didn't bet)
Seat 5: 31Kostya89 folded before Flop (didn't bet)
Seat 6: Nando_demm folded before Flop (didn't bet)
Seat 7: meierflo (button) folded before Flop (didn't bet)
Seat 8: XBrunoAlvesX (small blind) folded before Flop
Seat 9: achkas (big blind) showed [Kd Ks] and lost with a pair of Kings





PokerStars Hand #177196718737: Tournament #2067822782, $1.00+$0.10 USD Hold'em No Limit - Level X (125/250) - 2017/10/21 20:28:49 CUST [2017/10/21 12:28:49 ET]
Table '2067822782 47' 9-max Seat #8 is the button
Seat 1: BAM-LEE168 (4262 in chips) 
Seat 2: CheeDDou (6458 in chips) 
Seat 3: TURoff (5905 in chips) 
Seat 4: MMGimvp (4659 in chips) 
Seat 5: barchezi (22211 in chips) 
Seat 6: fabianoajf (2983 in chips) 
Seat 7: grassi59 (3000 in chips) 
Seat 8: AferisT032 (21821 in chips) 
Seat 9: vlad0505 (7554 in chips) 
BAM-LEE168: posts the ante 30
CheeDDou: posts the ante 30
TURoff: posts the ante 30
MMGimvp: posts the ante 30
barchezi: posts the ante 30
fabianoajf: posts the ante 30
grassi59: posts the ante 30
AferisT032: posts the ante 30
vlad0505: posts the ante 30
vlad0505: posts small blind 125
BAM-LEE168: posts big blind 250
*** HOLE CARDS ***
Dealt to TURoff [5h 2c]
CheeDDou: folds 
TURoff: folds 
MMGimvp: folds 
barchezi: calls 250
fabianoajf: folds 
grassi59: folds 
AferisT032: folds 
vlad0505: calls 125
BAM-LEE168: raises 3982 to 4232 and is all-in
barchezi: calls 3982
vlad0505: folds 
*** FLOP *** [6h 7s 6s]
*** TURN *** [6h 7s 6s] [Th]
*** RIVER *** [6h 7s 6s Th] [2s]
*** SHOW DOWN ***
BAM-LEE168: shows [9c Ad] (a pair of Sixes)
barchezi: shows [Kd Qh] (a pair of Sixes - lower kicker)
BAM-LEE168 collected 8984 from pot
*** SUMMARY ***
Total pot 8984 | Rake 0 
Board [6h 7s 6s Th 2s]
Seat 1: BAM-LEE168 (big blind) showed [9c Ad] and won (8984) with a pair of Sixes
Seat 2: CheeDDou folded before Flop (didn't bet)
Seat 3: TURoff folded before Flop (didn't bet)
Seat 4: MMGimvp folded before Flop (didn't bet)
Seat 5: barchezi showed [Kd Qh] and lost with a pair of Sixes
Seat 6: fabianoajf folded before Flop (didn't bet)
Seat 7: grassi59 folded before Flop (didn't bet)
Seat 8: AferisT032 (button) folded before Flop (didn't bet)
Seat 9: vlad0505 (small blind) folded before Flop





PokerStars Hand #177196757042: Tournament #2067822782, $1.00+$0.10 USD Hold'em No Limit - Level X (125/250) - 2017/10/21 20:29:45 CUST [2017/10/21 12:29:45 ET]
Table '2067822782 47' 9-max Seat #9 is the button
Seat 1: BAM-LEE168 (8984 in chips) 
Seat 2: CheeDDou (6428 in chips) 
Seat 3: TURoff (5875 in chips) 
Seat 4: MMGimvp (4629 in chips) 
Seat 5: barchezi (17949 in chips) 
Seat 6: fabianoajf (2953 in chips) 
Seat 7: grassi59 (2970 in chips) 
Seat 8: AferisT032 (21791 in chips) 
Seat 9: vlad0505 (7274 in chips) 
BAM-LEE168: posts the ante 30
CheeDDou: posts the ante 30
TURoff: posts the ante 30
MMGimvp: posts the ante 30
barchezi: posts the ante 30
fabianoajf: posts the ante 30
grassi59: posts the ante 30
AferisT032: posts the ante 30
vlad0505: posts the ante 30
BAM-LEE168: posts small blind 125
CheeDDou: posts big blind 250
*** HOLE CARDS ***
Dealt to TURoff [7c Qd]
TURoff: folds 
MMGimvp: folds 
barchezi: calls 250
fabianoajf: folds 
grassi59: folds 
AferisT032: calls 250
vlad0505: calls 250
BAM-LEE168: calls 125
CheeDDou: checks 
*** FLOP *** [8s 3h Ts]
BAM-LEE168: checks 
CheeDDou: checks 
barchezi: checks 
AferisT032: bets 500
vlad0505: folds 
BAM-LEE168: calls 500
CheeDDou: folds 
barchezi: calls 500
*** TURN *** [8s 3h Ts] [Qh]
BAM-LEE168: checks 
barchezi: checks 
AferisT032: bets 250
BAM-LEE168: folds 
barchezi: calls 250
*** RIVER *** [8s 3h Ts Qh] [5s]
barchezi: checks 
AferisT032: checks 
*** SHOW DOWN ***
barchezi: shows [Qc 9s] (a pair of Queens)
AferisT032: shows [9c Tc] (a pair of Tens)
barchezi collected 3520 from pot
*** SUMMARY ***
Total pot 3520 | Rake 0 
Board [8s 3h Ts Qh 5s]
Seat 1: BAM-LEE168 (small blind) folded on the Turn
Seat 2: CheeDDou (big blind) folded on the Flop
Seat 3: TURoff folded before Flop (didn't bet)
Seat 4: MMGimvp folded before Flop (didn't bet)
Seat 5: barchezi showed [Qc 9s] and won (3520) with a pair of Queens
Seat 6: fabianoajf folded before Flop (didn't bet)
Seat 7: grassi59 folded before Flop (didn't bet)
Seat 8: AferisT032 showed [9c Tc] and lost with a pair of Tens
Seat 9: vlad0505 (button) folded on the Flop





PokerStars Hand #177196819692: Tournament #2067822782, $1.00+$0.10 USD Hold'em No Limit - Level X (125/250) - 2017/10/21 20:31:17 CUST [2017/10/21 12:31:17 ET]
Table '2067822782 47' 9-max Seat #1 is the button
Seat 1: BAM-LEE168 (8204 in chips) 
Seat 2: CheeDDou (6148 in chips) 
Seat 3: TURoff (5845 in chips) 
Seat 4: MMGimvp (4599 in chips) 
Seat 5: barchezi (20439 in chips) 
Seat 6: fabianoajf (2923 in chips) 
Seat 7: grassi59 (2940 in chips) 
Seat 8: AferisT032 (20761 in chips) 
Seat 9: vlad0505 (6994 in chips) 
BAM-LEE168: posts the ante 30
CheeDDou: posts the ante 30
TURoff: posts the ante 30
MMGimvp: posts the ante 30
barchezi: posts the ante 30
fabianoajf: posts the ante 30
grassi59: posts the ante 30
AferisT032: posts the ante 30
vlad0505: posts the ante 30
CheeDDou: posts small blind 125
TURoff: posts big blind 250
*** HOLE CARDS ***
Dealt to TURoff [3c Ts]
MMGimvp: folds 
barchezi: folds 
fabianoajf: folds 
grassi59: folds 
AferisT032: folds 
vlad0505: raises 250 to 500
BAM-LEE168: calls 500
CheeDDou: folds 
TURoff: folds 
*** FLOP *** [9d 2c 4h]
vlad0505: bets 750
BAM-LEE168: folds 
Uncalled bet (750) returned to vlad0505
vlad0505 collected 1645 from pot
vlad0505: doesn't show hand 
*** SUMMARY ***
Total pot 1645 | Rake 0 
Board [9d 2c 4h]
Seat 1: BAM-LEE168 (button) folded on the Flop
Seat 2: CheeDDou (small blind) folded before Flop
Seat 3: TURoff (big blind) folded before Flop
Seat 4: MMGimvp folded before Flop (didn't bet)
Seat 5: barchezi folded before Flop (didn't bet)
Seat 6: fabianoajf folded before Flop (didn't bet)
Seat 7: grassi59 folded before Flop (didn't bet)
Seat 8: AferisT032 folded before Flop (didn't bet)
Seat 9: vlad0505 collected (1645)





PokerStars Hand #177196854589: Tournament #2067822782, $1.00+$0.10 USD Hold'em No Limit - Level X (125/250) - 2017/10/21 20:32:08 CUST [2017/10/21 12:32:08 ET]
Table '2067822782 47' 9-max Seat #2 is the button
Seat 1: BAM-LEE168 (7674 in chips) 
Seat 2: CheeDDou (5993 in chips) 
Seat 3: TURoff (5565 in chips) 
Seat 4: MMGimvp (4569 in chips) 
Seat 5: barchezi (20409 in chips) 
Seat 6: fabianoajf (2893 in chips) 
Seat 7: grassi59 (2910 in chips) 
Seat 8: AferisT032 (20731 in chips) 
Seat 9: vlad0505 (8109 in chips) 
BAM-LEE168: posts the ante 30
CheeDDou: posts the ante 30
TURoff: posts the ante 30
MMGimvp: posts the ante 30
barchezi: posts the ante 30
fabianoajf: posts the ante 30
grassi59: posts the ante 30
AferisT032: posts the ante 30
vlad0505: posts the ante 30
TURoff: posts small blind 125
MMGimvp: posts big blind 250
*** HOLE CARDS ***
Dealt to TURoff [7h Tc]
barchezi: calls 250
fabianoajf: raises 250 to 500
grassi59: folds 
AferisT032: calls 500
vlad0505: folds 
BAM-LEE168: folds 
CheeDDou: folds 
TURoff: folds 
MMGimvp: folds 
barchezi: calls 250
*** FLOP *** [2s 5s 7d]
barchezi: checks 
fabianoajf: bets 2363 and is all-in
AferisT032: folds 
barchezi: calls 2363
*** TURN *** [2s 5s 7d] [Qc]
*** RIVER *** [2s 5s 7d Qc] [Td]
*** SHOW DOWN ***
barchezi: shows [4s 3s] (high card Queen)
fabianoajf: shows [9d 9h] (a pair of Nines)
fabianoajf collected 6871 from pot
*** SUMMARY ***
Total pot 6871 | Rake 0 
Board [2s 5s 7d Qc Td]
Seat 1: BAM-LEE168 folded before Flop (didn't bet)
Seat 2: CheeDDou (button) folded before Flop (didn't bet)
Seat 3: TURoff (small blind) folded before Flop
Seat 4: MMGimvp (big blind) folded before Flop
Seat 5: barchezi showed [4s 3s] and lost with high card Queen
Seat 6: fabianoajf showed [9d 9h] and won (6871) with a pair of Nines
Seat 7: grassi59 folded before Flop (didn't bet)
Seat 8: AferisT032 folded on the Flop
Seat 9: vlad0505 folded before Flop (didn't bet)





PokerStars Hand #177196895944: Tournament #2067822782, $1.00+$0.10 USD Hold'em No Limit - Level X (125/250) - 2017/10/21 20:33:03 CUST [2017/10/21 12:33:03 ET]
Table '2067822782 47' 9-max Seat #3 is the button
Seat 1: BAM-LEE168 (7644 in chips) 
Seat 2: CheeDDou (5963 in chips) 
Seat 3: TURoff (5410 in chips) 
Seat 4: MMGimvp (4289 in chips) 
Seat 5: barchezi (17516 in chips) 
Seat 6: fabianoajf (6871 in chips) 
Seat 7: grassi59 (2880 in chips) 
Seat 8: AferisT032 (20201 in chips) 
Seat 9: vlad0505 (8079 in chips) 
BAM-LEE168: posts the ante 30
CheeDDou: posts the ante 30
TURoff: posts the ante 30
MMGimvp: posts the ante 30
barchezi: posts the ante 30
fabianoajf: posts the ante 30
grassi59: posts the ante 30
AferisT032: posts the ante 30
vlad0505: posts the ante 30
MMGimvp: posts small blind 125
barchezi: posts big blind 250
*** HOLE CARDS ***
Dealt to TURoff [7d 8s]
fabianoajf: folds 
grassi59: folds 
AferisT032: folds 
vlad0505: raises 250 to 500
BAM-LEE168: folds 
CheeDDou: folds 
TURoff: folds 
MMGimvp: folds 
barchezi: calls 250
*** FLOP *** [7s 4d Kh]
barchezi: checks 
vlad0505: checks 
*** TURN *** [7s 4d Kh] [4s]
barchezi: checks 
vlad0505: bets 750
barchezi: folds 
Uncalled bet (750) returned to vlad0505
vlad0505 collected 1395 from pot
vlad0505: doesn't show hand 
*** SUMMARY ***
Total pot 1395 | Rake 0 
Board [7s 4d Kh 4s]
Seat 1: BAM-LEE168 folded before Flop (didn't bet)
Seat 2: CheeDDou folded before Flop (didn't bet)
Seat 3: TURoff (button) folded before Flop (didn't bet)
Seat 4: MMGimvp (small blind) folded before Flop
Seat 5: barchezi (big blind) folded on the Turn
Seat 6: fabianoajf folded before Flop (didn't bet)
Seat 7: grassi59 folded before Flop (didn't bet)
Seat 8: AferisT032 folded before Flop (didn't bet)
Seat 9: vlad0505 collected (1395)





PokerStars Hand #177196921700: Tournament #2067822782, $1.00+$0.10 USD Hold'em No Limit - Level X (125/250) - 2017/10/21 20:33:41 CUST [2017/10/21 12:33:41 ET]
Table '2067822782 47' 9-max Seat #4 is the button
Seat 1: BAM-LEE168 (7614 in chips) 
Seat 2: CheeDDou (5933 in chips) 
Seat 3: TURoff (5380 in chips) 
Seat 4: MMGimvp (4134 in chips) 
Seat 5: barchezi (16986 in chips) 
Seat 6: fabianoajf (6841 in chips) 
Seat 7: grassi59 (2850 in chips) 
Seat 8: AferisT032 (20171 in chips) 
Seat 9: vlad0505 (8944 in chips) 
BAM-LEE168: posts the ante 30
CheeDDou: posts the ante 30
TURoff: posts the ante 30
MMGimvp: posts the ante 30
barchezi: posts the ante 30
fabianoajf: posts the ante 30
grassi59: posts the ante 30
AferisT032: posts the ante 30
vlad0505: posts the ante 30
barchezi: posts small blind 125
fabianoajf: posts big blind 250
*** HOLE CARDS ***
Dealt to TURoff [Ac Ah]
grassi59: folds 
AferisT032: folds 
vlad0505: folds 
BAM-LEE168: folds 
CheeDDou: folds 
TURoff: raises 375 to 625
MMGimvp: folds 
barchezi: calls 500
fabianoajf: folds 
*** FLOP *** [Td Tc Ad]
barchezi: checks 
TURoff: checks 
*** TURN *** [Td Tc Ad] [2c]
barchezi: checks 
TURoff: bets 500
barchezi: folds 
Uncalled bet (500) returned to TURoff
TURoff collected 1770 from pot
TURoff: doesn't show hand 
*** SUMMARY ***
Total pot 1770 | Rake 0 
Board [Td Tc Ad 2c]
Seat 1: BAM-LEE168 folded before Flop (didn't bet)
Seat 2: CheeDDou folded before Flop (didn't bet)
Seat 3: TURoff collected (1770)
Seat 4: MMGimvp (button) folded before Flop (didn't bet)
Seat 5: barchezi (small blind) folded on the Turn
Seat 6: fabianoajf (big blind) folded before Flop
Seat 7: grassi59 folded before Flop (didn't bet)
Seat 8: AferisT032 folded before Flop (didn't bet)
Seat 9: vlad0505 folded before Flop (didn't bet)





PokerStars Hand #177196956444: Tournament #2067822782, $1.00+$0.10 USD Hold'em No Limit - Level X (125/250) - 2017/10/21 20:34:32 CUST [2017/10/21 12:34:32 ET]
Table '2067822782 47' 9-max Seat #5 is the button
Seat 1: BAM-LEE168 (7584 in chips) 
Seat 2: CheeDDou (5903 in chips) 
Seat 3: TURoff (6495 in chips) 
Seat 4: MMGimvp (4104 in chips) 
Seat 5: barchezi (16331 in chips) 
Seat 6: fabianoajf (6561 in chips) 
Seat 7: grassi59 (2820 in chips) 
Seat 8: AferisT032 (20141 in chips) 
Seat 9: vlad0505 (8914 in chips) 
BAM-LEE168: posts the ante 30
CheeDDou: posts the ante 30
TURoff: posts the ante 30
MMGimvp: posts the ante 30
barchezi: posts the ante 30
fabianoajf: posts the ante 30
grassi59: posts the ante 30
AferisT032: posts the ante 30
vlad0505: posts the ante 30
fabianoajf: posts small blind 125
grassi59: posts big blind 250
*** HOLE CARDS ***
Dealt to TURoff [6h Th]
AferisT032: folds 
vlad0505: folds 
BAM-LEE168: folds 
CheeDDou: folds 
TURoff: folds 
MMGimvp: raises 3824 to 4074 and is all-in
barchezi: calls 4074
fabianoajf: folds 
grassi59: calls 2540 and is all-in
*** FLOP *** [Kd Ad 5c]
*** TURN *** [Kd Ad 5c] [3c]
*** RIVER *** [Kd Ad 5c 3c] [4s]
*** SHOW DOWN ***
MMGimvp: shows [Js Jh] (a pair of Jacks)
barchezi: shows [Ah Qd] (a pair of Aces)
barchezi collected 2568 from side pot
grassi59: shows [6d 7d] (a straight, Three to Seven)
grassi59 collected 8765 from main pot
MMGimvp finished the tournament
*** SUMMARY ***
Total pot 11333 Main pot 8765. Side pot 2568. | Rake 0 
Board [Kd Ad 5c 3c 4s]
Seat 1: BAM-LEE168 folded before Flop (didn't bet)
Seat 2: CheeDDou folded before Flop (didn't bet)
Seat 3: TURoff folded before Flop (didn't bet)
Seat 4: MMGimvp showed [Js Jh] and lost with a pair of Jacks
Seat 5: barchezi (button) showed [Ah Qd] and won (2568) with a pair of Aces
Seat 6: fabianoajf (small blind) folded before Flop
Seat 7: grassi59 (big blind) showed [6d 7d] and won (8765) with a straight, Three to Seven
Seat 8: AferisT032 folded before Flop (didn't bet)
Seat 9: vlad0505 folded before Flop (didn't bet)





PokerStars Hand #177196993474: Tournament #2067822782, $1.00+$0.10 USD Hold'em No Limit - Level XI (150/300) - 2017/10/21 20:35:27 CUST [2017/10/21 12:35:27 ET]
Table '2067822782 47' 9-max Seat #6 is the button
Seat 1: BAM-LEE168 (7554 in chips) 
Seat 2: CheeDDou (5873 in chips) 
Seat 3: TURoff (6465 in chips) 
Seat 4: patypacatatu (3000 in chips) 
Seat 5: barchezi (14795 in chips) 
Seat 6: fabianoajf (6406 in chips) 
Seat 7: grassi59 (8765 in chips) 
Seat 8: AferisT032 (20111 in chips) 
Seat 9: vlad0505 (8884 in chips) 
BAM-LEE168: posts the ante 40
CheeDDou: posts the ante 40
TURoff: posts the ante 40
patypacatatu: posts the ante 40
barchezi: posts the ante 40
fabianoajf: posts the ante 40
grassi59: posts the ante 40
AferisT032: posts the ante 40
vlad0505: posts the ante 40
grassi59: posts small blind 150
AferisT032: posts big blind 300
*** HOLE CARDS ***
Dealt to TURoff [6s Qd]
vlad0505: folds 
BAM-LEE168: folds 
CheeDDou: folds 
TURoff: folds 
patypacatatu: folds 
barchezi: folds 
fabianoajf: folds 
grassi59: raises 600 to 900
AferisT032: folds 
Uncalled bet (600) returned to grassi59
grassi59 collected 960 from pot
grassi59: doesn't show hand 
*** SUMMARY ***
Total pot 960 | Rake 0 
Seat 1: BAM-LEE168 folded before Flop (didn't bet)
Seat 2: CheeDDou folded before Flop (didn't bet)
Seat 3: TURoff folded before Flop (didn't bet)
Seat 4: patypacatatu folded before Flop (didn't bet)
Seat 5: barchezi folded before Flop (didn't bet)
Seat 6: fabianoajf (button) folded before Flop (didn't bet)
Seat 7: grassi59 (small blind) collected (960)
Seat 8: AferisT032 (big blind) folded before Flop
Seat 9: vlad0505 folded before Flop (didn't bet)





PokerStars Hand #177197019022: Tournament #2067822782, $1.00+$0.10 USD Hold'em No Limit - Level XI (150/300) - 2017/10/21 20:36:04 CUST [2017/10/21 12:36:04 ET]
Table '2067822782 47' 9-max Seat #7 is the button
Seat 1: BAM-LEE168 (7514 in chips) 
Seat 2: CheeDDou (5833 in chips) 
Seat 3: TURoff (6425 in chips) 
Seat 4: patypacatatu (2960 in chips) 
Seat 5: barchezi (14755 in chips) 
Seat 6: fabianoajf (6366 in chips) 
Seat 7: grassi59 (9385 in chips) 
Seat 8: AferisT032 (19771 in chips) 
Seat 9: vlad0505 (8844 in chips) 
BAM-LEE168: posts the ante 40
CheeDDou: posts the ante 40
TURoff: posts the ante 40
patypacatatu: posts the ante 40
barchezi: posts the ante 40
fabianoajf: posts the ante 40
grassi59: posts the ante 40
AferisT032: posts the ante 40
vlad0505: posts the ante 40
AferisT032: posts small blind 150
vlad0505: posts big blind 300
*** HOLE CARDS ***
Dealt to TURoff [3c 9c]
BAM-LEE168: calls 300
CheeDDou: folds 
TURoff: folds 
patypacatatu: raises 2620 to 2920 and is all-in
barchezi: folds 
fabianoajf: folds 
grassi59: folds 
AferisT032: folds 
vlad0505: folds 
BAM-LEE168: calls 2620
*** FLOP *** [4c 8d Th]
*** TURN *** [4c 8d Th] [9d]
*** RIVER *** [4c 8d Th 9d] [6c]
*** SHOW DOWN ***
BAM-LEE168: shows [6s Ts] (two pair, Tens and Sixes)
patypacatatu: shows [Qd Qs] (a pair of Queens)
BAM-LEE168 collected 6650 from pot
patypacatatu finished the tournament
*** SUMMARY ***
Total pot 6650 | Rake 0 
Board [4c 8d Th 9d 6c]
Seat 1: BAM-LEE168 showed [6s Ts] and won (6650) with two pair, Tens and Sixes
Seat 2: CheeDDou folded before Flop (didn't bet)
Seat 3: TURoff folded before Flop (didn't bet)
Seat 4: patypacatatu showed [Qd Qs] and lost with a pair of Queens
Seat 5: barchezi folded before Flop (didn't bet)
Seat 6: fabianoajf folded before Flop (didn't bet)
Seat 7: grassi59 (button) folded before Flop (didn't bet)
Seat 8: AferisT032 (small blind) folded before Flop
Seat 9: vlad0505 (big blind) folded before Flop





PokerStars Hand #177197043094: Tournament #2067822782, $1.00+$0.10 USD Hold'em No Limit - Level XI (150/300) - 2017/10/21 20:36:40 CUST [2017/10/21 12:36:40 ET]
Table '2067822782 47' 9-max Seat #8 is the button
Seat 1: BAM-LEE168 (11204 in chips) 
Seat 2: CheeDDou (5793 in chips) 
Seat 3: TURoff (6385 in chips) 
Seat 5: barchezi (14715 in chips) 
Seat 6: fabianoajf (6326 in chips) 
Seat 7: grassi59 (9345 in chips) 
Seat 8: AferisT032 (19581 in chips) 
Seat 9: vlad0505 (8504 in chips) 
BAM-LEE168: posts the ante 40
CheeDDou: posts the ante 40
TURoff: posts the ante 40
barchezi: posts the ante 40
fabianoajf: posts the ante 40
grassi59: posts the ante 40
AferisT032: posts the ante 40
vlad0505: posts the ante 40
vlad0505: posts small blind 150
BAM-LEE168: posts big blind 300
*** HOLE CARDS ***
Dealt to TURoff [Ac 6d]
BAM-LEE168 said, "lol"
CheeDDou: raises 300 to 600
TURoff: folds 
barchezi: folds 
fabianoajf: folds 
grassi59: folds 
AferisT032: calls 600
vlad0505: calls 450
BAM-LEE168: folds 
*** FLOP *** [6h Jh 7s]
vlad0505: checks 
CheeDDou: bets 750
AferisT032: calls 750
vlad0505: calls 750
*** TURN *** [6h Jh 7s] [Ad]
vlad0505: checks 
CheeDDou: bets 4403 and is all-in
AferisT032: calls 4403
vlad0505: folds 
*** RIVER *** [6h Jh 7s Ad] [7h]
*** SHOW DOWN ***
CheeDDou: shows [As Jd] (two pair, Aces and Jacks)
AferisT032: shows [8h 9h] (a flush, Jack high)
AferisT032 collected 13476 from pot
CheeDDou finished the tournament
*** SUMMARY ***
Total pot 13476 | Rake 0 
Board [6h Jh 7s Ad 7h]
Seat 1: BAM-LEE168 (big blind) folded before Flop
Seat 2: CheeDDou showed [As Jd] and lost with two pair, Aces and Jacks
Seat 3: TURoff folded before Flop (didn't bet)
Seat 5: barchezi folded before Flop (didn't bet)
Seat 6: fabianoajf folded before Flop (didn't bet)
Seat 7: grassi59 folded before Flop (didn't bet)
Seat 8: AferisT032 (button) showed [8h 9h] and won (13476) with a flush, Jack high
Seat 9: vlad0505 (small blind) folded on the Turn





PokerStars Hand #177197096341: Tournament #2067822782, $1.00+$0.10 USD Hold'em No Limit - Level XI (150/300) - 2017/10/21 20:37:58 CUST [2017/10/21 12:37:58 ET]
Table '2067822782 47' 9-max Seat #9 is the button
Seat 1: BAM-LEE168 (10864 in chips) 
Seat 3: TURoff (6345 in chips) 
Seat 4: 77_DM0N_77 (3000 in chips) 
Seat 5: barchezi (14675 in chips) 
Seat 6: fabianoajf (6286 in chips) 
Seat 7: grassi59 (9305 in chips) 
Seat 8: AferisT032 (27264 in chips) 
Seat 9: vlad0505 (7114 in chips) 
BAM-LEE168: posts the ante 40
TURoff: posts the ante 40
77_DM0N_77: posts the ante 40
barchezi: posts the ante 40
fabianoajf: posts the ante 40
grassi59: posts the ante 40
AferisT032: posts the ante 40
vlad0505: posts the ante 40
BAM-LEE168: posts small blind 150
TURoff: posts big blind 300
*** HOLE CARDS ***
Dealt to TURoff [6d 8d]
77_DM0N_77: calls 300
barchezi: folds 
fabianoajf: folds 
grassi59: calls 300
AferisT032: folds 
vlad0505: raises 1500 to 1800
BAM-LEE168: folds 
TURoff: folds 
77_DM0N_77: calls 1500
grassi59: calls 1500
*** FLOP *** [9c 2d Kh]
77_DM0N_77: bets 1160 and is all-in
grassi59: raises 1160 to 2320
vlad0505: folds 
Uncalled bet (1160) returned to grassi59
*** TURN *** [9c 2d Kh] [7d]
*** RIVER *** [9c 2d Kh 7d] [Jd]
*** SHOW DOWN ***
77_DM0N_77: shows [Ks Tc] (a pair of Kings)
grassi59: shows [Th Kc] (a pair of Kings)
77_DM0N_77 collected 4245 from pot
grassi59 collected 4245 from pot
*** SUMMARY ***
Total pot 8490 | Rake 0 
Board [9c 2d Kh 7d Jd]
Seat 1: BAM-LEE168 (small blind) folded before Flop
Seat 3: TURoff (big blind) folded before Flop
Seat 4: 77_DM0N_77 showed [Ks Tc] and won (4245) with a pair of Kings
Seat 5: barchezi folded before Flop (didn't bet)
Seat 6: fabianoajf folded before Flop (didn't bet)
Seat 7: grassi59 showed [Th Kc] and won (4245) with a pair of Kings
Seat 8: AferisT032 folded before Flop (didn't bet)
Seat 9: vlad0505 (button) folded on the Flop





PokerStars Hand #177197130655: Tournament #2067822782, $1.00+$0.10 USD Hold'em No Limit - Level XI (150/300) - 2017/10/21 20:38:49 CUST [2017/10/21 12:38:49 ET]
Table '2067822782 47' 9-max Seat #1 is the button
Seat 1: BAM-LEE168 (10674 in chips) 
Seat 2: TravisTrolc (3000 in chips) out of hand (moved from another table into small blind)
Seat 3: TURoff (6005 in chips) 
Seat 4: 77_DM0N_77 (4245 in chips) 
Seat 5: barchezi (14635 in chips) 
Seat 6: fabianoajf (6246 in chips) 
Seat 7: grassi59 (10550 in chips) 
Seat 8: AferisT032 (27224 in chips) 
Seat 9: vlad0505 (5274 in chips) 
BAM-LEE168: posts the ante 40
TURoff: posts the ante 40
77_DM0N_77: posts the ante 40
barchezi: posts the ante 40
fabianoajf: posts the ante 40
grassi59: posts the ante 40
AferisT032: posts the ante 40
vlad0505: posts the ante 40
TURoff: posts small blind 150
77_DM0N_77: posts big blind 300
*** HOLE CARDS ***
Dealt to TURoff [As Th]
barchezi: folds 
fabianoajf: folds 
grassi59: folds 
AferisT032: calls 300
vlad0505: calls 300
BAM-LEE168: calls 300
TURoff: raises 5665 to 5965 and is all-in
77_DM0N_77: folds 
AferisT032: calls 5665
vlad0505: folds 
BAM-LEE168: folds 
*** FLOP *** [5h 8s Ts]
*** TURN *** [5h 8s Ts] [Qs]
*** RIVER *** [5h 8s Ts Qs] [2c]
*** SHOW DOWN ***
TURoff: shows [As Th] (a pair of Tens)
AferisT032: shows [Kd Ac] (high card Ace)
TURoff collected 13150 from pot
*** SUMMARY ***
Total pot 13150 | Rake 0 
Board [5h 8s Ts Qs 2c]
Seat 1: BAM-LEE168 (button) folded before Flop
Seat 3: TURoff (small blind) showed [As Th] and won (13150) with a pair of Tens
Seat 4: 77_DM0N_77 (big blind) folded before Flop
Seat 5: barchezi folded before Flop (didn't bet)
Seat 6: fabianoajf folded before Flop (didn't bet)
Seat 7: grassi59 folded before Flop (didn't bet)
Seat 8: AferisT032 showed [Kd Ac] and lost with high card Ace
Seat 9: vlad0505 folded before Flop





PokerStars Hand #177197158666: Tournament #2067822782, $1.00+$0.10 USD Hold'em No Limit - Level XI (150/300) - 2017/10/21 20:39:30 CUST [2017/10/21 12:39:30 ET]
Table '2067822782 47' 9-max Seat #3 is the button
Seat 1: BAM-LEE168 (10334 in chips) 
Seat 2: TravisTrolc (3000 in chips) 
Seat 3: TURoff (13150 in chips) 
Seat 4: 77_DM0N_77 (3905 in chips) 
Seat 5: barchezi (14595 in chips) 
Seat 6: fabianoajf (6206 in chips) 
Seat 7: grassi59 (10510 in chips) 
Seat 8: AferisT032 (21219 in chips) 
Seat 9: vlad0505 (4934 in chips) 
BAM-LEE168: posts the ante 40
TravisTrolc: posts the ante 40
TURoff: posts the ante 40
77_DM0N_77: posts the ante 40
barchezi: posts the ante 40
fabianoajf: posts the ante 40
grassi59: posts the ante 40
AferisT032: posts the ante 40
vlad0505: posts the ante 40
77_DM0N_77: posts small blind 150
barchezi: posts big blind 300
*** HOLE CARDS ***
Dealt to TURoff [6s 7c]
AferisT032 said, "bred"
fabianoajf: folds 
grassi59: folds 
AferisT032: raises 300 to 600
vlad0505: calls 600
BAM-LEE168: calls 600
TravisTrolc: raises 300 to 900
TURoff: folds 
77_DM0N_77: folds 
barchezi: calls 600
AferisT032: calls 300
vlad0505: calls 300
BAM-LEE168: calls 300
*** FLOP *** [Jc Ts Tc]
barchezi: checks 
AferisT032: bets 600
vlad0505: folds 
BAM-LEE168: folds 
TravisTrolc: raises 1460 to 2060 and is all-in
barchezi: folds 
AferisT032: calls 1460
*** TURN *** [Jc Ts Tc] [Qc]
*** RIVER *** [Jc Ts Tc Qc] [4c]
*** SHOW DOWN ***
AferisT032: shows [Kh Qs] (two pair, Queens and Tens)
TravisTrolc: shows [2d Qd] (two pair, Queens and Tens - lower kicker)
AferisT032 collected 9130 from pot
TravisTrolc finished the tournament in 887th place
*** SUMMARY ***
Total pot 9130 | Rake 0 
Board [Jc Ts Tc Qc 4c]
Seat 1: BAM-LEE168 folded on the Flop
Seat 2: TravisTrolc showed [2d Qd] and lost with two pair, Queens and Tens
Seat 3: TURoff (button) folded before Flop (didn't bet)
Seat 4: 77_DM0N_77 (small blind) folded before Flop
Seat 5: barchezi (big blind) folded on the Flop
Seat 6: fabianoajf folded before Flop (didn't bet)
Seat 7: grassi59 folded before Flop (didn't bet)
Seat 8: AferisT032 showed [Kh Qs] and won (9130) with two pair, Queens and Tens
Seat 9: vlad0505 folded on the Flop





PokerStars Hand #177197213655: Tournament #2067822782, $1.00+$0.10 USD Hold'em No Limit - Level XI (150/300) - 2017/10/21 20:40:51 CUST [2017/10/21 12:40:51 ET]
Table '2067822782 47' 9-max Seat #4 is the button
Seat 1: BAM-LEE168 (9394 in chips) 
Seat 3: TURoff (13110 in chips) 
Seat 4: 77_DM0N_77 (3715 in chips) 
Seat 5: barchezi (13655 in chips) 
Seat 6: fabianoajf (6166 in chips) 
Seat 7: grassi59 (10470 in chips) 
Seat 8: AferisT032 (27349 in chips) 
Seat 9: vlad0505 (3994 in chips) 
BAM-LEE168: posts the ante 40
TURoff: posts the ante 40
77_DM0N_77: posts the ante 40
barchezi: posts the ante 40
fabianoajf: posts the ante 40
grassi59: posts the ante 40
AferisT032: posts the ante 40
vlad0505: posts the ante 40
barchezi: posts small blind 150
fabianoajf: posts big blind 300
*** HOLE CARDS ***
Dealt to TURoff [3d 9s]
grassi59: folds 
AferisT032: folds 
vlad0505: folds 
BAM-LEE168: calls 300
TURoff: folds 
77_DM0N_77: folds 
barchezi: folds 
fabianoajf: raises 5826 to 6126 and is all-in
BAM-LEE168: folds 
Uncalled bet (5826) returned to fabianoajf
fabianoajf collected 1070 from pot
fabianoajf: doesn't show hand 
*** SUMMARY ***
Total pot 1070 | Rake 0 
Seat 1: BAM-LEE168 folded before Flop
Seat 3: TURoff folded before Flop (didn't bet)
Seat 4: 77_DM0N_77 (button) folded before Flop (didn't bet)
Seat 5: barchezi (small blind) folded before Flop
Seat 6: fabianoajf (big blind) collected (1070)
Seat 7: grassi59 folded before Flop (didn't bet)
Seat 8: AferisT032 folded before Flop (didn't bet)
Seat 9: vlad0505 folded before Flop (didn't bet)





PokerStars Hand #177197231374: Tournament #2067822782, $1.00+$0.10 USD Hold'em No Limit - Level XI (150/300) - 2017/10/21 20:41:17 CUST [2017/10/21 12:41:17 ET]
Table '2067822782 47' 9-max Seat #5 is the button
Seat 1: BAM-LEE168 (9054 in chips) 
Seat 2: ChuckBassMD (6825 in chips) 
Seat 3: TURoff (13070 in chips) 
Seat 4: 77_DM0N_77 (3675 in chips) 
Seat 5: barchezi (13465 in chips) 
Seat 6: fabianoajf (6896 in chips) 
Seat 7: grassi59 (10430 in chips) 
Seat 8: AferisT032 (27309 in chips) 
Seat 9: vlad0505 (3954 in chips) 
BAM-LEE168: posts the ante 40
ChuckBassMD: posts the ante 40
TURoff: posts the ante 40
77_DM0N_77: posts the ante 40
barchezi: posts the ante 40
fabianoajf: posts the ante 40
grassi59: posts the ante 40
AferisT032: posts the ante 40
vlad0505: posts the ante 40
fabianoajf: posts small blind 150
grassi59: posts big blind 300
*** HOLE CARDS ***
Dealt to TURoff [5c Ah]
AferisT032: calls 300
vlad0505: calls 300
BAM-LEE168: folds 
ChuckBassMD: folds 
TURoff: folds 
77_DM0N_77: calls 300
barchezi: folds 
fabianoajf: calls 150
grassi59: checks 
*** FLOP *** [Kc 7d 3c]
fabianoajf: checks 
grassi59: checks 
AferisT032: bets 300
vlad0505: calls 300
77_DM0N_77: calls 300
fabianoajf: calls 300
grassi59: folds 
*** TURN *** [Kc 7d 3c] [4h]
fabianoajf: checks 
AferisT032: bets 600
vlad0505: calls 600
77_DM0N_77: folds 
fabianoajf: calls 600
*** RIVER *** [Kc 7d 3c 4h] [8d]
fabianoajf: bets 1604
AferisT032: raises 8068 to 9672
vlad0505: calls 2714 and is all-in
fabianoajf: folds 
Uncalled bet (6958) returned to AferisT032
*** SHOW DOWN ***
AferisT032: shows [5h 6h] (a straight, Four to Eight)
vlad0505: shows [5d 5s] (a pair of Fives)
AferisT032 collected 11892 from pot
vlad0505 finished the tournament in 820th place
*** SUMMARY ***
Total pot 11892 | Rake 0 
Board [Kc 7d 3c 4h 8d]
Seat 1: BAM-LEE168 folded before Flop (didn't bet)
Seat 2: ChuckBassMD folded before Flop (didn't bet)
Seat 3: TURoff folded before Flop (didn't bet)
Seat 4: 77_DM0N_77 folded on the Turn
Seat 5: barchezi (button) folded before Flop (didn't bet)
Seat 6: fabianoajf (small blind) folded on the River
Seat 7: grassi59 (big blind) folded on the Flop
Seat 8: AferisT032 showed [5h 6h] and won (11892) with a straight, Four to Eight
Seat 9: vlad0505 showed [5d 5s] and lost with a pair of Fives





PokerStars Hand #177197337956: Tournament #2067822782, $1.00+$0.10 USD Hold'em No Limit - Level XI (150/300) - 2017/10/21 20:43:54 CUST [2017/10/21 12:43:54 ET]
Table '2067822782 84' 9-max Seat #4 is the button
Seat 1: vizon_x (50563 in chips) 
Seat 2: I want more1 (11498 in chips) 
Seat 3: ZYBILO88 (7014 in chips) 
Seat 4: louis2307 (24815 in chips) 
Seat 5: TonyJYM (9105 in chips) 
Seat 6: mr.celeste (5774 in chips) 
Seat 7: Trap Sinatra (2857 in chips) 
Seat 8: Fd_Tomazetti (7666 in chips) 
Seat 9: TURoff (13030 in chips) 
vizon_x: posts the ante 40
I want more1: posts the ante 40
ZYBILO88: posts the ante 40
louis2307: posts the ante 40
TonyJYM: posts the ante 40
mr.celeste: posts the ante 40
Trap Sinatra: posts the ante 40
Fd_Tomazetti: posts the ante 40
TURoff: posts the ante 40
TonyJYM: posts small blind 150
mr.celeste: posts big blind 300
*** HOLE CARDS ***
Dealt to TURoff [2c Kd]
Trap Sinatra: folds 
Fd_Tomazetti: folds 
TURoff: folds 
vizon_x: folds 
I want more1: folds 
ZYBILO88: calls 300
louis2307: raises 1500 to 1800
TonyJYM: folds 
mr.celeste: folds 
ZYBILO88: folds 
Uncalled bet (1500) returned to louis2307
louis2307 collected 1410 from pot
louis2307: doesn't show hand 
*** SUMMARY ***
Total pot 1410 | Rake 0 
Seat 1: vizon_x folded before Flop (didn't bet)
Seat 2: I want more1 folded before Flop (didn't bet)
Seat 3: ZYBILO88 folded before Flop
Seat 4: louis2307 (button) collected (1410)
Seat 5: TonyJYM (small blind) folded before Flop
Seat 6: mr.celeste (big blind) folded before Flop
Seat 7: Trap Sinatra folded before Flop (didn't bet)
Seat 8: Fd_Tomazetti folded before Flop (didn't bet)
Seat 9: TURoff folded before Flop (didn't bet)





PokerStars Hand #177197390283: Tournament #2067822782, $1.00+$0.10 USD Hold'em No Limit - Level XII (200/400) - 2017/10/21 20:45:09 CUST [2017/10/21 12:45:09 ET]
Table '2067822782 84' 9-max Seat #5 is the button
Seat 1: vizon_x (50523 in chips) 
Seat 2: I want more1 (11458 in chips) 
Seat 3: ZYBILO88 (6674 in chips) 
Seat 4: louis2307 (25885 in chips) 
Seat 5: TonyJYM (8915 in chips) 
Seat 6: mr.celeste (5434 in chips) 
Seat 7: Trap Sinatra (2817 in chips) 
Seat 8: Fd_Tomazetti (7626 in chips) 
Seat 9: TURoff (12990 in chips) 
vizon_x: posts the ante 50
I want more1: posts the ante 50
ZYBILO88: posts the ante 50
louis2307: posts the ante 50
TonyJYM: posts the ante 50
mr.celeste: posts the ante 50
Trap Sinatra: posts the ante 50
Fd_Tomazetti: posts the ante 50
TURoff: posts the ante 50
mr.celeste: posts small blind 200
Trap Sinatra: posts big blind 400
*** HOLE CARDS ***
Dealt to TURoff [Th 2h]
Fd_Tomazetti: folds 
TURoff: folds 
vizon_x: folds 
I want more1: folds 
ZYBILO88: folds 
louis2307: folds 
TonyJYM: folds 
mr.celeste: raises 4984 to 5384 and is all-in
Trap Sinatra: calls 2367 and is all-in
Uncalled bet (2617) returned to mr.celeste
*** FLOP *** [4d As 5s]
*** TURN *** [4d As 5s] [Kd]
*** RIVER *** [4d As 5s Kd] [9s]
*** SHOW DOWN ***
mr.celeste: shows [4c 6h] (a pair of Fours)
Trap Sinatra: shows [4h Ah] (two pair, Aces and Fours)
Trap Sinatra collected 5984 from pot
*** SUMMARY ***
Total pot 5984 | Rake 0 
Board [4d As 5s Kd 9s]
Seat 1: vizon_x folded before Flop (didn't bet)
Seat 2: I want more1 folded before Flop (didn't bet)
Seat 3: ZYBILO88 folded before Flop (didn't bet)
Seat 4: louis2307 folded before Flop (didn't bet)
Seat 5: TonyJYM (button) folded before Flop (didn't bet)
Seat 6: mr.celeste (small blind) showed [4c 6h] and lost with a pair of Fours
Seat 7: Trap Sinatra (big blind) showed [4h Ah] and won (5984) with two pair, Aces and Fours
Seat 8: Fd_Tomazetti folded before Flop (didn't bet)
Seat 9: TURoff folded before Flop (didn't bet)





PokerStars Hand #177197435308: Tournament #2067822782, $1.00+$0.10 USD Hold'em No Limit - Level XII (200/400) - 2017/10/21 20:46:05 CUST [2017/10/21 12:46:05 ET]
Table '2067822782 84' 9-max Seat #6 is the button
Seat 1: vizon_x (50473 in chips) 
Seat 2: I want more1 (11408 in chips) 
Seat 3: ZYBILO88 (6624 in chips) 
Seat 4: louis2307 (25835 in chips) 
Seat 5: TonyJYM (8865 in chips) 
Seat 6: mr.celeste (2617 in chips) 
Seat 7: Trap Sinatra (5984 in chips) 
Seat 8: Fd_Tomazetti (7576 in chips) 
Seat 9: TURoff (12940 in chips) 
vizon_x: posts the ante 50
I want more1: posts the ante 50
ZYBILO88: posts the ante 50
louis2307: posts the ante 50
TonyJYM: posts the ante 50
mr.celeste: posts the ante 50
Trap Sinatra: posts the ante 50
Fd_Tomazetti: posts the ante 50
TURoff: posts the ante 50
Trap Sinatra: posts small blind 200
Fd_Tomazetti: posts big blind 400
*** HOLE CARDS ***
Dealt to TURoff [2d Ts]
TURoff: folds 
vizon_x: folds 
I want more1: raises 400 to 800
ZYBILO88: folds 
louis2307: folds 
TonyJYM: folds 
mr.celeste: folds 
Trap Sinatra: folds 
Fd_Tomazetti: folds 
Uncalled bet (400) returned to I want more1
I want more1 collected 1450 from pot
*** SUMMARY ***
Total pot 1450 | Rake 0 
Seat 1: vizon_x folded before Flop (didn't bet)
Seat 2: I want more1 collected (1450)
Seat 3: ZYBILO88 folded before Flop (didn't bet)
Seat 4: louis2307 folded before Flop (didn't bet)
Seat 5: TonyJYM folded before Flop (didn't bet)
Seat 6: mr.celeste (button) folded before Flop (didn't bet)
Seat 7: Trap Sinatra (small blind) folded before Flop
Seat 8: Fd_Tomazetti (big blind) folded before Flop
Seat 9: TURoff folded before Flop (didn't bet)





PokerStars Hand #177197458859: Tournament #2067822782, $1.00+$0.10 USD Hold'em No Limit - Level XII (200/400) - 2017/10/21 20:46:36 CUST [2017/10/21 12:46:36 ET]
Table '2067822782 84' 9-max Seat #7 is the button
Seat 1: vizon_x (50423 in chips) 
Seat 2: I want more1 (12408 in chips) 
Seat 3: ZYBILO88 (6574 in chips) 
Seat 4: louis2307 (25785 in chips) 
Seat 5: TonyJYM (8815 in chips) 
Seat 6: mr.celeste (2567 in chips) 
Seat 7: Trap Sinatra (5734 in chips) 
Seat 8: Fd_Tomazetti (7126 in chips) 
Seat 9: TURoff (12890 in chips) 
vizon_x: posts the ante 50
I want more1: posts the ante 50
ZYBILO88: posts the ante 50
louis2307: posts the ante 50
TonyJYM: posts the ante 50
mr.celeste: posts the ante 50
Trap Sinatra: posts the ante 50
Fd_Tomazetti: posts the ante 50
TURoff: posts the ante 50
Fd_Tomazetti: posts small blind 200
TURoff: posts big blind 400
*** HOLE CARDS ***
Dealt to TURoff [7h Ac]
vizon_x: folds 
I want more1: raises 522 to 922
ZYBILO88: folds 
louis2307: folds 
TonyJYM: folds 
mr.celeste: folds 
Trap Sinatra: folds 
Fd_Tomazetti: calls 722
TURoff: folds 
*** FLOP *** [Ts 7c 3d]
Fd_Tomazetti: checks 
I want more1: checks 
*** TURN *** [Ts 7c 3d] [6c]
Fd_Tomazetti: checks 
I want more1: checks 
*** RIVER *** [Ts 7c 3d 6c] [Jh]
Fd_Tomazetti: checks 
I want more1: checks 
*** SHOW DOWN ***
Fd_Tomazetti: shows [8s Ks] (high card King)
I want more1: shows [2h 2c] (a pair of Deuces)
I want more1 collected 2694 from pot
*** SUMMARY ***
Total pot 2694 | Rake 0 
Board [Ts 7c 3d 6c Jh]
Seat 1: vizon_x folded before Flop (didn't bet)
Seat 2: I want more1 showed [2h 2c] and won (2694) with a pair of Deuces
Seat 3: ZYBILO88 folded before Flop (didn't bet)
Seat 4: louis2307 folded before Flop (didn't bet)
Seat 5: TonyJYM folded before Flop (didn't bet)
Seat 6: mr.celeste folded before Flop (didn't bet)
Seat 7: Trap Sinatra (button) folded before Flop (didn't bet)
Seat 8: Fd_Tomazetti (small blind) showed [8s Ks] and lost with high card King
Seat 9: TURoff (big blind) folded before Flop





PokerStars Hand #177197518347: Tournament #2067822782, $1.00+$0.10 USD Hold'em No Limit - Level XII (200/400) - 2017/10/21 20:47:59 CUST [2017/10/21 12:47:59 ET]
Table '2067822782 84' 9-max Seat #8 is the button
Seat 1: vizon_x (50373 in chips) 
Seat 2: I want more1 (14130 in chips) 
Seat 3: ZYBILO88 (6524 in chips) 
Seat 4: louis2307 (25735 in chips) 
Seat 5: TonyJYM (8765 in chips) 
Seat 6: mr.celeste (2517 in chips) 
Seat 7: Trap Sinatra (5684 in chips) 
Seat 8: Fd_Tomazetti (6154 in chips) 
Seat 9: TURoff (12440 in chips) 
vizon_x: posts the ante 50
I want more1: posts the ante 50
ZYBILO88: posts the ante 50
louis2307: posts the ante 50
TonyJYM: posts the ante 50
mr.celeste: posts the ante 50
Trap Sinatra: posts the ante 50
Fd_Tomazetti: posts the ante 50
TURoff: posts the ante 50
TURoff: posts small blind 200
vizon_x: posts big blind 400
*** HOLE CARDS ***
Dealt to TURoff [5s 9c]
I want more1: folds 
ZYBILO88: folds 
louis2307: folds 
TonyJYM: raises 800 to 1200
mr.celeste: folds 
Trap Sinatra: raises 4434 to 5634 and is all-in
Fd_Tomazetti: folds 
TURoff: folds 
vizon_x: folds 
TonyJYM: calls 4434
*** FLOP *** [Th 7c 9s]
*** TURN *** [Th 7c 9s] [4s]
*** RIVER *** [Th 7c 9s 4s] [Tc]
*** SHOW DOWN ***
TonyJYM: shows [Ah Jc] (a pair of Tens)
Trap Sinatra: shows [Kh Ac] (a pair of Tens - Ace+King kicker)
Trap Sinatra collected 12318 from pot
*** SUMMARY ***
Total pot 12318 | Rake 0 
Board [Th 7c 9s 4s Tc]
Seat 1: vizon_x (big blind) folded before Flop
Seat 2: I want more1 folded before Flop (didn't bet)
Seat 3: ZYBILO88 folded before Flop (didn't bet)
Seat 4: louis2307 folded before Flop (didn't bet)
Seat 5: TonyJYM showed [Ah Jc] and lost with a pair of Tens
Seat 6: mr.celeste folded before Flop (didn't bet)
Seat 7: Trap Sinatra showed [Kh Ac] and won (12318) with a pair of Tens
Seat 8: Fd_Tomazetti (button) folded before Flop (didn't bet)
Seat 9: TURoff (small blind) folded before Flop





PokerStars Hand #177197550468: Tournament #2067822782, $1.00+$0.10 USD Hold'em No Limit - Level XII (200/400) - 2017/10/21 20:48:46 CUST [2017/10/21 12:48:46 ET]
Table '2067822782 84' 9-max Seat #9 is the button
Seat 1: vizon_x (49923 in chips) 
Seat 2: I want more1 (14080 in chips) 
Seat 3: ZYBILO88 (6474 in chips) 
Seat 4: louis2307 (25685 in chips) 
Seat 5: TonyJYM (3081 in chips) 
Seat 6: mr.celeste (2467 in chips) 
Seat 7: Trap Sinatra (12318 in chips) 
Seat 8: Fd_Tomazetti (6104 in chips) 
Seat 9: TURoff (12190 in chips) 
vizon_x: posts the ante 50
I want more1: posts the ante 50
ZYBILO88: posts the ante 50
louis2307: posts the ante 50
TonyJYM: posts the ante 50
mr.celeste: posts the ante 50
Trap Sinatra: posts the ante 50
Fd_Tomazetti: posts the ante 50
TURoff: posts the ante 50
vizon_x: posts small blind 200
I want more1: posts big blind 400
*** HOLE CARDS ***
Dealt to TURoff [3d 9s]
ZYBILO88: raises 400 to 800
louis2307: folds 
TonyJYM: folds 
mr.celeste: folds 
Trap Sinatra: folds 
Fd_Tomazetti: folds 
TURoff: folds 
vizon_x: folds 
I want more1: raises 1200 to 2000
ZYBILO88: calls 1200
*** FLOP *** [8s 8d 6s]
I want more1: checks 
ZYBILO88: bets 4424 and is all-in
I want more1: calls 4424
*** TURN *** [8s 8d 6s] [7s]
*** RIVER *** [8s 8d 6s 7s] [6h]
*** SHOW DOWN ***
I want more1: shows [Kd Ks] (two pair, Kings and Eights)
ZYBILO88: shows [Ad Jd] (two pair, Eights and Sixes)
I want more1 collected 13498 from pot
ZYBILO88 finished the tournament in 690th place
*** SUMMARY ***
Total pot 13498 | Rake 0 
Board [8s 8d 6s 7s 6h]
Seat 1: vizon_x (small blind) folded before Flop
Seat 2: I want more1 (big blind) showed [Kd Ks] and won (13498) with two pair, Kings and Eights
Seat 3: ZYBILO88 showed [Ad Jd] and lost with two pair, Eights and Sixes
Seat 4: louis2307 folded before Flop (didn't bet)
Seat 5: TonyJYM folded before Flop (didn't bet)
Seat 6: mr.celeste folded before Flop (didn't bet)
Seat 7: Trap Sinatra folded before Flop (didn't bet)
Seat 8: Fd_Tomazetti folded before Flop (didn't bet)
Seat 9: TURoff (button) folded before Flop (didn't bet)





PokerStars Hand #177197598282: Tournament #2067822782, $1.00+$0.10 USD Hold'em No Limit - Level XII (200/400) - 2017/10/21 20:49:55 CUST [2017/10/21 12:49:55 ET]
Table '2067822782 84' 9-max Seat #1 is the button
Seat 1: vizon_x (49673 in chips) 
Seat 2: I want more1 (21104 in chips) 
Seat 4: louis2307 (25635 in chips) 
Seat 5: TonyJYM (3031 in chips) 
Seat 6: mr.celeste (2417 in chips) 
Seat 7: Trap Sinatra (12268 in chips) 
Seat 8: Fd_Tomazetti (6054 in chips) 
Seat 9: TURoff (12140 in chips) 
vizon_x: posts the ante 50
I want more1: posts the ante 50
louis2307: posts the ante 50
TonyJYM: posts the ante 50
mr.celeste: posts the ante 50
Trap Sinatra: posts the ante 50
Fd_Tomazetti: posts the ante 50
TURoff: posts the ante 50
I want more1: posts small blind 200
louis2307: posts big blind 400
*** HOLE CARDS ***
Dealt to TURoff [Ac 4c]
TonyJYM: folds 
mr.celeste: folds 
Trap Sinatra: raises 484 to 884
Fd_Tomazetti: folds 
TURoff: calls 884
vizon_x: folds 
I want more1: calls 684
louis2307: folds 
*** FLOP *** [8d Kd 9s]
I want more1: checks 
Trap Sinatra: bets 1277
TURoff: folds 
I want more1: folds 
Uncalled bet (1277) returned to Trap Sinatra
Trap Sinatra collected 3452 from pot
Trap Sinatra: doesn't show hand 
*** SUMMARY ***
Total pot 3452 | Rake 0 
Board [8d Kd 9s]
Seat 1: vizon_x (button) folded before Flop (didn't bet)
Seat 2: I want more1 (small blind) folded on the Flop
Seat 4: louis2307 (big blind) folded before Flop
Seat 5: TonyJYM folded before Flop (didn't bet)
Seat 6: mr.celeste folded before Flop (didn't bet)
Seat 7: Trap Sinatra collected (3452)
Seat 8: Fd_Tomazetti folded before Flop (didn't bet)
Seat 9: TURoff folded on the Flop





PokerStars Hand #177197649609: Tournament #2067822782, $1.00+$0.10 USD Hold'em No Limit - Level XII (200/400) - 2017/10/21 20:51:10 CUST [2017/10/21 12:51:10 ET]
Table '2067822782 84' 9-max Seat #2 is the button
Seat 1: vizon_x (49623 in chips) 
Seat 2: I want more1 (20170 in chips) 
Seat 3: tom dwan802 (7036 in chips) out of hand (moved from another table into small blind)
Seat 4: louis2307 (25185 in chips) 
Seat 5: TonyJYM (2981 in chips) 
Seat 6: mr.celeste (2367 in chips) 
Seat 7: Trap Sinatra (14786 in chips) 
Seat 8: Fd_Tomazetti (6004 in chips) 
Seat 9: TURoff (11206 in chips) 
vizon_x: posts the ante 50
I want more1: posts the ante 50
louis2307: posts the ante 50
TonyJYM: posts the ante 50
mr.celeste: posts the ante 50
Trap Sinatra: posts the ante 50
Fd_Tomazetti: posts the ante 50
TURoff: posts the ante 50
louis2307: posts small blind 200
TonyJYM: posts big blind 400
*** HOLE CARDS ***
Dealt to TURoff [Kh Th]
mr.celeste: folds 
Trap Sinatra: raises 520 to 920
Fd_Tomazetti: folds 
TURoff: raises 1480 to 2400
vizon_x: folds 
I want more1: folds 
louis2307: folds 
TonyJYM: folds 
Trap Sinatra: calls 1480
*** FLOP *** [Ad Qc 2h]
Trap Sinatra: checks 
TURoff: bets 2800
Trap Sinatra: calls 2800
*** TURN *** [Ad Qc 2h] [8s]
Trap Sinatra: checks 
TURoff: checks 
*** RIVER *** [Ad Qc 2h 8s] [7h]
Trap Sinatra: bets 9536 and is all-in
TURoff: folds 
Uncalled bet (9536) returned to Trap Sinatra
Trap Sinatra collected 11400 from pot
Trap Sinatra: doesn't show hand 
*** SUMMARY ***
Total pot 11400 | Rake 0 
Board [Ad Qc 2h 8s 7h]
Seat 1: vizon_x folded before Flop (didn't bet)
Seat 2: I want more1 (button) folded before Flop (didn't bet)
Seat 4: louis2307 (small blind) folded before Flop
Seat 5: TonyJYM (big blind) folded before Flop
Seat 6: mr.celeste folded before Flop (didn't bet)
Seat 7: Trap Sinatra collected (11400)
Seat 8: Fd_Tomazetti folded before Flop (didn't bet)
Seat 9: TURoff folded on the River





PokerStars Hand #177197705135: Tournament #2067822782, $1.00+$0.10 USD Hold'em No Limit - Level XII (200/400) - 2017/10/21 20:52:30 CUST [2017/10/21 12:52:30 ET]
Table '2067822782 84' 9-max Seat #4 is the button
Seat 1: vizon_x (49573 in chips) 
Seat 2: I want more1 (20120 in chips) 
Seat 3: tom dwan802 (7036 in chips) 
Seat 4: louis2307 (24935 in chips) 
Seat 5: TonyJYM (2531 in chips) 
Seat 6: mr.celeste (2317 in chips) 
Seat 7: Trap Sinatra (20936 in chips) 
Seat 8: Fd_Tomazetti (5954 in chips) 
Seat 9: TURoff (5956 in chips) 
vizon_x: posts the ante 50
I want more1: posts the ante 50
tom dwan802: posts the ante 50
louis2307: posts the ante 50
TonyJYM: posts the ante 50
mr.celeste: posts the ante 50
Trap Sinatra: posts the ante 50
Fd_Tomazetti: posts the ante 50
TURoff: posts the ante 50
TonyJYM: posts small blind 200
mr.celeste: posts big blind 400
*** HOLE CARDS ***
Dealt to TURoff [2h 6h]
Trap Sinatra: folds 
Fd_Tomazetti: folds 
TURoff: folds 
Trap Sinatra said, "KIngs?"
vizon_x: raises 400 to 800
I want more1: folds 
tom dwan802: raises 6186 to 6986 and is all-in
louis2307: folds 
TonyJYM: folds 
mr.celeste: folds 
vizon_x: calls 6186
*** FLOP *** [7h 3s Qs]
*** TURN *** [7h 3s Qs] [5c]
*** RIVER *** [7h 3s Qs 5c] [Jd]
*** SHOW DOWN ***
vizon_x: shows [Ah Kh] (high card Ace)
tom dwan802: shows [As Qd] (a pair of Queens)
tom dwan802 collected 15022 from pot
*** SUMMARY ***
Total pot 15022 | Rake 0 
Board [7h 3s Qs 5c Jd]
Seat 1: vizon_x showed [Ah Kh] and lost with high card Ace
Seat 2: I want more1 folded before Flop (didn't bet)
Seat 3: tom dwan802 showed [As Qd] and won (15022) with a pair of Queens
Seat 4: louis2307 (button) folded before Flop (didn't bet)
Seat 5: TonyJYM (small blind) folded before Flop
Seat 6: mr.celeste (big blind) folded before Flop
Seat 7: Trap Sinatra folded before Flop (didn't bet)
Seat 8: Fd_Tomazetti folded before Flop (didn't bet)
Seat 9: TURoff folded before Flop (didn't bet)





PokerStars Hand #177197743685: Tournament #2067822782, $1.00+$0.10 USD Hold'em No Limit - Level XII (200/400) - 2017/10/21 20:53:27 CUST [2017/10/21 12:53:27 ET]
Table '2067822782 84' 9-max Seat #5 is the button
Seat 1: vizon_x (42537 in chips) 
Seat 2: I want more1 (20070 in chips) 
Seat 3: tom dwan802 (15022 in chips) 
Seat 4: louis2307 (24885 in chips) 
Seat 5: TonyJYM (2281 in chips) 
Seat 6: mr.celeste (1867 in chips) 
Seat 7: Trap Sinatra (20886 in chips) 
Seat 8: Fd_Tomazetti (5904 in chips) 
Seat 9: TURoff (5906 in chips) 
vizon_x: posts the ante 50
I want more1: posts the ante 50
tom dwan802: posts the ante 50
louis2307: posts the ante 50
TonyJYM: posts the ante 50
mr.celeste: posts the ante 50
Trap Sinatra: posts the ante 50
Fd_Tomazetti: posts the ante 50
TURoff: posts the ante 50
mr.celeste: posts small blind 200
Trap Sinatra: posts big blind 400
*** HOLE CARDS ***
Dealt to TURoff [Ac 8d]
TURoff said, "aga"
Fd_Tomazetti: raises 400 to 800
TURoff: folds 
vizon_x: folds 
I want more1: folds 
tom dwan802: folds 
louis2307: folds 
TonyJYM: raises 1431 to 2231 and is all-in
mr.celeste: folds 
Trap Sinatra: raises 18605 to 20836 and is all-in
Fd_Tomazetti: folds 
Uncalled bet (18605) returned to Trap Sinatra
*** FLOP *** [3s 9s Kd]
*** TURN *** [3s 9s Kd] [3d]
*** RIVER *** [3s 9s Kd 3d] [Kh]
*** SHOW DOWN ***
Trap Sinatra: shows [Qs Ah] (two pair, Kings and Threes)
TonyJYM: shows [Jd Ad] (two pair, Kings and Threes)
Trap Sinatra collected 2956 from pot
TonyJYM collected 2956 from pot
*** SUMMARY ***
Total pot 5912 | Rake 0 
Board [3s 9s Kd 3d Kh]
Seat 1: vizon_x folded before Flop (didn't bet)
Seat 2: I want more1 folded before Flop (didn't bet)
Seat 3: tom dwan802 folded before Flop (didn't bet)
Seat 4: louis2307 folded before Flop (didn't bet)
Seat 5: TonyJYM (button) showed [Jd Ad] and won (2956) with two pair, Kings and Threes
Seat 6: mr.celeste (small blind) folded before Flop
Seat 7: Trap Sinatra (big blind) showed [Qs Ah] and won (2956) with two pair, Kings and Threes
Seat 8: Fd_Tomazetti folded before Flop
Seat 9: TURoff folded before Flop (didn't bet)





PokerStars Hand #177197775223: Tournament #2067822782, $1.00+$0.10 USD Hold'em No Limit - Level XII (200/400) - 2017/10/21 20:54:13 CUST [2017/10/21 12:54:13 ET]
Table '2067822782 84' 9-max Seat #6 is the button
Seat 1: vizon_x (42487 in chips) 
Seat 2: I want more1 (20020 in chips) 
Seat 3: tom dwan802 (14972 in chips) 
Seat 4: louis2307 (24835 in chips) 
Seat 5: TonyJYM (2956 in chips) 
Seat 6: mr.celeste (1617 in chips) 
Seat 7: Trap Sinatra (21561 in chips) 
Seat 8: Fd_Tomazetti (5054 in chips) 
Seat 9: TURoff (5856 in chips) 
vizon_x: posts the ante 50
I want more1: posts the ante 50
tom dwan802: posts the ante 50
louis2307: posts the ante 50
TonyJYM: posts the ante 50
mr.celeste: posts the ante 50
Trap Sinatra: posts the ante 50
Fd_Tomazetti: posts the ante 50
TURoff: posts the ante 50
Trap Sinatra: posts small blind 200
Fd_Tomazetti: posts big blind 400
*** HOLE CARDS ***
Dealt to TURoff [Qc 2c]
TURoff: folds 
vizon_x: raises 400 to 800
I want more1: calls 800
tom dwan802: folds 
louis2307: folds 
TonyJYM: calls 800
mr.celeste: folds 
Trap Sinatra: calls 600
Fd_Tomazetti: folds 
*** FLOP *** [3d Qd Ts]
Trap Sinatra: checks 
vizon_x: checks 
I want more1: checks 
TonyJYM: checks 
*** TURN *** [3d Qd Ts] [Jc]
louis2307 is sitting out
Trap Sinatra: bets 1499
vizon_x: calls 1499
I want more1: folds 
TonyJYM: folds 
*** RIVER *** [3d Qd Ts Jc] [Kc]
Trap Sinatra: checks 
vizon_x: bets 800
Trap Sinatra: calls 800
*** SHOW DOWN ***
vizon_x: shows [8s 9d] (a straight, Nine to King)
Trap Sinatra: mucks hand 
vizon_x collected 8648 from pot
*** SUMMARY ***
Total pot 8648 | Rake 0 
Board [3d Qd Ts Jc Kc]
Seat 1: vizon_x showed [8s 9d] and won (8648) with a straight, Nine to King
Seat 2: I want more1 folded on the Turn
Seat 3: tom dwan802 folded before Flop (didn't bet)
Seat 4: louis2307 folded before Flop (didn't bet)
Seat 5: TonyJYM folded on the Turn
Seat 6: mr.celeste (button) folded before Flop (didn't bet)
Seat 7: Trap Sinatra (small blind) mucked [Jh Qh]
Seat 8: Fd_Tomazetti (big blind) folded before Flop
Seat 9: TURoff folded before Flop (didn't bet)





PokerStars Hand #177198037686: Tournament #2067822782, $1.00+$0.10 USD Hold'em No Limit - Level XIII (250/500) - 2017/10/21 21:01:36 CUST [2017/10/21 13:01:36 ET]
Table '2067822782 84' 9-max Seat #7 is the button
Seat 1: vizon_x (47986 in chips) 
Seat 2: I want more1 (19170 in chips) 
Seat 3: tom dwan802 (14922 in chips) 
Seat 4: louis2307 (24785 in chips) is sitting out
Seat 5: TonyJYM (2106 in chips) 
Seat 6: mr.celeste (1567 in chips) 
Seat 7: Trap Sinatra (18412 in chips) 
Seat 8: Fd_Tomazetti (4604 in chips) 
Seat 9: TURoff (5806 in chips) 
vizon_x: posts the ante 60
I want more1: posts the ante 60
tom dwan802: posts the ante 60
louis2307: posts the ante 60
TonyJYM: posts the ante 60
mr.celeste: posts the ante 60
Trap Sinatra: posts the ante 60
Fd_Tomazetti: posts the ante 60
TURoff: posts the ante 60
Fd_Tomazetti: posts small blind 250
TURoff: posts big blind 500
*** HOLE CARDS ***
Dealt to TURoff [2s 5c]
vizon_x: folds 
I want more1: folds 
tom dwan802: folds 
louis2307: folds 
TonyJYM: folds 
mr.celeste: raises 1007 to 1507 and is all-in
Trap Sinatra: folds 
Fd_Tomazetti: folds 
TURoff: calls 1007
*** FLOP *** [Kh Td 6c]
*** TURN *** [Kh Td 6c] [Jd]
*** RIVER *** [Kh Td 6c Jd] [As]
*** SHOW DOWN ***
TURoff: shows [2s 5c] (high card Ace)
mr.celeste: shows [Th 9d] (a pair of Tens)
mr.celeste collected 3804 from pot
*** SUMMARY ***
Total pot 3804 | Rake 0 
Board [Kh Td 6c Jd As]
Seat 1: vizon_x folded before Flop (didn't bet)
Seat 2: I want more1 folded before Flop (didn't bet)
Seat 3: tom dwan802 folded before Flop (didn't bet)
Seat 4: louis2307 folded before Flop (didn't bet)
Seat 5: TonyJYM folded before Flop (didn't bet)
Seat 6: mr.celeste showed [Th 9d] and won (3804) with a pair of Tens
Seat 7: Trap Sinatra (button) folded before Flop (didn't bet)
Seat 8: Fd_Tomazetti (small blind) folded before Flop
Seat 9: TURoff (big blind) showed [2s 5c] and lost with high card Ace





PokerStars Hand #177198084381: Tournament #2067822782, $1.00+$0.10 USD Hold'em No Limit - Level XIII (250/500) - 2017/10/21 21:02:46 CUST [2017/10/21 13:02:46 ET]
Table '2067822782 84' 9-max Seat #8 is the button
Seat 1: vizon_x (47926 in chips) 
Seat 2: I want more1 (19110 in chips) 
Seat 3: tom dwan802 (14862 in chips) 
Seat 4: louis2307 (24725 in chips) is sitting out
Seat 5: TonyJYM (2046 in chips) 
Seat 6: mr.celeste (3804 in chips) 
Seat 7: Trap Sinatra (18352 in chips) 
Seat 8: Fd_Tomazetti (4294 in chips) 
Seat 9: TURoff (4239 in chips) 
vizon_x: posts the ante 60
I want more1: posts the ante 60
tom dwan802: posts the ante 60
louis2307: posts the ante 60
TonyJYM: posts the ante 60
mr.celeste: posts the ante 60
Trap Sinatra: posts the ante 60
Fd_Tomazetti: posts the ante 60
TURoff: posts the ante 60
TURoff: posts small blind 250
vizon_x: posts big blind 500
*** HOLE CARDS ***
Dealt to TURoff [9h Kd]
I want more1: folds 
tom dwan802: folds 
louis2307: folds 
TonyJYM: raises 1486 to 1986 and is all-in
mr.celeste: raises 1758 to 3744 and is all-in
Trap Sinatra: folds 
Fd_Tomazetti: folds 
TURoff: folds 
vizon_x: calls 3244
*** FLOP *** [5d 4h 8d]
*** TURN *** [5d 4h 8d] [5c]
*** RIVER *** [5d 4h 8d 5c] [Qd]
*** SHOW DOWN ***
vizon_x: shows [Jc Js] (two pair, Jacks and Fives)
mr.celeste: shows [Tc Th] (two pair, Tens and Fives)
vizon_x collected 3516 from side pot
TonyJYM: shows [Jd Ad] (a flush, Ace high)
TonyJYM collected 6748 from main pot
mr.celeste finished the tournament in 575th place
*** SUMMARY ***
Total pot 10264 Main pot 6748. Side pot 3516. | Rake 0 
Board [5d 4h 8d 5c Qd]
Seat 1: vizon_x (big blind) showed [Jc Js] and won (3516) with two pair, Jacks and Fives
Seat 2: I want more1 folded before Flop (didn't bet)
Seat 3: tom dwan802 folded before Flop (didn't bet)
Seat 4: louis2307 folded before Flop (didn't bet)
Seat 5: TonyJYM showed [Jd Ad] and won (6748) with a flush, Ace high
Seat 6: mr.celeste showed [Tc Th] and lost with two pair, Tens and Fives
Seat 7: Trap Sinatra folded before Flop (didn't bet)
Seat 8: Fd_Tomazetti (button) folded before Flop (didn't bet)
Seat 9: TURoff (small blind) folded before Flop





PokerStars Hand #177198116623: Tournament #2067822782, $1.00+$0.10 USD Hold'em No Limit - Level XIII (250/500) - 2017/10/21 21:03:33 CUST [2017/10/21 13:03:33 ET]
Table '2067822782 84' 9-max Seat #9 is the button
Seat 1: vizon_x (47638 in chips) 
Seat 2: I want more1 (19050 in chips) 
Seat 3: tom dwan802 (14802 in chips) 
Seat 4: louis2307 (24665 in chips) is sitting out
Seat 5: TonyJYM (6748 in chips) 
Seat 7: Trap Sinatra (18292 in chips) 
Seat 8: Fd_Tomazetti (4234 in chips) 
Seat 9: TURoff (3929 in chips) 
vizon_x: posts the ante 60
I want more1: posts the ante 60
tom dwan802: posts the ante 60
louis2307: posts the ante 60
TonyJYM: posts the ante 60
Trap Sinatra: posts the ante 60
Fd_Tomazetti: posts the ante 60
TURoff: posts the ante 60
vizon_x: posts small blind 250
I want more1: posts big blind 500
*** HOLE CARDS ***
Dealt to TURoff [Td Jd]
tom dwan802: folds 
louis2307: folds 
TonyJYM: folds 
Trap Sinatra: folds 
Fd_Tomazetti: folds 
TURoff: raises 3369 to 3869 and is all-in
vizon_x: folds 
I want more1: folds 
Uncalled bet (3369) returned to TURoff
TURoff collected 1730 from pot
TURoff: doesn't show hand 
*** SUMMARY ***
Total pot 1730 | Rake 0 
Seat 1: vizon_x (small blind) folded before Flop
Seat 2: I want more1 (big blind) folded before Flop
Seat 3: tom dwan802 folded before Flop (didn't bet)
Seat 4: louis2307 folded before Flop (didn't bet)
Seat 5: TonyJYM folded before Flop (didn't bet)
Seat 7: Trap Sinatra folded before Flop (didn't bet)
Seat 8: Fd_Tomazetti folded before Flop (didn't bet)
Seat 9: TURoff (button) collected (1730)





PokerStars Hand #177198138505: Tournament #2067822782, $1.00+$0.10 USD Hold'em No Limit - Level XIII (250/500) - 2017/10/21 21:04:04 CUST [2017/10/21 13:04:04 ET]
Table '2067822782 84' 9-max Seat #1 is the button
Seat 1: vizon_x (47328 in chips) 
Seat 2: I want more1 (18490 in chips) 
Seat 3: tom dwan802 (14742 in chips) 
Seat 4: louis2307 (24605 in chips) is sitting out
Seat 5: TonyJYM (6688 in chips) 
Seat 7: Trap Sinatra (18232 in chips) 
Seat 8: Fd_Tomazetti (4174 in chips) 
Seat 9: TURoff (5099 in chips) 
vizon_x: posts the ante 60
I want more1: posts the ante 60
tom dwan802: posts the ante 60
louis2307: posts the ante 60
TonyJYM: posts the ante 60
Trap Sinatra: posts the ante 60
Fd_Tomazetti: posts the ante 60
TURoff: posts the ante 60
I want more1: posts small blind 250
tom dwan802: posts big blind 500
*** HOLE CARDS ***
Dealt to TURoff [6h As]
louis2307: folds 
TonyJYM: folds 
Trap Sinatra: folds 
Fd_Tomazetti: folds 
TURoff: folds 
vizon_x: raises 500 to 1000
I want more1: folds 
tom dwan802: folds 
Uncalled bet (500) returned to vizon_x
vizon_x collected 1730 from pot
vizon_x: doesn't show hand 
*** SUMMARY ***
Total pot 1730 | Rake 0 
Seat 1: vizon_x (button) collected (1730)
Seat 2: I want more1 (small blind) folded before Flop
Seat 3: tom dwan802 (big blind) folded before Flop
Seat 4: louis2307 folded before Flop (didn't bet)
Seat 5: TonyJYM folded before Flop (didn't bet)
Seat 7: Trap Sinatra folded before Flop (didn't bet)
Seat 8: Fd_Tomazetti folded before Flop (didn't bet)
Seat 9: TURoff folded before Flop (didn't bet)





PokerStars Hand #177198162394: Tournament #2067822782, $1.00+$0.10 USD Hold'em No Limit - Level XIII (250/500) - 2017/10/21 21:04:38 CUST [2017/10/21 13:04:38 ET]
Table '2067822782 84' 9-max Seat #2 is the button
Seat 1: vizon_x (48498 in chips) 
Seat 2: I want more1 (18180 in chips) 
Seat 3: tom dwan802 (14182 in chips) 
Seat 4: louis2307 (24545 in chips) is sitting out
Seat 5: TonyJYM (6628 in chips) 
Seat 6: TembI413 (11382 in chips) 
Seat 7: Trap Sinatra (18172 in chips) 
Seat 8: Fd_Tomazetti (4114 in chips) 
Seat 9: TURoff (5039 in chips) 
vizon_x: posts the ante 60
I want more1: posts the ante 60
tom dwan802: posts the ante 60
louis2307: posts the ante 60
TonyJYM: posts the ante 60
TembI413: posts the ante 60
Trap Sinatra: posts the ante 60
Fd_Tomazetti: posts the ante 60
TURoff: posts the ante 60
tom dwan802: posts small blind 250
louis2307: posts big blind 500
*** HOLE CARDS ***
Dealt to TURoff [8c 5c]
TonyJYM: calls 500
TembI413: folds 
Trap Sinatra: folds 
Fd_Tomazetti: raises 750 to 1250
TURoff: folds 
vizon_x: raises 750 to 2000
I want more1: folds 
tom dwan802: folds 
louis2307: folds 
TonyJYM: calls 1500
Fd_Tomazetti: calls 750
*** FLOP *** [7c 2c Qd]
TonyJYM: bets 4568 and is all-in
Fd_Tomazetti: calls 2054 and is all-in
vizon_x: folds 
Uncalled bet (2514) returned to TonyJYM
*** TURN *** [7c 2c Qd] [6s]
*** RIVER *** [7c 2c Qd 6s] [Qc]
*** SHOW DOWN ***
TonyJYM: shows [Jc 4c] (a flush, Queen high)
Fd_Tomazetti: shows [Ad Qs] (three of a kind, Queens)
TonyJYM collected 11398 from pot
Fd_Tomazetti finished the tournament in 550th place
*** SUMMARY ***
Total pot 11398 | Rake 0 
Board [7c 2c Qd 6s Qc]
Seat 1: vizon_x folded on the Flop
Seat 2: I want more1 (button) folded before Flop (didn't bet)
Seat 3: tom dwan802 (small blind) folded before Flop
Seat 4: louis2307 (big blind) folded before Flop
Seat 5: TonyJYM showed [Jc 4c] and won (11398) with a flush, Queen high
Seat 6: TembI413 folded before Flop (didn't bet)
Seat 7: Trap Sinatra folded before Flop (didn't bet)
Seat 8: Fd_Tomazetti showed [Ad Qs] and lost with three of a kind, Queens
Seat 9: TURoff folded before Flop (didn't bet)





PokerStars Hand #177198229817: Tournament #2067822782, $1.00+$0.10 USD Hold'em No Limit - Level XIII (250/500) - 2017/10/21 21:06:02 CUST [2017/10/21 13:06:02 ET]
Table '2067822782 27' 9-max Seat #8 is the button
Seat 1: Kejsi_Raibek (5193 in chips) 
Seat 2: KATO068068 (12134 in chips) 
Seat 3: thehman764 (4176 in chips) 
Seat 4: ricardovinog (12734 in chips) 
Seat 5: TURoff (4979 in chips) 
Seat 6: patriicksb (6740 in chips) 
Seat 7: Redron86 (11429 in chips) 
Seat 8: h@st@ baby (10550 in chips) 
Seat 9: Vascaino_017 (6538 in chips) 
Kejsi_Raibek: posts the ante 60
KATO068068: posts the ante 60
thehman764: posts the ante 60
ricardovinog: posts the ante 60
TURoff: posts the ante 60
patriicksb: posts the ante 60
Redron86: posts the ante 60
h@st@ baby: posts the ante 60
Vascaino_017: posts the ante 60
Vascaino_017: posts small blind 250
Kejsi_Raibek: posts big blind 500
*** HOLE CARDS ***
Dealt to TURoff [Qd 7d]
KATO068068: folds 
thehman764: folds 
ricardovinog: folds 
TURoff: folds 
patriicksb: folds 
Redron86: folds 
h@st@ baby: folds 
Vascaino_017: folds 
Uncalled bet (250) returned to Kejsi_Raibek
Kejsi_Raibek collected 1040 from pot
*** SUMMARY ***
Total pot 1040 | Rake 0 
Seat 1: Kejsi_Raibek (big blind) collected (1040)
Seat 2: KATO068068 folded before Flop (didn't bet)
Seat 3: thehman764 folded before Flop (didn't bet)
Seat 4: ricardovinog folded before Flop (didn't bet)
Seat 5: TURoff folded before Flop (didn't bet)
Seat 6: patriicksb folded before Flop (didn't bet)
Seat 7: Redron86 folded before Flop (didn't bet)
Seat 8: h@st@ baby (button) folded before Flop (didn't bet)
Seat 9: Vascaino_017 (small blind) folded before Flop





PokerStars Hand #177198250653: Tournament #2067822782, $1.00+$0.10 USD Hold'em No Limit - Level XIII (250/500) - 2017/10/21 21:06:31 CUST [2017/10/21 13:06:31 ET]
Table '2067822782 27' 9-max Seat #9 is the button
Seat 1: Kejsi_Raibek (5923 in chips) 
Seat 2: KATO068068 (12074 in chips) 
Seat 3: thehman764 (4116 in chips) 
Seat 4: ricardovinog (12674 in chips) 
Seat 5: TURoff (4919 in chips) 
Seat 6: patriicksb (6680 in chips) 
Seat 7: Redron86 (11369 in chips) 
Seat 8: h@st@ baby (10490 in chips) 
Seat 9: Vascaino_017 (6228 in chips) 
Kejsi_Raibek: posts the ante 60
KATO068068: posts the ante 60
thehman764: posts the ante 60
ricardovinog: posts the ante 60
TURoff: posts the ante 60
patriicksb: posts the ante 60
Redron86: posts the ante 60
h@st@ baby: posts the ante 60
Vascaino_017: posts the ante 60
Kejsi_Raibek: posts small blind 250
KATO068068: posts big blind 500
*** HOLE CARDS ***
Dealt to TURoff [Qc 7d]
thehman764: folds 
ricardovinog: folds 
TURoff: folds 
patriicksb: folds 
Redron86: folds 
h@st@ baby: folds 
Vascaino_017: folds 
Kejsi_Raibek: folds 
Uncalled bet (250) returned to KATO068068
KATO068068 collected 1040 from pot
*** SUMMARY ***
Total pot 1040 | Rake 0 
Seat 1: Kejsi_Raibek (small blind) folded before Flop
Seat 2: KATO068068 (big blind) collected (1040)
Seat 3: thehman764 folded before Flop (didn't bet)
Seat 4: ricardovinog folded before Flop (didn't bet)
Seat 5: TURoff folded before Flop (didn't bet)
Seat 6: patriicksb folded before Flop (didn't bet)
Seat 7: Redron86 folded before Flop (didn't bet)
Seat 8: h@st@ baby folded before Flop (didn't bet)
Seat 9: Vascaino_017 (button) folded before Flop (didn't bet)





PokerStars Hand #177198274415: Tournament #2067822782, $1.00+$0.10 USD Hold'em No Limit - Level XIII (250/500) - 2017/10/21 21:07:03 CUST [2017/10/21 13:07:03 ET]
Table '2067822782 27' 9-max Seat #1 is the button
Seat 1: Kejsi_Raibek (5613 in chips) 
Seat 2: KATO068068 (12804 in chips) 
Seat 3: thehman764 (4056 in chips) 
Seat 4: ricardovinog (12614 in chips) 
Seat 5: TURoff (4859 in chips) 
Seat 6: patriicksb (6620 in chips) 
Seat 7: Redron86 (11309 in chips) 
Seat 8: h@st@ baby (10430 in chips) 
Seat 9: Vascaino_017 (6168 in chips) 
Kejsi_Raibek: posts the ante 60
KATO068068: posts the ante 60
thehman764: posts the ante 60
ricardovinog: posts the ante 60
TURoff: posts the ante 60
patriicksb: posts the ante 60
Redron86: posts the ante 60
h@st@ baby: posts the ante 60
Vascaino_017: posts the ante 60
KATO068068: posts small blind 250
thehman764: posts big blind 500
*** HOLE CARDS ***
Dealt to TURoff [4s Ac]
ricardovinog: folds 
TURoff: folds 
patriicksb: folds 
Redron86: folds 
h@st@ baby: folds 
Vascaino_017: folds 
Kejsi_Raibek: folds 
KATO068068: calls 250
thehman764: checks 
*** FLOP *** [8s 8h 7h]
KATO068068: checks 
thehman764: checks 
*** TURN *** [8s 8h 7h] [Ad]
KATO068068: checks 
thehman764: checks 
*** RIVER *** [8s 8h 7h Ad] [8c]
KATO068068: checks 
thehman764: checks 
*** SHOW DOWN ***
KATO068068: shows [Qc 3c] (three of a kind, Eights)
thehman764: shows [Kh 9c] (three of a kind, Eights - Ace+King kicker)
thehman764 collected 1540 from pot
*** SUMMARY ***
Total pot 1540 | Rake 0 
Board [8s 8h 7h Ad 8c]
Seat 1: Kejsi_Raibek (button) folded before Flop (didn't bet)
Seat 2: KATO068068 (small blind) showed [Qc 3c] and lost with three of a kind, Eights
Seat 3: thehman764 (big blind) showed [Kh 9c] and won (1540) with three of a kind, Eights
Seat 4: ricardovinog folded before Flop (didn't bet)
Seat 5: TURoff folded before Flop (didn't bet)
Seat 6: patriicksb folded before Flop (didn't bet)
Seat 7: Redron86 folded before Flop (didn't bet)
Seat 8: h@st@ baby folded before Flop (didn't bet)
Seat 9: Vascaino_017 folded before Flop (didn't bet)





PokerStars Hand #177198309894: Tournament #2067822782, $1.00+$0.10 USD Hold'em No Limit - Level XIII (250/500) - 2017/10/21 21:07:52 CUST [2017/10/21 13:07:52 ET]
Table '2067822782 27' 9-max Seat #2 is the button
Seat 1: Kejsi_Raibek (5553 in chips) 
Seat 2: KATO068068 (12244 in chips) 
Seat 3: thehman764 (5036 in chips) 
Seat 4: ricardovinog (12554 in chips) 
Seat 5: TURoff (4799 in chips) 
Seat 6: patriicksb (6560 in chips) 
Seat 7: Redron86 (11249 in chips) 
Seat 8: h@st@ baby (10370 in chips) 
Seat 9: Vascaino_017 (6108 in chips) 
Kejsi_Raibek: posts the ante 60
KATO068068: posts the ante 60
thehman764: posts the ante 60
ricardovinog: posts the ante 60
TURoff: posts the ante 60
patriicksb: posts the ante 60
Redron86: posts the ante 60
h@st@ baby: posts the ante 60
Vascaino_017: posts the ante 60
thehman764: posts small blind 250
ricardovinog: posts big blind 500
*** HOLE CARDS ***
Dealt to TURoff [3d 8h]
TURoff: folds 
patriicksb: folds 
Redron86: folds 
h@st@ baby: folds 
Vascaino_017: folds 
Kejsi_Raibek has timed out
Kejsi_Raibek: folds 
Kejsi_Raibek is sitting out
KATO068068: folds 
Kejsi_Raibek has returned
thehman764: folds 
Uncalled bet (250) returned to ricardovinog
ricardovinog collected 1040 from pot
ricardovinog: doesn't show hand 
*** SUMMARY ***
Total pot 1040 | Rake 0 
Seat 1: Kejsi_Raibek folded before Flop (didn't bet)
Seat 2: KATO068068 (button) folded before Flop (didn't bet)
Seat 3: thehman764 (small blind) folded before Flop
Seat 4: ricardovinog (big blind) collected (1040)
Seat 5: TURoff folded before Flop (didn't bet)
Seat 6: patriicksb folded before Flop (didn't bet)
Seat 7: Redron86 folded before Flop (didn't bet)
Seat 8: h@st@ baby folded before Flop (didn't bet)
Seat 9: Vascaino_017 folded before Flop (didn't bet)





PokerStars Hand #177198337112: Tournament #2067822782, $1.00+$0.10 USD Hold'em No Limit - Level XIII (250/500) - 2017/10/21 21:08:30 CUST [2017/10/21 13:08:30 ET]
Table '2067822782 27' 9-max Seat #3 is the button
Seat 1: Kejsi_Raibek (5493 in chips) 
Seat 2: KATO068068 (12184 in chips) 
Seat 3: thehman764 (4726 in chips) 
Seat 4: ricardovinog (13284 in chips) 
Seat 5: TURoff (4739 in chips) 
Seat 6: patriicksb (6500 in chips) 
Seat 7: Redron86 (11189 in chips) 
Seat 8: h@st@ baby (10310 in chips) 
Seat 9: Vascaino_017 (6048 in chips) 
Kejsi_Raibek: posts the ante 60
KATO068068: posts the ante 60
thehman764: posts the ante 60
ricardovinog: posts the ante 60
TURoff: posts the ante 60
patriicksb: posts the ante 60
Redron86: posts the ante 60
h@st@ baby: posts the ante 60
Vascaino_017: posts the ante 60
ricardovinog: posts small blind 250
TURoff: posts big blind 500
*** HOLE CARDS ***
Dealt to TURoff [8h Jc]
patriicksb: folds 
Redron86: folds 
h@st@ baby: folds 
Vascaino_017: folds 
Kejsi_Raibek: folds 
KATO068068: calls 500
thehman764: folds 
ricardovinog: calls 250
TURoff: checks 
*** FLOP *** [7s Jh 4c]
ricardovinog: checks 
TURoff: bets 4179 and is all-in
KATO068068: calls 4179
ricardovinog: folds 
*** TURN *** [7s Jh 4c] [Kc]
*** RIVER *** [7s Jh 4c Kc] [8s]
*** SHOW DOWN ***
TURoff: shows [8h Jc] (two pair, Jacks and Eights)
KATO068068: shows [Ah Jd] (a pair of Jacks)
TURoff collected 10398 from pot
*** SUMMARY ***
Total pot 10398 | Rake 0 
Board [7s Jh 4c Kc 8s]
Seat 1: Kejsi_Raibek folded before Flop (didn't bet)
Seat 2: KATO068068 showed [Ah Jd] and lost with a pair of Jacks
Seat 3: thehman764 (button) folded before Flop (didn't bet)
Seat 4: ricardovinog (small blind) folded on the Flop
Seat 5: TURoff (big blind) showed [8h Jc] and won (10398) with two pair, Jacks and Eights
Seat 6: patriicksb folded before Flop (didn't bet)
Seat 7: Redron86 folded before Flop (didn't bet)
Seat 8: h@st@ baby folded before Flop (didn't bet)
Seat 9: Vascaino_017 folded before Flop (didn't bet)





PokerStars Hand #177198402552: Tournament #2067822782, $1.00+$0.10 USD Hold'em No Limit - Level XIII (250/500) - 2017/10/21 21:10:00 CUST [2017/10/21 13:10:00 ET]
Table '2067822782 27' 9-max Seat #4 is the button
Seat 1: Kejsi_Raibek (5433 in chips) 
Seat 2: KATO068068 (7445 in chips) 
Seat 3: thehman764 (4666 in chips) 
Seat 4: ricardovinog (12724 in chips) 
Seat 5: TURoff (10398 in chips) 
Seat 6: patriicksb (6440 in chips) 
Seat 7: Redron86 (11129 in chips) 
Seat 8: h@st@ baby (10250 in chips) 
Seat 9: Vascaino_017 (5988 in chips) 
Kejsi_Raibek: posts the ante 60
KATO068068: posts the ante 60
thehman764: posts the ante 60
ricardovinog: posts the ante 60
TURoff: posts the ante 60
patriicksb: posts the ante 60
Redron86: posts the ante 60
h@st@ baby: posts the ante 60
Vascaino_017: posts the ante 60
TURoff: posts small blind 250
patriicksb: posts big blind 500
*** HOLE CARDS ***
Dealt to TURoff [Ah Tc]
Redron86: folds 
h@st@ baby: raises 750 to 1250
Vascaino_017: folds 
Kejsi_Raibek: folds 
KATO068068: raises 3790 to 5040
thehman764: folds 
ricardovinog: folds 
TURoff: folds 
patriicksb: folds 
h@st@ baby: folds 
Uncalled bet (3790) returned to KATO068068
KATO068068 collected 3790 from pot
*** SUMMARY ***
Total pot 3790 | Rake 0 
Seat 1: Kejsi_Raibek folded before Flop (didn't bet)
Seat 2: KATO068068 collected (3790)
Seat 3: thehman764 folded before Flop (didn't bet)
Seat 4: ricardovinog (button) folded before Flop (didn't bet)
Seat 5: TURoff (small blind) folded before Flop
Seat 6: patriicksb (big blind) folded before Flop
Seat 7: Redron86 folded before Flop (didn't bet)
Seat 8: h@st@ baby folded before Flop
Seat 9: Vascaino_017 folded before Flop (didn't bet)





PokerStars Hand #177198447288: Tournament #2067822782, $1.00+$0.10 USD Hold'em No Limit - Level XIII (250/500) - 2017/10/21 21:11:02 CUST [2017/10/21 13:11:02 ET]
Table '2067822782 27' 9-max Seat #5 is the button
Seat 1: Kejsi_Raibek (5373 in chips) 
Seat 2: KATO068068 (9925 in chips) 
Seat 3: thehman764 (4606 in chips) 
Seat 4: ricardovinog (12664 in chips) 
Seat 5: TURoff (10088 in chips) 
Seat 6: patriicksb (5880 in chips) 
Seat 7: Redron86 (11069 in chips) 
Seat 8: h@st@ baby (8940 in chips) 
Seat 9: Vascaino_017 (5928 in chips) 
Kejsi_Raibek: posts the ante 60
KATO068068: posts the ante 60
thehman764: posts the ante 60
ricardovinog: posts the ante 60
TURoff: posts the ante 60
patriicksb: posts the ante 60
Redron86: posts the ante 60
h@st@ baby: posts the ante 60
Vascaino_017: posts the ante 60
patriicksb: posts small blind 250
Redron86: posts big blind 500
*** HOLE CARDS ***
Dealt to TURoff [9h 5c]
h@st@ baby: folds 
Vascaino_017: folds 
Kejsi_Raibek: raises 4813 to 5313 and is all-in
KATO068068: folds 
thehman764: folds 
ricardovinog: folds 
TURoff: folds 
patriicksb: folds 
Redron86: folds 
Uncalled bet (4813) returned to Kejsi_Raibek
Kejsi_Raibek collected 1790 from pot
*** SUMMARY ***
Total pot 1790 | Rake 0 
Seat 1: Kejsi_Raibek collected (1790)
Seat 2: KATO068068 folded before Flop (didn't bet)
Seat 3: thehman764 folded before Flop (didn't bet)
Seat 4: ricardovinog folded before Flop (didn't bet)
Seat 5: TURoff (button) folded before Flop (didn't bet)
Seat 6: patriicksb (small blind) folded before Flop
Seat 7: Redron86 (big blind) folded before Flop
Seat 8: h@st@ baby folded before Flop (didn't bet)
Seat 9: Vascaino_017 folded before Flop (didn't bet)





PokerStars Hand #177198476888: Tournament #2067822782, $1.00+$0.10 USD Hold'em No Limit - Level XIV (300/600) - 2017/10/21 21:11:43 CUST [2017/10/21 13:11:43 ET]
Table '2067822782 27' 9-max Seat #6 is the button
Seat 1: Kejsi_Raibek (6603 in chips) 
Seat 2: KATO068068 (9865 in chips) 
Seat 3: thehman764 (4546 in chips) 
Seat 4: ricardovinog (12604 in chips) 
Seat 5: TURoff (10028 in chips) 
Seat 6: patriicksb (5570 in chips) 
Seat 7: Redron86 (10509 in chips) 
Seat 8: h@st@ baby (8880 in chips) 
Seat 9: Vascaino_017 (5868 in chips) 
Kejsi_Raibek: posts the ante 70
KATO068068: posts the ante 70
thehman764: posts the ante 70
ricardovinog: posts the ante 70
TURoff: posts the ante 70
patriicksb: posts the ante 70
Redron86: posts the ante 70
h@st@ baby: posts the ante 70
Vascaino_017: posts the ante 70
Redron86: posts small blind 300
h@st@ baby: posts big blind 600
*** HOLE CARDS ***
Dealt to TURoff [8h 9c]
Vascaino_017: folds 
Kejsi_Raibek: folds 
KATO068068: folds 
thehman764: folds 
ricardovinog: raises 600 to 1200
TURoff: folds 
patriicksb: folds 
Redron86: folds 
h@st@ baby: folds 
Uncalled bet (600) returned to ricardovinog
ricardovinog collected 2130 from pot
ricardovinog: doesn't show hand 
*** SUMMARY ***
Total pot 2130 | Rake 0 
Seat 1: Kejsi_Raibek folded before Flop (didn't bet)
Seat 2: KATO068068 folded before Flop (didn't bet)
Seat 3: thehman764 folded before Flop (didn't bet)
Seat 4: ricardovinog collected (2130)
Seat 5: TURoff folded before Flop (didn't bet)
Seat 6: patriicksb (button) folded before Flop (didn't bet)
Seat 7: Redron86 (small blind) folded before Flop
Seat 8: h@st@ baby (big blind) folded before Flop
Seat 9: Vascaino_017 folded before Flop (didn't bet)





PokerStars Hand #177198499301: Tournament #2067822782, $1.00+$0.10 USD Hold'em No Limit - Level XIV (300/600) - 2017/10/21 21:12:14 CUST [2017/10/21 13:12:14 ET]
Table '2067822782 27' 9-max Seat #7 is the button
Seat 1: Kejsi_Raibek (6533 in chips) 
Seat 2: KATO068068 (9795 in chips) 
Seat 3: thehman764 (4476 in chips) 
Seat 4: ricardovinog (14064 in chips) 
Seat 5: TURoff (9958 in chips) 
Seat 6: patriicksb (5500 in chips) 
Seat 7: Redron86 (10139 in chips) 
Seat 8: h@st@ baby (8210 in chips) 
Seat 9: Vascaino_017 (5798 in chips) 
Kejsi_Raibek: posts the ante 70
KATO068068: posts the ante 70
thehman764: posts the ante 70
ricardovinog: posts the ante 70
TURoff: posts the ante 70
patriicksb: posts the ante 70
Redron86: posts the ante 70
h@st@ baby: posts the ante 70
Vascaino_017: posts the ante 70
h@st@ baby: posts small blind 300
Vascaino_017: posts big blind 600
*** HOLE CARDS ***
Dealt to TURoff [Ah Kh]
Kejsi_Raibek has timed out
Kejsi_Raibek: folds 
Kejsi_Raibek is sitting out
KATO068068 is disconnected 
KATO068068 is connected 
KATO068068: raises 600 to 1200
thehman764: folds 
ricardovinog: folds 
TURoff: calls 1200
patriicksb: folds 
Redron86: folds 
h@st@ baby: folds 
Vascaino_017: folds 
*** FLOP *** [2c 9h Ad]
KATO068068: checks 
TURoff: bets 1200
KATO068068: calls 1200
*** TURN *** [2c 9h Ad] [Jc]
KATO068068: checks 
TURoff: bets 1800
KATO068068: raises 5525 to 7325 and is all-in
TURoff: calls 5525
*** RIVER *** [2c 9h Ad Jc] [Jh]
*** SHOW DOWN ***
KATO068068: shows [As Th] (two pair, Aces and Jacks)
TURoff: shows [Ah Kh] (two pair, Aces and Jacks - King kicker)
TURoff collected 20980 from pot
*** SUMMARY ***
Total pot 20980 | Rake 0 
Board [2c 9h Ad Jc Jh]
Seat 1: Kejsi_Raibek folded before Flop (didn't bet)
Seat 2: KATO068068 showed [As Th] and lost with two pair, Aces and Jacks
Seat 3: thehman764 folded before Flop (didn't bet)
Seat 4: ricardovinog folded before Flop (didn't bet)
Seat 5: TURoff showed [Ah Kh] and won (20980) with two pair, Aces and Jacks
Seat 6: patriicksb folded before Flop (didn't bet)
Seat 7: Redron86 (button) folded before Flop (didn't bet)
Seat 8: h@st@ baby (small blind) folded before Flop
Seat 9: Vascaino_017 (big blind) folded before Flop





PokerStars Hand #177198624898: Tournament #2067822782, $1.00+$0.10 USD Hold'em No Limit - Level XIV (300/600) - 2017/10/21 21:15:07 CUST [2017/10/21 13:15:07 ET]
Table '2067822782 27' 9-max Seat #8 is the button
Seat 1: Kejsi_Raibek (6463 in chips) is sitting out
Seat 3: thehman764 (4406 in chips) 
Seat 4: ricardovinog (13994 in chips) 
Seat 5: TURoff (21143 in chips) 
Seat 6: patriicksb (5430 in chips) 
Seat 7: Redron86 (10069 in chips) 
Seat 8: h@st@ baby (7840 in chips) 
Seat 9: Vascaino_017 (5128 in chips) 
Kejsi_Raibek: posts the ante 70
thehman764: posts the ante 70
ricardovinog: posts the ante 70
TURoff: posts the ante 70
patriicksb: posts the ante 70
Redron86: posts the ante 70
h@st@ baby: posts the ante 70
Vascaino_017: posts the ante 70
Vascaino_017: posts small blind 300
Kejsi_Raibek: posts big blind 600
*** HOLE CARDS ***
Dealt to TURoff [5h Js]
thehman764: folds 
ricardovinog: folds 
TURoff: folds 
patriicksb: folds 
Redron86: folds 
h@st@ baby: folds 
Vascaino_017: raises 600 to 1200
Kejsi_Raibek: folds 
Uncalled bet (600) returned to Vascaino_017
Vascaino_017 collected 1760 from pot
Vascaino_017: doesn't show hand 
*** SUMMARY ***
Total pot 1760 | Rake 0 
Seat 1: Kejsi_Raibek (big blind) folded before Flop
Seat 3: thehman764 folded before Flop (didn't bet)
Seat 4: ricardovinog folded before Flop (didn't bet)
Seat 5: TURoff folded before Flop (didn't bet)
Seat 6: patriicksb folded before Flop (didn't bet)
Seat 7: Redron86 folded before Flop (didn't bet)
Seat 8: h@st@ baby (button) folded before Flop (didn't bet)
Seat 9: Vascaino_017 (small blind) collected (1760)





PokerStars Hand #177198643008: Tournament #2067822782, $1.00+$0.10 USD Hold'em No Limit - Level XIV (300/600) - 2017/10/21 21:15:32 CUST [2017/10/21 13:15:32 ET]
Table '2067822782 27' 9-max Seat #9 is the button
Seat 1: Kejsi_Raibek (5793 in chips) is sitting out
Seat 3: thehman764 (4336 in chips) 
Seat 4: ricardovinog (13924 in chips) 
Seat 5: TURoff (21073 in chips) 
Seat 6: patriicksb (5360 in chips) 
Seat 7: Redron86 (9999 in chips) 
Seat 8: h@st@ baby (7770 in chips) 
Seat 9: Vascaino_017 (6218 in chips) 
Kejsi_Raibek: posts the ante 70
thehman764: posts the ante 70
ricardovinog: posts the ante 70
TURoff: posts the ante 70
patriicksb: posts the ante 70
Redron86: posts the ante 70
h@st@ baby: posts the ante 70
Vascaino_017: posts the ante 70
Kejsi_Raibek: posts small blind 300
thehman764: posts big blind 600
*** HOLE CARDS ***
Dealt to TURoff [9d Ks]
ricardovinog: folds 
TURoff: folds 
patriicksb: folds 
Redron86: folds 
h@st@ baby: folds 
Vascaino_017: raises 5548 to 6148 and is all-in
Kejsi_Raibek: folds 
thehman764: folds 
Uncalled bet (5548) returned to Vascaino_017
Vascaino_017 collected 2060 from pot
Vascaino_017: doesn't show hand 
*** SUMMARY ***
Total pot 2060 | Rake 0 
Seat 1: Kejsi_Raibek (small blind) folded before Flop
Seat 3: thehman764 (big blind) folded before Flop
Seat 4: ricardovinog folded before Flop (didn't bet)
Seat 5: TURoff folded before Flop (didn't bet)
Seat 6: patriicksb folded before Flop (didn't bet)
Seat 7: Redron86 folded before Flop (didn't bet)
Seat 8: h@st@ baby folded before Flop (didn't bet)
Seat 9: Vascaino_017 (button) collected (2060)





PokerStars Hand #177198659212: Tournament #2067822782, $1.00+$0.10 USD Hold'em No Limit - Level XIV (300/600) - 2017/10/21 21:15:54 CUST [2017/10/21 13:15:54 ET]
Table '2067822782 27' 9-max Seat #1 is the button
Seat 1: Kejsi_Raibek (5423 in chips) is sitting out
Seat 3: thehman764 (3666 in chips) 
Seat 4: ricardovinog (13854 in chips) 
Seat 5: TURoff (21003 in chips) 
Seat 6: patriicksb (5290 in chips) 
Seat 7: Redron86 (9929 in chips) 
Seat 8: h@st@ baby (7700 in chips) 
Seat 9: Vascaino_017 (7608 in chips) 
Kejsi_Raibek: posts the ante 70
thehman764: posts the ante 70
ricardovinog: posts the ante 70
TURoff: posts the ante 70
patriicksb: posts the ante 70
Redron86: posts the ante 70
h@st@ baby: posts the ante 70
Vascaino_017: posts the ante 70
thehman764: posts small blind 300
ricardovinog: posts big blind 600
*** HOLE CARDS ***
Dealt to TURoff [Qc Qs]
TURoff: raises 900 to 1500
patriicksb: folds 
Redron86: folds 
h@st@ baby: folds 
Vascaino_017: folds 
Kejsi_Raibek: folds 
thehman764: folds 
ricardovinog is disconnected 
ricardovinog is connected 
ricardovinog: calls 900
*** FLOP *** [5s 4h Kh]
ricardovinog: checks 
TURoff: bets 1200
ricardovinog: calls 1200
*** TURN *** [5s 4h Kh] [5c]
ricardovinog: checks 
TURoff: bets 1800
ricardovinog: calls 1800
*** RIVER *** [5s 4h Kh 5c] [7c]
ricardovinog: checks 
TURoff: checks 
*** SHOW DOWN ***
ricardovinog: shows [8d 8h] (two pair, Eights and Fives)
TURoff: shows [Qc Qs] (two pair, Queens and Fives)
TURoff collected 9860 from pot
*** SUMMARY ***
Total pot 9860 | Rake 0 
Board [5s 4h Kh 5c 7c]
Seat 1: Kejsi_Raibek (button) folded before Flop (didn't bet)
Seat 3: thehman764 (small blind) folded before Flop
Seat 4: ricardovinog (big blind) showed [8d 8h] and lost with two pair, Eights and Fives
Seat 5: TURoff showed [Qc Qs] and won (9860) with two pair, Queens and Fives
Seat 6: patriicksb folded before Flop (didn't bet)
Seat 7: Redron86 folded before Flop (didn't bet)
Seat 8: h@st@ baby folded before Flop (didn't bet)
Seat 9: Vascaino_017 folded before Flop (didn't bet)





PokerStars Hand #177198734187: Tournament #2067822782, $1.00+$0.10 USD Hold'em No Limit - Level XIV (300/600) - 2017/10/21 21:17:37 CUST [2017/10/21 13:17:37 ET]
Table '2067822782 27' 9-max Seat #3 is the button
Seat 1: Kejsi_Raibek (5353 in chips) is sitting out
Seat 2: NanoDen (7070 in chips) 
Seat 3: thehman764 (3296 in chips) 
Seat 4: ricardovinog (9284 in chips) 
Seat 5: TURoff (26293 in chips) 
Seat 6: patriicksb (5220 in chips) 
Seat 7: Redron86 (9859 in chips) 
Seat 8: h@st@ baby (7630 in chips) 
Seat 9: Vascaino_017 (7538 in chips) 
Kejsi_Raibek: posts the ante 70
NanoDen: posts the ante 70
thehman764: posts the ante 70
ricardovinog: posts the ante 70
TURoff: posts the ante 70
patriicksb: posts the ante 70
Redron86: posts the ante 70
h@st@ baby: posts the ante 70
Vascaino_017: posts the ante 70
ricardovinog: posts small blind 300
TURoff: posts big blind 600
*** HOLE CARDS ***
Dealt to TURoff [Ah 3c]
patriicksb: folds 
Redron86: folds 
h@st@ baby: folds 
Vascaino_017: folds 
Kejsi_Raibek: folds 
NanoDen: folds 
thehman764: folds 
ricardovinog: folds 
Uncalled bet (300) returned to TURoff
TURoff collected 1230 from pot
TURoff: doesn't show hand 
*** SUMMARY ***
Total pot 1230 | Rake 0 
Seat 1: Kejsi_Raibek folded before Flop (didn't bet)
Seat 2: NanoDen folded before Flop (didn't bet)
Seat 3: thehman764 (button) folded before Flop (didn't bet)
Seat 4: ricardovinog (small blind) folded before Flop
Seat 5: TURoff (big blind) collected (1230)
Seat 6: patriicksb folded before Flop (didn't bet)
Seat 7: Redron86 folded before Flop (didn't bet)
Seat 8: h@st@ baby folded before Flop (didn't bet)
Seat 9: Vascaino_017 folded before Flop (didn't bet)





PokerStars Hand #177198758073: Tournament #2067822782, $1.00+$0.10 USD Hold'em No Limit - Level XIV (300/600) - 2017/10/21 21:18:09 CUST [2017/10/21 13:18:09 ET]
Table '2067822782 27' 9-max Seat #4 is the button
Seat 1: Kejsi_Raibek (5283 in chips) is sitting out
Seat 2: NanoDen (7000 in chips) 
Seat 3: thehman764 (3226 in chips) 
Seat 4: ricardovinog (8914 in chips) 
Seat 5: TURoff (27153 in chips) 
Seat 6: patriicksb (5150 in chips) 
Seat 7: Redron86 (9789 in chips) 
Seat 8: h@st@ baby (7560 in chips) 
Seat 9: Vascaino_017 (7468 in chips) 
Kejsi_Raibek: posts the ante 70
NanoDen: posts the ante 70
thehman764: posts the ante 70
ricardovinog: posts the ante 70
TURoff: posts the ante 70
patriicksb: posts the ante 70
Redron86: posts the ante 70
h@st@ baby: posts the ante 70
Vascaino_017: posts the ante 70
TURoff: posts small blind 300
patriicksb: posts big blind 600
*** HOLE CARDS ***
Dealt to TURoff [8s As]
Redron86: folds 
h@st@ baby: raises 6890 to 7490 and is all-in
Vascaino_017: folds 
Kejsi_Raibek: folds 
NanoDen: folds 
thehman764: folds 
ricardovinog: folds 
TURoff: folds 
patriicksb: folds 
Uncalled bet (6890) returned to h@st@ baby
h@st@ baby collected 2130 from pot
h@st@ baby: doesn't show hand 
*** SUMMARY ***
Total pot 2130 | Rake 0 
Seat 1: Kejsi_Raibek folded before Flop (didn't bet)
Seat 2: NanoDen folded before Flop (didn't bet)
Seat 3: thehman764 folded before Flop (didn't bet)
Seat 4: ricardovinog (button) folded before Flop (didn't bet)
Seat 5: TURoff (small blind) folded before Flop
Seat 6: patriicksb (big blind) folded before Flop
Seat 7: Redron86 folded before Flop (didn't bet)
Seat 8: h@st@ baby collected (2130)
Seat 9: Vascaino_017 folded before Flop (didn't bet)





PokerStars Hand #177198781249: Tournament #2067822782, $1.00+$0.10 USD Hold'em No Limit - Level XIV (300/600) - 2017/10/21 21:18:41 CUST [2017/10/21 13:18:41 ET]
Table '2067822782 27' 9-max Seat #5 is the button
Seat 1: Kejsi_Raibek (5213 in chips) is sitting out
Seat 2: NanoDen (6930 in chips) 
Seat 3: thehman764 (3156 in chips) 
Seat 4: ricardovinog (8844 in chips) 
Seat 5: TURoff (26783 in chips) 
Seat 6: patriicksb (4480 in chips) 
Seat 7: Redron86 (9719 in chips) 
Seat 8: h@st@ baby (9020 in chips) 
Seat 9: Vascaino_017 (7398 in chips) 
Kejsi_Raibek: posts the ante 70
NanoDen: posts the ante 70
thehman764: posts the ante 70
ricardovinog: posts the ante 70
TURoff: posts the ante 70
patriicksb: posts the ante 70
Redron86: posts the ante 70
h@st@ baby: posts the ante 70
Vascaino_017: posts the ante 70
patriicksb: posts small blind 300
Redron86: posts big blind 600
*** HOLE CARDS ***
Dealt to TURoff [Ts Ac]
h@st@ baby: folds 
Vascaino_017: raises 6728 to 7328 and is all-in
Kejsi_Raibek: folds 
NanoDen: folds 
thehman764: folds 
ricardovinog: folds 
TURoff: folds 
patriicksb: folds 
Redron86: folds 
Uncalled bet (6728) returned to Vascaino_017
Vascaino_017 collected 2130 from pot
Vascaino_017: doesn't show hand 
*** SUMMARY ***
Total pot 2130 | Rake 0 
Seat 1: Kejsi_Raibek folded before Flop (didn't bet)
Seat 2: NanoDen folded before Flop (didn't bet)
Seat 3: thehman764 folded before Flop (didn't bet)
Seat 4: ricardovinog folded before Flop (didn't bet)
Seat 5: TURoff (button) folded before Flop (didn't bet)
Seat 6: patriicksb (small blind) folded before Flop
Seat 7: Redron86 (big blind) folded before Flop
Seat 8: h@st@ baby folded before Flop (didn't bet)
Seat 9: Vascaino_017 collected (2130)





PokerStars Hand #177198806855: Tournament #2067822782, $1.00+$0.10 USD Hold'em No Limit - Level XIV (300/600) - 2017/10/21 21:19:16 CUST [2017/10/21 13:19:16 ET]
Table '2067822782 27' 9-max Seat #6 is the button
Seat 1: Kejsi_Raibek (5143 in chips) is sitting out
Seat 2: NanoDen (6860 in chips) 
Seat 3: thehman764 (3086 in chips) 
Seat 4: ricardovinog (8774 in chips) 
Seat 5: TURoff (26713 in chips) 
Seat 6: patriicksb (4110 in chips) 
Seat 7: Redron86 (9049 in chips) 
Seat 8: h@st@ baby (8950 in chips) 
Seat 9: Vascaino_017 (8858 in chips) 
Kejsi_Raibek: posts the ante 70
NanoDen: posts the ante 70
thehman764: posts the ante 70
ricardovinog: posts the ante 70
TURoff: posts the ante 70
patriicksb: posts the ante 70
Redron86: posts the ante 70
h@st@ baby: posts the ante 70
Vascaino_017: posts the ante 70
Redron86: posts small blind 300
h@st@ baby: posts big blind 600
*** HOLE CARDS ***
Dealt to TURoff [6h Kd]
Vascaino_017: folds 
Kejsi_Raibek: folds 
NanoDen: folds 
thehman764: folds 
ricardovinog: folds 
TURoff: raises 720 to 1320
patriicksb: folds 
Redron86: folds 
h@st@ baby: folds 
Uncalled bet (720) returned to TURoff
TURoff collected 2130 from pot
TURoff: doesn't show hand 
*** SUMMARY ***
Total pot 2130 | Rake 0 
Seat 1: Kejsi_Raibek folded before Flop (didn't bet)
Seat 2: NanoDen folded before Flop (didn't bet)
Seat 3: thehman764 folded before Flop (didn't bet)
Seat 4: ricardovinog folded before Flop (didn't bet)
Seat 5: TURoff collected (2130)
Seat 6: patriicksb (button) folded before Flop (didn't bet)
Seat 7: Redron86 (small blind) folded before Flop
Seat 8: h@st@ baby (big blind) folded before Flop
Seat 9: Vascaino_017 folded before Flop (didn't bet)





PokerStars Hand #177198825074: Tournament #2067822782, $1.00+$0.10 USD Hold'em No Limit - Level XIV (300/600) - 2017/10/21 21:19:41 CUST [2017/10/21 13:19:41 ET]
Table '2067822782 27' 9-max Seat #7 is the button
Seat 1: Kejsi_Raibek (5073 in chips) is sitting out
Seat 2: NanoDen (6790 in chips) 
Seat 3: thehman764 (3016 in chips) 
Seat 4: ricardovinog (8704 in chips) 
Seat 5: TURoff (28173 in chips) 
Seat 6: patriicksb (4040 in chips) 
Seat 7: Redron86 (8679 in chips) 
Seat 8: h@st@ baby (8280 in chips) 
Seat 9: Vascaino_017 (8788 in chips) 
Kejsi_Raibek: posts the ante 70
NanoDen: posts the ante 70
thehman764: posts the ante 70
ricardovinog: posts the ante 70
TURoff: posts the ante 70
patriicksb: posts the ante 70
Redron86: posts the ante 70
h@st@ baby: posts the ante 70
Vascaino_017: posts the ante 70
h@st@ baby: posts small blind 300
Vascaino_017: posts big blind 600
*** HOLE CARDS ***
Dealt to TURoff [3c Th]
Kejsi_Raibek: folds 
NanoDen: folds 
thehman764: folds 
ricardovinog: folds 
TURoff: folds 
patriicksb: folds 
Redron86: folds 
h@st@ baby: folds 
Uncalled bet (300) returned to Vascaino_017
Vascaino_017 collected 1230 from pot
Vascaino_017: doesn't show hand 
*** SUMMARY ***
Total pot 1230 | Rake 0 
Seat 1: Kejsi_Raibek folded before Flop (didn't bet)
Seat 2: NanoDen folded before Flop (didn't bet)
Seat 3: thehman764 folded before Flop (didn't bet)
Seat 4: ricardovinog folded before Flop (didn't bet)
Seat 5: TURoff folded before Flop (didn't bet)
Seat 6: patriicksb folded before Flop (didn't bet)
Seat 7: Redron86 (button) folded before Flop (didn't bet)
Seat 8: h@st@ baby (small blind) folded before Flop
Seat 9: Vascaino_017 (big blind) collected (1230)





PokerStars Hand #177198844379: Tournament #2067822782, $1.00+$0.10 USD Hold'em No Limit - Level XIV (300/600) - 2017/10/21 21:20:07 CUST [2017/10/21 13:20:07 ET]
Table '2067822782 27' 9-max Seat #8 is the button
Seat 1: Kejsi_Raibek (5003 in chips) is sitting out
Seat 2: NanoDen (6720 in chips) 
Seat 3: thehman764 (2946 in chips) 
Seat 4: ricardovinog (8634 in chips) 
Seat 5: TURoff (28103 in chips) 
Seat 6: patriicksb (3970 in chips) 
Seat 7: Redron86 (8609 in chips) 
Seat 8: h@st@ baby (7910 in chips) 
Seat 9: Vascaino_017 (9648 in chips) 
Kejsi_Raibek: posts the ante 70
NanoDen: posts the ante 70
thehman764: posts the ante 70
ricardovinog: posts the ante 70
TURoff: posts the ante 70
patriicksb: posts the ante 70
Redron86: posts the ante 70
h@st@ baby: posts the ante 70
Vascaino_017: posts the ante 70
Vascaino_017: posts small blind 300
Kejsi_Raibek: posts big blind 600
*** HOLE CARDS ***
Dealt to TURoff [4s 6s]
NanoDen: raises 6050 to 6650 and is all-in
thehman764: folds 
ricardovinog: folds 
TURoff: folds 
patriicksb: folds 
Redron86: folds 
h@st@ baby: folds 
Vascaino_017: raises 2928 to 9578 and is all-in
Kejsi_Raibek: folds 
Uncalled bet (2928) returned to Vascaino_017
*** FLOP *** [4h 6d Th]
*** TURN *** [4h 6d Th] [5c]
*** RIVER *** [4h 6d Th 5c] [7h]
*** SHOW DOWN ***
Vascaino_017: shows [Ad Jc] (high card Ace)
NanoDen: shows [Ah 9c] (high card Ace - lower kicker)
Vascaino_017 collected 14530 from pot
NanoDen finished the tournament in 439th place and received $1.81.
*** SUMMARY ***
Total pot 14530 | Rake 0 
Board [4h 6d Th 5c 7h]
Seat 1: Kejsi_Raibek (big blind) folded before Flop
Seat 2: NanoDen showed [Ah 9c] and lost with high card Ace
Seat 3: thehman764 folded before Flop (didn't bet)
Seat 4: ricardovinog folded before Flop (didn't bet)
Seat 5: TURoff folded before Flop (didn't bet)
Seat 6: patriicksb folded before Flop (didn't bet)
Seat 7: Redron86 folded before Flop (didn't bet)
Seat 8: h@st@ baby (button) folded before Flop (didn't bet)
Seat 9: Vascaino_017 (small blind) showed [Ad Jc] and won (14530) with high card Ace





PokerStars Hand #177198873652: Tournament #2067822782, $1.00+$0.10 USD Hold'em No Limit - Level XIV (300/600) - 2017/10/21 21:20:47 CUST [2017/10/21 13:20:47 ET]
Table '2067822782 27' 9-max Seat #9 is the button
Seat 1: Kejsi_Raibek (4333 in chips) is sitting out
Seat 3: thehman764 (2876 in chips) 
Seat 4: ricardovinog (8564 in chips) 
Seat 5: TURoff (28033 in chips) 
Seat 6: patriicksb (3900 in chips) 
Seat 7: Redron86 (8539 in chips) 
Seat 8: h@st@ baby (7840 in chips) 
Seat 9: Vascaino_017 (17458 in chips) 
Kejsi_Raibek: posts the ante 70
thehman764: posts the ante 70
ricardovinog: posts the ante 70
TURoff: posts the ante 70
patriicksb: posts the ante 70
Redron86: posts the ante 70
h@st@ baby: posts the ante 70
Vascaino_017: posts the ante 70
Kejsi_Raibek: posts small blind 300
thehman764: posts big blind 600
*** HOLE CARDS ***
Dealt to TURoff [8s 5d]
ricardovinog: folds 
TURoff: folds 
patriicksb: folds 
Redron86: calls 600
h@st@ baby: folds 
Vascaino_017: folds 
Kejsi_Raibek: folds 
thehman764: checks 
*** FLOP *** [7s Jh Ac]
thehman764: checks 
Redron86: checks 
*** TURN *** [7s Jh Ac] [7h]
thehman764: bets 1030
Redron86: raises 1030 to 2060
thehman764: calls 1030
*** RIVER *** [7s Jh Ac 7h] [2h]
thehman764: bets 146 and is all-in
Redron86: calls 146
*** SHOW DOWN ***
thehman764: shows [Jd 4d] (two pair, Jacks and Sevens)
Redron86: shows [Ks Kd] (two pair, Kings and Sevens)
Redron86 collected 6472 from pot
thehman764 finished the tournament in 426th place and received $1.81.
*** SUMMARY ***
Total pot 6472 | Rake 0 
Board [7s Jh Ac 7h 2h]
Seat 1: Kejsi_Raibek (small blind) folded before Flop
Seat 3: thehman764 (big blind) showed [Jd 4d] and lost with two pair, Jacks and Sevens
Seat 4: ricardovinog folded before Flop (didn't bet)
Seat 5: TURoff folded before Flop (didn't bet)
Seat 6: patriicksb folded before Flop (didn't bet)
Seat 7: Redron86 showed [Ks Kd] and won (6472) with two pair, Kings and Sevens
Seat 8: h@st@ baby folded before Flop (didn't bet)
Seat 9: Vascaino_017 (button) folded before Flop (didn't bet)





PokerStars Hand #177198920767: Tournament #2067822782, $1.00+$0.10 USD Hold'em No Limit - Level XV (350/700) - 2017/10/21 21:21:51 CUST [2017/10/21 13:21:51 ET]
Table '2067822782 27' 9-max Seat #1 is the button
Seat 1: Kejsi_Raibek (3963 in chips) is sitting out
Seat 2: tatzinger (7710 in chips) out of hand (moved from another table into small blind)
Seat 4: ricardovinog (8494 in chips) 
Seat 5: TURoff (27963 in chips) 
Seat 6: patriicksb (3830 in chips) 
Seat 7: Redron86 (12135 in chips) 
Seat 8: h@st@ baby (7770 in chips) 
Seat 9: Vascaino_017 (17388 in chips) 
Kejsi_Raibek: posts the ante 85
ricardovinog: posts the ante 85
TURoff: posts the ante 85
patriicksb: posts the ante 85
Redron86: posts the ante 85
h@st@ baby: posts the ante 85
Vascaino_017: posts the ante 85
ricardovinog: posts small blind 350
TURoff: posts big blind 700
*** HOLE CARDS ***
Dealt to TURoff [Jd 4s]
patriicksb: folds 
Redron86: folds 
h@st@ baby: folds 
Vascaino_017: folds 
Kejsi_Raibek: folds 
ricardovinog: raises 7709 to 8409 and is all-in
TURoff: folds 
Uncalled bet (7709) returned to ricardovinog
ricardovinog collected 1995 from pot
ricardovinog: doesn't show hand 
*** SUMMARY ***
Total pot 1995 | Rake 0 
Seat 1: Kejsi_Raibek (button) folded before Flop (didn't bet)
Seat 4: ricardovinog (small blind) collected (1995)
Seat 5: TURoff (big blind) folded before Flop
Seat 6: patriicksb folded before Flop (didn't bet)
Seat 7: Redron86 folded before Flop (didn't bet)
Seat 8: h@st@ baby folded before Flop (didn't bet)
Seat 9: Vascaino_017 folded before Flop (didn't bet)





PokerStars Hand #177198949311: Tournament #2067822782, $1.00+$0.10 USD Hold'em No Limit - Level XV (350/700) - 2017/10/21 21:22:30 CUST [2017/10/21 13:22:30 ET]
Table '2067822782 27' 9-max Seat #4 is the button
Seat 1: Kejsi_Raibek (3878 in chips) is sitting out
Seat 2: tatzinger (7710 in chips) 
Seat 3: stangalstyks (41005 in chips) 
Seat 4: ricardovinog (9704 in chips) 
Seat 5: TURoff (27178 in chips) 
Seat 6: patriicksb (3745 in chips) 
Seat 7: Redron86 (12050 in chips) 
Seat 8: h@st@ baby (7685 in chips) 
Seat 9: Vascaino_017 (17303 in chips) 
Kejsi_Raibek: posts the ante 85
tatzinger: posts the ante 85
stangalstyks: posts the ante 85
ricardovinog: posts the ante 85
TURoff: posts the ante 85
patriicksb: posts the ante 85
Redron86: posts the ante 85
h@st@ baby: posts the ante 85
Vascaino_017: posts the ante 85
TURoff: posts small blind 350
patriicksb: posts big blind 700
*** HOLE CARDS ***
Dealt to TURoff [3h 3d]
Redron86: folds 
h@st@ baby: folds 
Vascaino_017: folds 
Kejsi_Raibek: folds 
tatzinger: folds 
stangalstyks: folds 
ricardovinog: folds 
TURoff: raises 26393 to 27093 and is all-in
patriicksb: calls 2960 and is all-in
Uncalled bet (23433) returned to TURoff
*** FLOP *** [2h 4d 6h]
*** TURN *** [2h 4d 6h] [4c]
*** RIVER *** [2h 4d 6h 4c] [Kd]
*** SHOW DOWN ***
TURoff: shows [3h 3d] (two pair, Fours and Threes)
patriicksb: shows [6d Qd] (two pair, Sixes and Fours)
patriicksb collected 8085 from pot
*** SUMMARY ***
Total pot 8085 | Rake 0 
Board [2h 4d 6h 4c Kd]
Seat 1: Kejsi_Raibek folded before Flop (didn't bet)
Seat 2: tatzinger folded before Flop (didn't bet)
Seat 3: stangalstyks folded before Flop (didn't bet)
Seat 4: ricardovinog (button) folded before Flop (didn't bet)
Seat 5: TURoff (small blind) showed [3h 3d] and lost with two pair, Fours and Threes
Seat 6: patriicksb (big blind) showed [6d Qd] and won (8085) with two pair, Sixes and Fours
Seat 7: Redron86 folded before Flop (didn't bet)
Seat 8: h@st@ baby folded before Flop (didn't bet)
Seat 9: Vascaino_017 folded before Flop (didn't bet)





PokerStars Hand #177198977336: Tournament #2067822782, $1.00+$0.10 USD Hold'em No Limit - Level XV (350/700) - 2017/10/21 21:23:08 CUST [2017/10/21 13:23:08 ET]
Table '2067822782 27' 9-max Seat #5 is the button
Seat 1: Kejsi_Raibek (3793 in chips) is sitting out
Seat 2: tatzinger (7625 in chips) 
Seat 3: stangalstyks (40920 in chips) 
Seat 4: ricardovinog (9619 in chips) 
Seat 5: TURoff (23433 in chips) 
Seat 6: patriicksb (8085 in chips) 
Seat 7: Redron86 (11965 in chips) 
Seat 8: h@st@ baby (7600 in chips) 
Seat 9: Vascaino_017 (17218 in chips) 
Kejsi_Raibek: posts the ante 85
tatzinger: posts the ante 85
stangalstyks: posts the ante 85
ricardovinog: posts the ante 85
TURoff: posts the ante 85
patriicksb: posts the ante 85
Redron86: posts the ante 85
h@st@ baby: posts the ante 85
Vascaino_017: posts the ante 85
patriicksb: posts small blind 350
Redron86: posts big blind 700
*** HOLE CARDS ***
Dealt to TURoff [7d 6h]
h@st@ baby: folds 
Vascaino_017: folds 
Kejsi_Raibek: folds 
tatzinger: folds 
stangalstyks: folds 
ricardovinog: raises 700 to 1400
TURoff: folds 
patriicksb: folds 
Redron86: folds 
Uncalled bet (700) returned to ricardovinog
ricardovinog collected 2515 from pot
ricardovinog: doesn't show hand 
*** SUMMARY ***
Total pot 2515 | Rake 0 
Seat 1: Kejsi_Raibek folded before Flop (didn't bet)
Seat 2: tatzinger folded before Flop (didn't bet)
Seat 3: stangalstyks folded before Flop (didn't bet)
Seat 4: ricardovinog collected (2515)
Seat 5: TURoff (button) folded before Flop (didn't bet)
Seat 6: patriicksb (small blind) folded before Flop
Seat 7: Redron86 (big blind) folded before Flop
Seat 8: h@st@ baby folded before Flop (didn't bet)
Seat 9: Vascaino_017 folded before Flop (didn't bet)





PokerStars Hand #177199001153: Tournament #2067822782, $1.00+$0.10 USD Hold'em No Limit - Level XV (350/700) - 2017/10/21 21:23:41 CUST [2017/10/21 13:23:41 ET]
Table '2067822782 27' 9-max Seat #6 is the button
Seat 1: Kejsi_Raibek (3708 in chips) is sitting out
Seat 2: tatzinger (7540 in chips) 
Seat 3: stangalstyks (40835 in chips) 
Seat 4: ricardovinog (11349 in chips) 
Seat 5: TURoff (23348 in chips) 
Seat 6: patriicksb (7650 in chips) 
Seat 7: Redron86 (11180 in chips) 
Seat 8: h@st@ baby (7515 in chips) 
Seat 9: Vascaino_017 (17133 in chips) 
Kejsi_Raibek: posts the ante 85
tatzinger: posts the ante 85
stangalstyks: posts the ante 85
ricardovinog: posts the ante 85
TURoff: posts the ante 85
patriicksb: posts the ante 85
Redron86: posts the ante 85
h@st@ baby: posts the ante 85
Vascaino_017: posts the ante 85
Redron86: posts small blind 350
h@st@ baby: posts big blind 700
*** HOLE CARDS ***
Dealt to TURoff [Qd 6h]
Vascaino_017: folds 
Kejsi_Raibek: folds 
tatzinger: folds 
stangalstyks: folds 
ricardovinog: folds 
TURoff: folds 
patriicksb: raises 6865 to 7565 and is all-in
Redron86: folds 
h@st@ baby: folds 
Uncalled bet (6865) returned to patriicksb
patriicksb collected 2515 from pot
Kejsi_Raibek has returned
*** SUMMARY ***
Total pot 2515 | Rake 0 
Seat 1: Kejsi_Raibek folded before Flop (didn't bet)
Seat 2: tatzinger folded before Flop (didn't bet)
Seat 3: stangalstyks folded before Flop (didn't bet)
Seat 4: ricardovinog folded before Flop (didn't bet)
Seat 5: TURoff folded before Flop (didn't bet)
Seat 6: patriicksb (button) collected (2515)
Seat 7: Redron86 (small blind) folded before Flop
Seat 8: h@st@ baby (big blind) folded before Flop
Seat 9: Vascaino_017 folded before Flop (didn't bet)





PokerStars Hand #177199013534: Tournament #2067822782, $1.00+$0.10 USD Hold'em No Limit - Level XV (350/700) - 2017/10/21 21:23:58 CUST [2017/10/21 13:23:58 ET]
Table '2067822782 27' 9-max Seat #7 is the button
Seat 1: Kejsi_Raibek (3623 in chips) 
Seat 2: tatzinger (7455 in chips) 
Seat 3: stangalstyks (40750 in chips) 
Seat 4: ricardovinog (11264 in chips) 
Seat 5: TURoff (23263 in chips) 
Seat 6: patriicksb (9380 in chips) 
Seat 7: Redron86 (10745 in chips) 
Seat 8: h@st@ baby (6730 in chips) 
Seat 9: Vascaino_017 (17048 in chips) 
Kejsi_Raibek: posts the ante 85
tatzinger: posts the ante 85
stangalstyks: posts the ante 85
ricardovinog: posts the ante 85
TURoff: posts the ante 85
patriicksb: posts the ante 85
Redron86: posts the ante 85
h@st@ baby: posts the ante 85
Vascaino_017: posts the ante 85
h@st@ baby: posts small blind 350
Vascaino_017: posts big blind 700
*** HOLE CARDS ***
Dealt to TURoff [6c 7h]
Kejsi_Raibek: folds 
tatzinger: folds 
stangalstyks: folds 
ricardovinog: folds 
TURoff: folds 
patriicksb: folds 
Redron86: folds 
h@st@ baby: raises 1050 to 1750
Vascaino_017: folds 
Uncalled bet (1050) returned to h@st@ baby
h@st@ baby collected 2165 from pot
h@st@ baby: doesn't show hand 
*** SUMMARY ***
Total pot 2165 | Rake 0 
Seat 1: Kejsi_Raibek folded before Flop (didn't bet)
Seat 2: tatzinger folded before Flop (didn't bet)
Seat 3: stangalstyks folded before Flop (didn't bet)
Seat 4: ricardovinog folded before Flop (didn't bet)
Seat 5: TURoff folded before Flop (didn't bet)
Seat 6: patriicksb folded before Flop (didn't bet)
Seat 7: Redron86 (button) folded before Flop (didn't bet)
Seat 8: h@st@ baby (small blind) collected (2165)
Seat 9: Vascaino_017 (big blind) folded before Flop





PokerStars Hand #177199042899: Tournament #2067822782, $1.00+$0.10 USD Hold'em No Limit - Level XV (350/700) - 2017/10/21 21:24:38 CUST [2017/10/21 13:24:38 ET]
Table '2067822782 27' 9-max Seat #8 is the button
Seat 1: Kejsi_Raibek (3538 in chips) 
Seat 2: tatzinger (7370 in chips) 
Seat 3: stangalstyks (40665 in chips) 
Seat 4: ricardovinog (11179 in chips) 
Seat 5: TURoff (23178 in chips) 
Seat 6: patriicksb (9295 in chips) 
Seat 7: Redron86 (10660 in chips) 
Seat 8: h@st@ baby (8110 in chips) 
Seat 9: Vascaino_017 (16263 in chips) 
Kejsi_Raibek: posts the ante 85
tatzinger: posts the ante 85
stangalstyks: posts the ante 85
ricardovinog: posts the ante 85
TURoff: posts the ante 85
patriicksb: posts the ante 85
Redron86: posts the ante 85
h@st@ baby: posts the ante 85
Vascaino_017: posts the ante 85
Vascaino_017: posts small blind 350
Kejsi_Raibek: posts big blind 700
*** HOLE CARDS ***
Dealt to TURoff [As Kh]
tatzinger: calls 700
stangalstyks: folds 
ricardovinog: folds 
TURoff: raises 2300 to 3000
patriicksb: folds 
Redron86: folds 
h@st@ baby: folds 
Vascaino_017: folds 
Kejsi_Raibek: folds 
tatzinger: calls 2300
*** FLOP *** [Kc 8c 2s]
tatzinger: bets 4285 and is all-in
TURoff: calls 4285
*** TURN *** [Kc 8c 2s] [9c]
*** RIVER *** [Kc 8c 2s 9c] [6d]
*** SHOW DOWN ***
tatzinger: shows [9s Ac] (a pair of Nines)
TURoff: shows [As Kh] (a pair of Kings)
TURoff collected 16385 from pot
tatzinger finished the tournament in 385th place and received $2.08.
*** SUMMARY ***
Total pot 16385 | Rake 0 
Board [Kc 8c 2s 9c 6d]
Seat 1: Kejsi_Raibek (big blind) folded before Flop
Seat 2: tatzinger showed [9s Ac] and lost with a pair of Nines
Seat 3: stangalstyks folded before Flop (didn't bet)
Seat 4: ricardovinog folded before Flop (didn't bet)
Seat 5: TURoff showed [As Kh] and won (16385) with a pair of Kings
Seat 6: patriicksb folded before Flop (didn't bet)
Seat 7: Redron86 folded before Flop (didn't bet)
Seat 8: h@st@ baby (button) folded before Flop (didn't bet)
Seat 9: Vascaino_017 (small blind) folded before Flop





PokerStars Hand #177199094038: Tournament #2067822782, $1.00+$0.10 USD Hold'em No Limit - Level XV (350/700) - 2017/10/21 21:25:47 CUST [2017/10/21 13:25:47 ET]
Table '2067822782 27' 9-max Seat #9 is the button
Seat 1: Kejsi_Raibek (2753 in chips) 
Seat 3: stangalstyks (40580 in chips) 
Seat 4: ricardovinog (11094 in chips) 
Seat 5: TURoff (32193 in chips) 
Seat 6: patriicksb (9210 in chips) 
Seat 7: Redron86 (10575 in chips) 
Seat 8: h@st@ baby (8025 in chips) 
Seat 9: Vascaino_017 (15828 in chips) 
Kejsi_Raibek: posts the ante 85
stangalstyks: posts the ante 85
ricardovinog: posts the ante 85
TURoff: posts the ante 85
patriicksb: posts the ante 85
Redron86: posts the ante 85
h@st@ baby: posts the ante 85
Vascaino_017: posts the ante 85
Kejsi_Raibek: posts small blind 350
stangalstyks: posts big blind 700
*** HOLE CARDS ***
Dealt to TURoff [5s 5d]
ricardovinog: folds 
TURoff: raises 840 to 1540
patriicksb: folds 
Redron86: folds 
h@st@ baby: folds 
Vascaino_017: raises 3360 to 4900
Kejsi_Raibek: folds 
stangalstyks: calls 4200
TURoff: folds 
*** FLOP *** [3s Qs Ts]
stangalstyks: checks 
Vascaino_017: bets 10843 and is all-in
stangalstyks: folds 
Uncalled bet (10843) returned to Vascaino_017
Vascaino_017 collected 12370 from pot
Vascaino_017: doesn't show hand 
*** SUMMARY ***
Total pot 12370 | Rake 0 
Board [3s Qs Ts]
Seat 1: Kejsi_Raibek (small blind) folded before Flop
Seat 3: stangalstyks (big blind) folded on the Flop
Seat 4: ricardovinog folded before Flop (didn't bet)
Seat 5: TURoff folded before Flop
Seat 6: patriicksb folded before Flop (didn't bet)
Seat 7: Redron86 folded before Flop (didn't bet)
Seat 8: h@st@ baby folded before Flop (didn't bet)
Seat 9: Vascaino_017 (button) collected (12370)





PokerStars Hand #177199159516: Tournament #2067822782, $1.00+$0.10 USD Hold'em No Limit - Level XV (350/700) - 2017/10/21 21:27:16 CUST [2017/10/21 13:27:16 ET]
Table '2067822782 27' 9-max Seat #1 is the button
Seat 1: Kejsi_Raibek (2318 in chips) 
Seat 2: tr.amateuz (7266 in chips) out of hand (moved from another table into small blind)
Seat 3: stangalstyks (35595 in chips) 
Seat 4: ricardovinog (11009 in chips) 
Seat 5: TURoff (30568 in chips) 
Seat 6: patriicksb (9125 in chips) 
Seat 7: Redron86 (10490 in chips) 
Seat 8: h@st@ baby (7940 in chips) 
Seat 9: Vascaino_017 (23213 in chips) 
Kejsi_Raibek: posts the ante 85
stangalstyks: posts the ante 85
ricardovinog: posts the ante 85
TURoff: posts the ante 85
patriicksb: posts the ante 85
Redron86: posts the ante 85
h@st@ baby: posts the ante 85
Vascaino_017: posts the ante 85
stangalstyks: posts small blind 350
ricardovinog: posts big blind 700
*** HOLE CARDS ***
Dealt to TURoff [As 2d]
TURoff: folds 
patriicksb: folds 
Redron86: folds 
h@st@ baby: folds 
Vascaino_017: folds 
Kejsi_Raibek: folds 
stangalstyks: calls 350
ricardovinog: raises 1400 to 2100
stangalstyks: folds 
Uncalled bet (1400) returned to ricardovinog
ricardovinog collected 2080 from pot
ricardovinog: doesn't show hand 
*** SUMMARY ***
Total pot 2080 | Rake 0 
Seat 1: Kejsi_Raibek (button) folded before Flop (didn't bet)
Seat 3: stangalstyks (small blind) folded before Flop
Seat 4: ricardovinog (big blind) collected (2080)
Seat 5: TURoff folded before Flop (didn't bet)
Seat 6: patriicksb folded before Flop (didn't bet)
Seat 7: Redron86 folded before Flop (didn't bet)
Seat 8: h@st@ baby folded before Flop (didn't bet)
Seat 9: Vascaino_017 folded before Flop (didn't bet)





PokerStars Hand #177199186708: Tournament #2067822782, $1.00+$0.10 USD Hold'em No Limit - Level XV (350/700) - 2017/10/21 21:27:53 CUST [2017/10/21 13:27:53 ET]
Table '2067822782 27' 9-max Seat #3 is the button
Seat 1: Kejsi_Raibek (2233 in chips) 
Seat 2: tr.amateuz (7266 in chips) 
Seat 3: stangalstyks (34810 in chips) 
Seat 4: ricardovinog (12304 in chips) 
Seat 5: TURoff (30483 in chips) 
Seat 6: patriicksb (9040 in chips) 
Seat 7: Redron86 (10405 in chips) 
Seat 8: h@st@ baby (7855 in chips) 
Seat 9: Vascaino_017 (23128 in chips) 
Kejsi_Raibek: posts the ante 85
tr.amateuz: posts the ante 85
stangalstyks: posts the ante 85
ricardovinog: posts the ante 85
TURoff: posts the ante 85
patriicksb: posts the ante 85
Redron86: posts the ante 85
h@st@ baby: posts the ante 85
Vascaino_017: posts the ante 85
ricardovinog: posts small blind 350
TURoff: posts big blind 700
*** HOLE CARDS ***
Dealt to TURoff [Tc Ad]
patriicksb: folds 
Redron86: folds 
h@st@ baby: folds 
Vascaino_017: folds 
Kejsi_Raibek: folds 
tr.amateuz: folds 
stangalstyks: folds 
ricardovinog: calls 350
TURoff: raises 1400 to 2100
ricardovinog: folds 
Uncalled bet (1400) returned to TURoff
TURoff collected 2165 from pot
TURoff: doesn't show hand 
*** SUMMARY ***
Total pot 2165 | Rake 0 
Seat 1: Kejsi_Raibek folded before Flop (didn't bet)
Seat 2: tr.amateuz folded before Flop (didn't bet)
Seat 3: stangalstyks (button) folded before Flop (didn't bet)
Seat 4: ricardovinog (small blind) folded before Flop
Seat 5: TURoff (big blind) collected (2165)
Seat 6: patriicksb folded before Flop (didn't bet)
Seat 7: Redron86 folded before Flop (didn't bet)
Seat 8: h@st@ baby folded before Flop (didn't bet)
Seat 9: Vascaino_017 folded before Flop (didn't bet)





PokerStars Hand #177199220651: Tournament #2067822782, $1.00+$0.10 USD Hold'em No Limit - Level XV (350/700) - 2017/10/21 21:28:39 CUST [2017/10/21 13:28:39 ET]
Table '2067822782 27' 9-max Seat #4 is the button
Seat 1: Kejsi_Raibek (2148 in chips) 
Seat 2: tr.amateuz (7181 in chips) 
Seat 3: stangalstyks (34725 in chips) 
Seat 4: ricardovinog (11519 in chips) 
Seat 5: TURoff (31863 in chips) 
Seat 6: patriicksb (8955 in chips) 
Seat 7: Redron86 (10320 in chips) 
Seat 8: h@st@ baby (7770 in chips) 
Seat 9: Vascaino_017 (23043 in chips) 
Kejsi_Raibek: posts the ante 85
tr.amateuz: posts the ante 85
stangalstyks: posts the ante 85
ricardovinog: posts the ante 85
TURoff: posts the ante 85
patriicksb: posts the ante 85
Redron86: posts the ante 85
h@st@ baby: posts the ante 85
Vascaino_017: posts the ante 85
TURoff: posts small blind 350
patriicksb: posts big blind 700
*** HOLE CARDS ***
Dealt to TURoff [9h Td]
Redron86: folds 
h@st@ baby: folds 
Vascaino_017: raises 700 to 1400
Kejsi_Raibek: folds 
tr.amateuz: folds 
stangalstyks: folds 
ricardovinog: folds 
TURoff: folds 
patriicksb: calls 700
*** FLOP *** [4h Kh As]
patriicksb: checks 
Vascaino_017: bets 1958
patriicksb: raises 5512 to 7470 and is all-in
Vascaino_017: calls 5512
*** TURN *** [4h Kh As] [4c]
*** RIVER *** [4h Kh As 4c] [5h]
*** SHOW DOWN ***
patriicksb: shows [Ah Tc] (two pair, Aces and Fours)
Vascaino_017: shows [Ac Kc] (two pair, Aces and Kings)
Vascaino_017 collected 18855 from pot
patriicksb finished the tournament in 357th place and received $2.08.
*** SUMMARY ***
Total pot 18855 | Rake 0 
Board [4h Kh As 4c 5h]
Seat 1: Kejsi_Raibek folded before Flop (didn't bet)
Seat 2: tr.amateuz folded before Flop (didn't bet)
Seat 3: stangalstyks folded before Flop (didn't bet)
Seat 4: ricardovinog (button) folded before Flop (didn't bet)
Seat 5: TURoff (small blind) folded before Flop
Seat 6: patriicksb (big blind) showed [Ah Tc] and lost with two pair, Aces and Fours
Seat 7: Redron86 folded before Flop (didn't bet)
Seat 8: h@st@ baby folded before Flop (didn't bet)
Seat 9: Vascaino_017 showed [Ac Kc] and won (18855) with two pair, Aces and Kings





PokerStars Hand #177199253590: Tournament #2067822782, $1.00+$0.10 USD Hold'em No Limit - Level XV (350/700) - 2017/10/21 21:29:24 CUST [2017/10/21 13:29:24 ET]
Table '2067822782 27' 9-max Seat #5 is the button
Seat 1: Kejsi_Raibek (2063 in chips) 
Seat 2: tr.amateuz (7096 in chips) 
Seat 3: stangalstyks (34640 in chips) 
Seat 4: ricardovinog (11434 in chips) 
Seat 5: TURoff (31428 in chips) 
Seat 7: Redron86 (10235 in chips) 
Seat 8: h@st@ baby (7685 in chips) 
Seat 9: Vascaino_017 (32943 in chips) 
Kejsi_Raibek: posts the ante 85
tr.amateuz: posts the ante 85
stangalstyks: posts the ante 85
ricardovinog: posts the ante 85
TURoff: posts the ante 85
Redron86: posts the ante 85
h@st@ baby: posts the ante 85
Vascaino_017: posts the ante 85
Redron86: posts small blind 350
h@st@ baby: posts big blind 700
*** HOLE CARDS ***
Dealt to TURoff [9c Jh]
Vascaino_017: folds 
Kejsi_Raibek: raises 1278 to 1978 and is all-in
tr.amateuz: folds 
stangalstyks: folds 
ricardovinog: folds 
TURoff: folds 
Redron86: folds 
h@st@ baby: calls 1278
*** FLOP *** [Kc As Js]
*** TURN *** [Kc As Js] [6s]
*** RIVER *** [Kc As Js 6s] [8d]
*** SHOW DOWN ***
h@st@ baby: shows [Qs Ks] (a flush, Ace high)
Kejsi_Raibek: shows [5d 5h] (a pair of Fives)
h@st@ baby collected 4986 from pot
Kejsi_Raibek finished the tournament in 353rd place and received $2.08.
*** SUMMARY ***
Total pot 4986 | Rake 0 
Board [Kc As Js 6s 8d]
Seat 1: Kejsi_Raibek showed [5d 5h] and lost with a pair of Fives
Seat 2: tr.amateuz folded before Flop (didn't bet)
Seat 3: stangalstyks folded before Flop (didn't bet)
Seat 4: ricardovinog folded before Flop (didn't bet)
Seat 5: TURoff (button) folded before Flop (didn't bet)
Seat 7: Redron86 (small blind) folded before Flop
Seat 8: h@st@ baby (big blind) showed [Qs Ks] and won (4986) with a flush, Ace high
Seat 9: Vascaino_017 folded before Flop (didn't bet)





PokerStars Hand #177199281185: Tournament #2067822782, $1.00+$0.10 USD Hold'em No Limit - Level XV (350/700) - 2017/10/21 21:30:01 CUST [2017/10/21 13:30:01 ET]
Table '2067822782 27' 9-max Seat #7 is the button
Seat 1: Zekko1983 (48571 in chips) 
Seat 2: tr.amateuz (7011 in chips) 
Seat 3: stangalstyks (34555 in chips) 
Seat 4: ricardovinog (11349 in chips) 
Seat 5: TURoff (31343 in chips) 
Seat 6: G.R.N.24 (7570 in chips) 
Seat 7: Redron86 (9800 in chips) 
Seat 8: h@st@ baby (10608 in chips) 
Seat 9: Vascaino_017 (32858 in chips) 
Zekko1983: posts the ante 85
tr.amateuz: posts the ante 85
stangalstyks: posts the ante 85
ricardovinog: posts the ante 85
TURoff: posts the ante 85
G.R.N.24: posts the ante 85
Redron86: posts the ante 85
h@st@ baby: posts the ante 85
Vascaino_017: posts the ante 85
h@st@ baby: posts small blind 350
Vascaino_017: posts big blind 700
*** HOLE CARDS ***
Dealt to TURoff [6h Tc]
Zekko1983: folds 
tr.amateuz: folds 
stangalstyks: folds 
ricardovinog: raises 700 to 1400
TURoff: folds 
G.R.N.24: folds 
Redron86: folds 
h@st@ baby: folds 
Vascaino_017: folds 
Uncalled bet (700) returned to ricardovinog
ricardovinog collected 2515 from pot
ricardovinog: doesn't show hand 
*** SUMMARY ***
Total pot 2515 | Rake 0 
Seat 1: Zekko1983 folded before Flop (didn't bet)
Seat 2: tr.amateuz folded before Flop (didn't bet)
Seat 3: stangalstyks folded before Flop (didn't bet)
Seat 4: ricardovinog collected (2515)
Seat 5: TURoff folded before Flop (didn't bet)
Seat 6: G.R.N.24 folded before Flop (didn't bet)
Seat 7: Redron86 (button) folded before Flop (didn't bet)
Seat 8: h@st@ baby (small blind) folded before Flop
Seat 9: Vascaino_017 (big blind) folded before Flop





PokerStars Hand #177199302980: Tournament #2067822782, $1.00+$0.10 USD Hold'em No Limit - Level XV (350/700) - 2017/10/21 21:30:30 CUST [2017/10/21 13:30:30 ET]
Table '2067822782 27' 9-max Seat #8 is the button
Seat 1: Zekko1983 (48486 in chips) 
Seat 2: tr.amateuz (6926 in chips) 
Seat 3: stangalstyks (34470 in chips) 
Seat 4: ricardovinog (13079 in chips) 
Seat 5: TURoff (31258 in chips) 
Seat 6: G.R.N.24 (7485 in chips) 
Seat 7: Redron86 (9715 in chips) 
Seat 8: h@st@ baby (10173 in chips) 
Seat 9: Vascaino_017 (32073 in chips) 
Zekko1983: posts the ante 85
tr.amateuz: posts the ante 85
stangalstyks: posts the ante 85
ricardovinog: posts the ante 85
TURoff: posts the ante 85
G.R.N.24: posts the ante 85
Redron86: posts the ante 85
h@st@ baby: posts the ante 85
Vascaino_017: posts the ante 85
Vascaino_017: posts small blind 350
Zekko1983: posts big blind 700
*** HOLE CARDS ***
Dealt to TURoff [3s 2s]
tr.amateuz: folds 
stangalstyks: raises 770 to 1470
ricardovinog: folds 
TURoff: folds 
G.R.N.24: folds 
Redron86: folds 
h@st@ baby: folds 
Vascaino_017: folds 
Zekko1983: calls 770
*** FLOP *** [Qd 4d 4s]
Zekko1983: checks 
stangalstyks: bets 1217
Zekko1983: folds 
Uncalled bet (1217) returned to stangalstyks
stangalstyks collected 4055 from pot
stangalstyks: doesn't show hand 
*** SUMMARY ***
Total pot 4055 | Rake 0 
Board [Qd 4d 4s]
Seat 1: Zekko1983 (big blind) folded on the Flop
Seat 2: tr.amateuz folded before Flop (didn't bet)
Seat 3: stangalstyks collected (4055)
Seat 4: ricardovinog folded before Flop (didn't bet)
Seat 5: TURoff folded before Flop (didn't bet)
Seat 6: G.R.N.24 folded before Flop (didn't bet)
Seat 7: Redron86 folded before Flop (didn't bet)
Seat 8: h@st@ baby (button) folded before Flop (didn't bet)
Seat 9: Vascaino_017 (small blind) folded before Flop





PokerStars Hand #177199349852: Tournament #2067822782, $1.00+$0.10 USD Hold'em No Limit - Level XVI (400/800) - 2017/10/21 21:31:34 CUST [2017/10/21 13:31:34 ET]
Table '2067822782 27' 9-max Seat #9 is the button
Seat 1: Zekko1983 (46931 in chips) 
Seat 2: tr.amateuz (6841 in chips) 
Seat 3: stangalstyks (36970 in chips) 
Seat 4: ricardovinog (12994 in chips) 
Seat 5: TURoff (31173 in chips) 
Seat 6: G.R.N.24 (7400 in chips) 
Seat 7: Redron86 (9630 in chips) 
Seat 8: h@st@ baby (10088 in chips) 
Seat 9: Vascaino_017 (31638 in chips) 
Zekko1983: posts the ante 100
tr.amateuz: posts the ante 100
stangalstyks: posts the ante 100
ricardovinog: posts the ante 100
TURoff: posts the ante 100
G.R.N.24: posts the ante 100
Redron86: posts the ante 100
h@st@ baby: posts the ante 100
Vascaino_017: posts the ante 100
Zekko1983: posts small blind 400
tr.amateuz: posts big blind 800
*** HOLE CARDS ***
Dealt to TURoff [4s Ah]
stangalstyks: folds 
ricardovinog: folds 
TURoff: folds 
G.R.N.24: raises 6500 to 7300 and is all-in
Redron86: folds 
h@st@ baby: folds 
Vascaino_017: folds 
Zekko1983: folds 
tr.amateuz: folds 
Uncalled bet (6500) returned to G.R.N.24
G.R.N.24 collected 2900 from pot
G.R.N.24: doesn't show hand 
*** SUMMARY ***
Total pot 2900 | Rake 0 
Seat 1: Zekko1983 (small blind) folded before Flop
Seat 2: tr.amateuz (big blind) folded before Flop
Seat 3: stangalstyks folded before Flop (didn't bet)
Seat 4: ricardovinog folded before Flop (didn't bet)
Seat 5: TURoff folded before Flop (didn't bet)
Seat 6: G.R.N.24 collected (2900)
Seat 7: Redron86 folded before Flop (didn't bet)
Seat 8: h@st@ baby folded before Flop (didn't bet)
Seat 9: Vascaino_017 (button) folded before Flop (didn't bet)





PokerStars Hand #177199380764: Tournament #2067822782, $1.00+$0.10 USD Hold'em No Limit - Level XVI (400/800) - 2017/10/21 21:32:15 CUST [2017/10/21 13:32:15 ET]
Table '2067822782 27' 9-max Seat #1 is the button
Seat 1: Zekko1983 (46431 in chips) 
Seat 2: tr.amateuz (5941 in chips) 
Seat 3: stangalstyks (36870 in chips) 
Seat 4: ricardovinog (12894 in chips) 
Seat 5: TURoff (31073 in chips) 
Seat 6: G.R.N.24 (9400 in chips) 
Seat 7: Redron86 (9530 in chips) 
Seat 8: h@st@ baby (9988 in chips) 
Seat 9: Vascaino_017 (31538 in chips) 
Zekko1983: posts the ante 100
tr.amateuz: posts the ante 100
stangalstyks: posts the ante 100
ricardovinog: posts the ante 100
TURoff: posts the ante 100
G.R.N.24: posts the ante 100
Redron86: posts the ante 100
h@st@ baby: posts the ante 100
Vascaino_017: posts the ante 100
tr.amateuz: posts small blind 400
stangalstyks: posts big blind 800
*** HOLE CARDS ***
Dealt to TURoff [Qs Jc]
ricardovinog: folds 
TURoff: raises 960 to 1760
G.R.N.24: folds 
Redron86: folds 
h@st@ baby: folds 
Vascaino_017: folds 
Zekko1983: folds 
tr.amateuz: folds 
stangalstyks: calls 960
*** FLOP *** [8s 3s 5s]
stangalstyks: checks 
TURoff: bets 1600
stangalstyks: calls 1600
*** TURN *** [8s 3s 5s] [Tc]
stangalstyks: checks 
TURoff: bets 2400
stangalstyks: folds 
Uncalled bet (2400) returned to TURoff
TURoff collected 8020 from pot
TURoff: doesn't show hand 
*** SUMMARY ***
Total pot 8020 | Rake 0 
Board [8s 3s 5s Tc]
Seat 1: Zekko1983 (button) folded before Flop (didn't bet)
Seat 2: tr.amateuz (small blind) folded before Flop
Seat 3: stangalstyks (big blind) folded on the Turn
Seat 4: ricardovinog folded before Flop (didn't bet)
Seat 5: TURoff collected (8020)
Seat 6: G.R.N.24 folded before Flop (didn't bet)
Seat 7: Redron86 folded before Flop (didn't bet)
Seat 8: h@st@ baby folded before Flop (didn't bet)
Seat 9: Vascaino_017 folded before Flop (didn't bet)





PokerStars Hand #177199414917: Tournament #2067822782, $1.00+$0.10 USD Hold'em No Limit - Level XVI (400/800) - 2017/10/21 21:33:02 CUST [2017/10/21 13:33:02 ET]
Table '2067822782 27' 9-max Seat #2 is the button
Seat 1: Zekko1983 (46331 in chips) 
Seat 2: tr.amateuz (5441 in chips) 
Seat 3: stangalstyks (33410 in chips) 
Seat 4: ricardovinog (12794 in chips) 
Seat 5: TURoff (35633 in chips) 
Seat 6: G.R.N.24 (9300 in chips) 
Seat 7: Redron86 (9430 in chips) 
Seat 8: h@st@ baby (9888 in chips) 
Seat 9: Vascaino_017 (31438 in chips) 
Zekko1983: posts the ante 100
tr.amateuz: posts the ante 100
stangalstyks: posts the ante 100
ricardovinog: posts the ante 100
TURoff: posts the ante 100
G.R.N.24: posts the ante 100
Redron86: posts the ante 100
h@st@ baby: posts the ante 100
Vascaino_017: posts the ante 100
stangalstyks: posts small blind 400
ricardovinog: posts big blind 800
*** HOLE CARDS ***
Dealt to TURoff [Ah Qc]
TURoff: raises 960 to 1760
G.R.N.24: folds 
Redron86: folds 
h@st@ baby: folds 
Vascaino_017: folds 
Zekko1983: folds 
tr.amateuz: folds 
stangalstyks: folds 
ricardovinog: calls 960
*** FLOP *** [5c 5h 2s]
ricardovinog: checks 
TURoff: bets 1600
ricardovinog: folds 
Uncalled bet (1600) returned to TURoff
TURoff collected 4820 from pot
TURoff: doesn't show hand 
*** SUMMARY ***
Total pot 4820 | Rake 0 
Board [5c 5h 2s]
Seat 1: Zekko1983 folded before Flop (didn't bet)
Seat 2: tr.amateuz (button) folded before Flop (didn't bet)
Seat 3: stangalstyks (small blind) folded before Flop
Seat 4: ricardovinog (big blind) folded on the Flop
Seat 5: TURoff collected (4820)
Seat 6: G.R.N.24 folded before Flop (didn't bet)
Seat 7: Redron86 folded before Flop (didn't bet)
Seat 8: h@st@ baby folded before Flop (didn't bet)
Seat 9: Vascaino_017 folded before Flop (didn't bet)





PokerStars Hand #177199449635: Tournament #2067822782, $1.00+$0.10 USD Hold'em No Limit - Level XVI (400/800) - 2017/10/21 21:33:49 CUST [2017/10/21 13:33:49 ET]
Table '2067822782 27' 9-max Seat #3 is the button
Seat 1: Zekko1983 (46231 in chips) 
Seat 2: tr.amateuz (5341 in chips) 
Seat 3: stangalstyks (32910 in chips) 
Seat 4: ricardovinog (10934 in chips) 
Seat 5: TURoff (38593 in chips) 
Seat 6: G.R.N.24 (9200 in chips) 
Seat 7: Redron86 (9330 in chips) 
Seat 8: h@st@ baby (9788 in chips) 
Seat 9: Vascaino_017 (31338 in chips) 
Zekko1983: posts the ante 100
tr.amateuz: posts the ante 100
stangalstyks: posts the ante 100
ricardovinog: posts the ante 100
TURoff: posts the ante 100
G.R.N.24: posts the ante 100
Redron86: posts the ante 100
h@st@ baby: posts the ante 100
Vascaino_017: posts the ante 100
ricardovinog: posts small blind 400
TURoff: posts big blind 800
*** HOLE CARDS ***
Dealt to TURoff [8h 7c]
G.R.N.24: folds 
Redron86: folds 
h@st@ baby: folds 
Vascaino_017: folds 
Zekko1983: folds 
tr.amateuz: folds 
stangalstyks: folds 
ricardovinog: raises 10034 to 10834 and is all-in
TURoff: folds 
Uncalled bet (10034) returned to ricardovinog
ricardovinog collected 2500 from pot
ricardovinog: doesn't show hand 
*** SUMMARY ***
Total pot 2500 | Rake 0 
Seat 1: Zekko1983 folded before Flop (didn't bet)
Seat 2: tr.amateuz folded before Flop (didn't bet)
Seat 3: stangalstyks (button) folded before Flop (didn't bet)
Seat 4: ricardovinog (small blind) collected (2500)
Seat 5: TURoff (big blind) folded before Flop
Seat 6: G.R.N.24 folded before Flop (didn't bet)
Seat 7: Redron86 folded before Flop (didn't bet)
Seat 8: h@st@ baby folded before Flop (didn't bet)
Seat 9: Vascaino_017 folded before Flop (didn't bet)





PokerStars Hand #177199469928: Tournament #2067822782, $1.00+$0.10 USD Hold'em No Limit - Level XVI (400/800) - 2017/10/21 21:34:16 CUST [2017/10/21 13:34:16 ET]
Table '2067822782 27' 9-max Seat #4 is the button
Seat 1: Zekko1983 (46131 in chips) 
Seat 2: tr.amateuz (5241 in chips) 
Seat 3: stangalstyks (32810 in chips) 
Seat 4: ricardovinog (12534 in chips) 
Seat 5: TURoff (37693 in chips) 
Seat 6: G.R.N.24 (9100 in chips) 
Seat 7: Redron86 (9230 in chips) 
Seat 8: h@st@ baby (9688 in chips) 
Seat 9: Vascaino_017 (31238 in chips) 
Zekko1983: posts the ante 100
tr.amateuz: posts the ante 100
stangalstyks: posts the ante 100
ricardovinog: posts the ante 100
TURoff: posts the ante 100
G.R.N.24: posts the ante 100
Redron86: posts the ante 100
h@st@ baby: posts the ante 100
Vascaino_017: posts the ante 100
TURoff: posts small blind 400
G.R.N.24: posts big blind 800
*** HOLE CARDS ***
Dealt to TURoff [Jh 7c]
Redron86: folds 
h@st@ baby: folds 
Vascaino_017: folds 
Zekko1983: folds 
tr.amateuz: raises 4341 to 5141 and is all-in
stangalstyks: folds 
ricardovinog: raises 7293 to 12434 and is all-in
TURoff: folds 
G.R.N.24: folds 
Uncalled bet (7293) returned to ricardovinog
*** FLOP *** [Qc Js 7d]
*** TURN *** [Qc Js 7d] [4c]
*** RIVER *** [Qc Js 7d 4c] [3c]
*** SHOW DOWN ***
tr.amateuz: shows [8d 8c] (a pair of Eights)
ricardovinog: shows [Ac 9c] (a flush, Ace high)
ricardovinog collected 12382 from pot
tr.amateuz finished the tournament in 317th place and received $2.39.
*** SUMMARY ***
Total pot 12382 | Rake 0 
Board [Qc Js 7d 4c 3c]
Seat 1: Zekko1983 folded before Flop (didn't bet)
Seat 2: tr.amateuz showed [8d 8c] and lost with a pair of Eights
Seat 3: stangalstyks folded before Flop (didn't bet)
Seat 4: ricardovinog (button) showed [Ac 9c] and won (12382) with a flush, Ace high
Seat 5: TURoff (small blind) folded before Flop
Seat 6: G.R.N.24 (big blind) folded before Flop
Seat 7: Redron86 folded before Flop (didn't bet)
Seat 8: h@st@ baby folded before Flop (didn't bet)
Seat 9: Vascaino_017 folded before Flop (didn't bet)





PokerStars Hand #177199500026: Tournament #2067822782, $1.00+$0.10 USD Hold'em No Limit - Level XVI (400/800) - 2017/10/21 21:34:57 CUST [2017/10/21 13:34:57 ET]
Table '2067822782 27' 9-max Seat #5 is the button
Seat 1: Zekko1983 (46031 in chips) 
Seat 3: stangalstyks (32710 in chips) 
Seat 4: ricardovinog (19675 in chips) 
Seat 5: TURoff (37193 in chips) 
Seat 6: G.R.N.24 (8200 in chips) 
Seat 7: Redron86 (9130 in chips) 
Seat 8: h@st@ baby (9588 in chips) 
Seat 9: Vascaino_017 (31138 in chips) 
Zekko1983: posts the ante 100
stangalstyks: posts the ante 100
ricardovinog: posts the ante 100
TURoff: posts the ante 100
G.R.N.24: posts the ante 100
Redron86: posts the ante 100
h@st@ baby: posts the ante 100
Vascaino_017: posts the ante 100
G.R.N.24: posts small blind 400
Redron86: posts big blind 800
*** HOLE CARDS ***
Dealt to TURoff [3d Ad]
h@st@ baby: folds 
Vascaino_017: folds 
Zekko1983: folds 
stangalstyks: raises 880 to 1680
ricardovinog: folds 
TURoff: calls 1680
G.R.N.24: folds 
Redron86: folds 
*** FLOP *** [Qd 2d 9s]
stangalstyks: bets 1608
TURoff: calls 1608
*** TURN *** [Qd 2d 9s] [Kc]
stangalstyks: checks 
TURoff: checks 
*** RIVER *** [Qd 2d 9s Kc] [4s]
stangalstyks: checks 
TURoff: checks 
*** SHOW DOWN ***
stangalstyks: shows [5c 6c] (high card King)
TURoff: shows [3d Ad] (high card Ace)
TURoff collected 8576 from pot
*** SUMMARY ***
Total pot 8576 | Rake 0 
Board [Qd 2d 9s Kc 4s]
Seat 1: Zekko1983 folded before Flop (didn't bet)
Seat 3: stangalstyks showed [5c 6c] and lost with high card King
Seat 4: ricardovinog folded before Flop (didn't bet)
Seat 5: TURoff (button) showed [3d Ad] and won (8576) with high card Ace
Seat 6: G.R.N.24 (small blind) folded before Flop
Seat 7: Redron86 (big blind) folded before Flop
Seat 8: h@st@ baby folded before Flop (didn't bet)
Seat 9: Vascaino_017 folded before Flop (didn't bet)





PokerStars Hand #177199549341: Tournament #2067822782, $1.00+$0.10 USD Hold'em No Limit - Level XVI (400/800) - 2017/10/21 21:36:04 CUST [2017/10/21 13:36:04 ET]
Table '2067822782 27' 9-max Seat #6 is the button
Seat 1: Zekko1983 (45931 in chips) 
Seat 2: APurchart (40272 in chips) 
Seat 3: stangalstyks (29322 in chips) 
Seat 4: ricardovinog (19575 in chips) 
Seat 5: TURoff (42381 in chips) 
Seat 6: G.R.N.24 (7700 in chips) 
Seat 7: Redron86 (8230 in chips) 
Seat 8: h@st@ baby (9488 in chips) 
Seat 9: Vascaino_017 (31038 in chips) 
Zekko1983: posts the ante 100
APurchart: posts the ante 100
stangalstyks: posts the ante 100
ricardovinog: posts the ante 100
TURoff: posts the ante 100
G.R.N.24: posts the ante 100
Redron86: posts the ante 100
h@st@ baby: posts the ante 100
Vascaino_017: posts the ante 100
Redron86: posts small blind 400
h@st@ baby: posts big blind 800
*** HOLE CARDS ***
Dealt to TURoff [8c Ah]
Vascaino_017: folds 
Zekko1983: folds 
APurchart: folds 
stangalstyks: folds 
ricardovinog: folds 
TURoff: raises 960 to 1760
G.R.N.24: folds 
Redron86: folds 
h@st@ baby: folds 
Uncalled bet (960) returned to TURoff
TURoff collected 2900 from pot
TURoff: doesn't show hand 
*** SUMMARY ***
Total pot 2900 | Rake 0 
Seat 1: Zekko1983 folded before Flop (didn't bet)
Seat 2: APurchart folded before Flop (didn't bet)
Seat 3: stangalstyks folded before Flop (didn't bet)
Seat 4: ricardovinog folded before Flop (didn't bet)
Seat 5: TURoff collected (2900)
Seat 6: G.R.N.24 (button) folded before Flop (didn't bet)
Seat 7: Redron86 (small blind) folded before Flop
Seat 8: h@st@ baby (big blind) folded before Flop
Seat 9: Vascaino_017 folded before Flop (didn't bet)





PokerStars Hand #177199572389: Tournament #2067822782, $1.00+$0.10 USD Hold'em No Limit - Level XVI (400/800) - 2017/10/21 21:36:35 CUST [2017/10/21 13:36:35 ET]
Table '2067822782 27' 9-max Seat #7 is the button
Seat 1: Zekko1983 (45831 in chips) 
Seat 2: APurchart (40172 in chips) 
Seat 3: stangalstyks (29222 in chips) 
Seat 4: ricardovinog (19475 in chips) 
Seat 5: TURoff (44381 in chips) 
Seat 6: G.R.N.24 (7600 in chips) 
Seat 7: Redron86 (7730 in chips) 
Seat 8: h@st@ baby (8588 in chips) 
Seat 9: Vascaino_017 (30938 in chips) 
Zekko1983: posts the ante 100
APurchart: posts the ante 100
stangalstyks: posts the ante 100
ricardovinog: posts the ante 100
TURoff: posts the ante 100
G.R.N.24: posts the ante 100
Redron86: posts the ante 100
h@st@ baby: posts the ante 100
Vascaino_017: posts the ante 100
h@st@ baby: posts small blind 400
Vascaino_017: posts big blind 800
*** HOLE CARDS ***
Dealt to TURoff [6h Kh]
Zekko1983: calls 800
APurchart: folds 
stangalstyks: folds 
ricardovinog: folds 
TURoff: folds 
G.R.N.24: folds 
Redron86: folds 
h@st@ baby: calls 400
Vascaino_017: checks 
*** FLOP *** [3s 6c Ad]
h@st@ baby: checks 
Vascaino_017: checks 
Zekko1983: bets 800
h@st@ baby: folds 
Vascaino_017: folds 
Uncalled bet (800) returned to Zekko1983
Zekko1983 collected 3300 from pot
*** SUMMARY ***
Total pot 3300 | Rake 0 
Board [3s 6c Ad]
Seat 1: Zekko1983 collected (3300)
Seat 2: APurchart folded before Flop (didn't bet)
Seat 3: stangalstyks folded before Flop (didn't bet)
Seat 4: ricardovinog folded before Flop (didn't bet)
Seat 5: TURoff folded before Flop (didn't bet)
Seat 6: G.R.N.24 folded before Flop (didn't bet)
Seat 7: Redron86 (button) folded before Flop (didn't bet)
Seat 8: h@st@ baby (small blind) folded on the Flop
Seat 9: Vascaino_017 (big blind) folded on the Flop





PokerStars Hand #177199613513: Tournament #2067822782, $1.00+$0.10 USD Hold'em No Limit - Level XVI (400/800) - 2017/10/21 21:37:31 CUST [2017/10/21 13:37:31 ET]
Table '2067822782 27' 9-max Seat #8 is the button
Seat 1: Zekko1983 (48231 in chips) 
Seat 2: APurchart (40072 in chips) 
Seat 3: stangalstyks (29122 in chips) 
Seat 4: ricardovinog (19375 in chips) 
Seat 5: TURoff (44281 in chips) 
Seat 6: G.R.N.24 (7500 in chips) 
Seat 7: Redron86 (7630 in chips) 
Seat 8: h@st@ baby (7688 in chips) 
Seat 9: Vascaino_017 (30038 in chips) 
Zekko1983: posts the ante 100
APurchart: posts the ante 100
stangalstyks: posts the ante 100
ricardovinog: posts the ante 100
TURoff: posts the ante 100
G.R.N.24: posts the ante 100
Redron86: posts the ante 100
h@st@ baby: posts the ante 100
Vascaino_017: posts the ante 100
Vascaino_017: posts small blind 400
Zekko1983: posts big blind 800
*** HOLE CARDS ***
Dealt to TURoff [8d 8h]
APurchart: folds 
stangalstyks: raises 880 to 1680
ricardovinog: folds 
TURoff: calls 1680
G.R.N.24: folds 
Redron86: folds 
h@st@ baby: folds 
Vascaino_017: folds 
Zekko1983: calls 880
*** FLOP *** [8c 4h Ks]
Zekko1983: checks 
stangalstyks: checks 
TURoff: bets 1600
Zekko1983: folds 
stangalstyks: calls 1600
*** TURN *** [8c 4h Ks] [Ac]
stangalstyks: checks 
TURoff: bets 3200
stangalstyks: raises 4782 to 7982
TURoff: raises 32919 to 40901 and is all-in
stangalstyks: calls 17760 and is all-in
Uncalled bet (15159) returned to TURoff
*** RIVER *** [8c 4h Ks Ac] [7h]
*** SHOW DOWN ***
stangalstyks: shows [As 4s] (two pair, Aces and Fours)
TURoff: shows [8d 8h] (three of a kind, Eights)
TURoff collected 61024 from pot
stangalstyks finished the tournament in 293rd place and received $2.39.
*** SUMMARY ***
Total pot 61024 | Rake 0 
Board [8c 4h Ks Ac 7h]
Seat 1: Zekko1983 (big blind) folded on the Flop
Seat 2: APurchart folded before Flop (didn't bet)
Seat 3: stangalstyks showed [As 4s] and lost with two pair, Aces and Fours
Seat 4: ricardovinog folded before Flop (didn't bet)
Seat 5: TURoff showed [8d 8h] and won (61024) with three of a kind, Eights
Seat 6: G.R.N.24 folded before Flop (didn't bet)
Seat 7: Redron86 folded before Flop (didn't bet)
Seat 8: h@st@ baby (button) folded before Flop (didn't bet)
Seat 9: Vascaino_017 (small blind) folded before Flop





PokerStars Hand #177199682723: Tournament #2067822782, $1.00+$0.10 USD Hold'em No Limit - Level XVI (400/800) - 2017/10/21 21:39:06 CUST [2017/10/21 13:39:06 ET]
Table '2067822782 27' 9-max Seat #9 is the button
Seat 1: Zekko1983 (46451 in chips) 
Seat 2: APurchart (39972 in chips) 
Seat 4: ricardovinog (19275 in chips) 
Seat 5: TURoff (76183 in chips) 
Seat 6: G.R.N.24 (7400 in chips) 
Seat 7: Redron86 (7530 in chips) 
Seat 8: h@st@ baby (7588 in chips) 
Seat 9: Vascaino_017 (29538 in chips) 
Zekko1983: posts the ante 100
APurchart: posts the ante 100
ricardovinog: posts the ante 100
TURoff: posts the ante 100
G.R.N.24: posts the ante 100
Redron86: posts the ante 100
h@st@ baby: posts the ante 100
Vascaino_017: posts the ante 100
Zekko1983: posts small blind 400
APurchart: posts big blind 800
*** HOLE CARDS ***
Dealt to TURoff [9c 5d]
ricardovinog: folds 
TURoff: folds 
G.R.N.24: folds 
Redron86: folds 
h@st@ baby: folds 
Vascaino_017: folds 
Zekko1983: calls 400
APurchart: checks 
*** FLOP *** [4s 7s Qc]
Zekko1983: checks 
APurchart: checks 
*** TURN *** [4s 7s Qc] [7c]
Zekko1983: checks 
APurchart: bets 1704
Zekko1983: folds 
Uncalled bet (1704) returned to APurchart
APurchart collected 2400 from pot
APurchart: doesn't show hand 
*** SUMMARY ***
Total pot 2400 | Rake 0 
Board [4s 7s Qc 7c]
Seat 1: Zekko1983 (small blind) folded on the Turn
Seat 2: APurchart (big blind) collected (2400)
Seat 4: ricardovinog folded before Flop (didn't bet)
Seat 5: TURoff folded before Flop (didn't bet)
Seat 6: G.R.N.24 folded before Flop (didn't bet)
Seat 7: Redron86 folded before Flop (didn't bet)
Seat 8: h@st@ baby folded before Flop (didn't bet)
Seat 9: Vascaino_017 (button) folded before Flop (didn't bet)





PokerStars Hand #177199704668: Tournament #2067822782, $1.00+$0.10 USD Hold'em No Limit - Level XVI (400/800) - 2017/10/21 21:39:37 CUST [2017/10/21 13:39:37 ET]
Table '2067822782 27' 9-max Seat #1 is the button
Seat 1: Zekko1983 (45551 in chips) 
Seat 2: APurchart (41472 in chips) 
Seat 4: ricardovinog (19175 in chips) 
Seat 5: TURoff (76083 in chips) 
Seat 6: G.R.N.24 (7300 in chips) 
Seat 7: Redron86 (7430 in chips) 
Seat 8: h@st@ baby (7488 in chips) 
Seat 9: Vascaino_017 (29438 in chips) 
Zekko1983: posts the ante 100
APurchart: posts the ante 100
ricardovinog: posts the ante 100
TURoff: posts the ante 100
G.R.N.24: posts the ante 100
Redron86: posts the ante 100
h@st@ baby: posts the ante 100
Vascaino_017: posts the ante 100
APurchart: posts small blind 400
ricardovinog: posts big blind 800
*** HOLE CARDS ***
Dealt to TURoff [2d 3c]
TURoff: folds 
G.R.N.24: raises 6400 to 7200 and is all-in
Redron86: folds 
h@st@ baby: folds 
Vascaino_017: folds 
Zekko1983: folds 
APurchart: folds 
ricardovinog: folds 
Uncalled bet (6400) returned to G.R.N.24
G.R.N.24 collected 2800 from pot
G.R.N.24: doesn't show hand 
*** SUMMARY ***
Total pot 2800 | Rake 0 
Seat 1: Zekko1983 (button) folded before Flop (didn't bet)
Seat 2: APurchart (small blind) folded before Flop
Seat 4: ricardovinog (big blind) folded before Flop
Seat 5: TURoff folded before Flop (didn't bet)
Seat 6: G.R.N.24 collected (2800)
Seat 7: Redron86 folded before Flop (didn't bet)
Seat 8: h@st@ baby folded before Flop (didn't bet)
Seat 9: Vascaino_017 folded before Flop (didn't bet)





PokerStars Hand #177199723355: Tournament #2067822782, $1.00+$0.10 USD Hold'em No Limit - Level XVI (400/800) - 2017/10/21 21:40:02 CUST [2017/10/21 13:40:02 ET]
Table '2067822782 27' 9-max Seat #2 is the button
Seat 1: Zekko1983 (45451 in chips) 
Seat 2: APurchart (40972 in chips) 
Seat 3: PawelSlepzov (28840 in chips) out of hand (moved from another table into small blind)
Seat 4: ricardovinog (18275 in chips) 
Seat 5: TURoff (75983 in chips) 
Seat 6: G.R.N.24 (9200 in chips) 
Seat 7: Redron86 (7330 in chips) 
Seat 8: h@st@ baby (7388 in chips) 
Seat 9: Vascaino_017 (29338 in chips) 
Zekko1983: posts the ante 100
APurchart: posts the ante 100
ricardovinog: posts the ante 100
TURoff: posts the ante 100
G.R.N.24: posts the ante 100
Redron86: posts the ante 100
h@st@ baby: posts the ante 100
Vascaino_017: posts the ante 100
ricardovinog: posts small blind 400
TURoff: posts big blind 800
*** HOLE CARDS ***
Dealt to TURoff [7d 2c]
G.R.N.24: folds 
Redron86: folds 
h@st@ baby: folds 
Vascaino_017: folds 
Zekko1983: calls 800
APurchart: folds 
ricardovinog: calls 400
TURoff: checks 
*** FLOP *** [Qc 9d 4d]
ricardovinog: checks 
TURoff: checks 
Zekko1983: checks 
*** TURN *** [Qc 9d 4d] [6h]
ricardovinog: checks 
TURoff: checks 
Zekko1983: checks 
*** RIVER *** [Qc 9d 4d 6h] [2h]
ricardovinog: checks 
TURoff: checks 
Zekko1983: bets 800
ricardovinog: folds 
TURoff: folds 
Uncalled bet (800) returned to Zekko1983
Zekko1983 collected 3200 from pot
*** SUMMARY ***
Total pot 3200 | Rake 0 
Board [Qc 9d 4d 6h 2h]
Seat 1: Zekko1983 collected (3200)
Seat 2: APurchart (button) folded before Flop (didn't bet)
Seat 4: ricardovinog (small blind) folded on the River
Seat 5: TURoff (big blind) folded on the River
Seat 6: G.R.N.24 folded before Flop (didn't bet)
Seat 7: Redron86 folded before Flop (didn't bet)
Seat 8: h@st@ baby folded before Flop (didn't bet)
Seat 9: Vascaino_017 folded before Flop (didn't bet)





PokerStars Hand #177199757884: Tournament #2067822782, $1.00+$0.10 USD Hold'em No Limit - Level XVI (400/800) - 2017/10/21 21:40:50 CUST [2017/10/21 13:40:50 ET]
Table '2067822782 27' 9-max Seat #4 is the button
Seat 1: Zekko1983 (47751 in chips) 
Seat 2: APurchart (40872 in chips) 
Seat 3: PawelSlepzov (28840 in chips) 
Seat 4: ricardovinog (17375 in chips) 
Seat 5: TURoff (75083 in chips) 
Seat 6: G.R.N.24 (9100 in chips) 
Seat 7: Redron86 (7230 in chips) 
Seat 8: h@st@ baby (7288 in chips) 
Seat 9: Vascaino_017 (29238 in chips) 
Zekko1983: posts the ante 100
APurchart: posts the ante 100
PawelSlepzov: posts the ante 100
ricardovinog: posts the ante 100
TURoff: posts the ante 100
G.R.N.24: posts the ante 100
Redron86: posts the ante 100
h@st@ baby: posts the ante 100
Vascaino_017: posts the ante 100
TURoff: posts small blind 400
G.R.N.24: posts big blind 800
*** HOLE CARDS ***
Dealt to TURoff [Ks 4d]
Redron86: folds 
h@st@ baby: folds 
Vascaino_017: folds 
Zekko1983: folds 
APurchart: folds 
PawelSlepzov: folds 
ricardovinog: folds 
TURoff: raises 74183 to 74983 and is all-in
G.R.N.24: calls 8200 and is all-in
Uncalled bet (65983) returned to TURoff
*** FLOP *** [8s 7h Ac]
*** TURN *** [8s 7h Ac] [8d]
*** RIVER *** [8s 7h Ac 8d] [Jh]
*** SHOW DOWN ***
TURoff: shows [Ks 4d] (a pair of Eights)
G.R.N.24: shows [5h As] (two pair, Aces and Eights)
G.R.N.24 collected 18900 from pot
*** SUMMARY ***
Total pot 18900 | Rake 0 
Board [8s 7h Ac 8d Jh]
Seat 1: Zekko1983 folded before Flop (didn't bet)
Seat 2: APurchart folded before Flop (didn't bet)
Seat 3: PawelSlepzov folded before Flop (didn't bet)
Seat 4: ricardovinog (button) folded before Flop (didn't bet)
Seat 5: TURoff (small blind) showed [Ks 4d] and lost with a pair of Eights
Seat 6: G.R.N.24 (big blind) showed [5h As] and won (18900) with two pair, Aces and Eights
Seat 7: Redron86 folded before Flop (didn't bet)
Seat 8: h@st@ baby folded before Flop (didn't bet)
Seat 9: Vascaino_017 folded before Flop (didn't bet)





PokerStars Hand #177199791162: Tournament #2067822782, $1.00+$0.10 USD Hold'em No Limit - Level XVII (500/1000) - 2017/10/21 21:41:35 CUST [2017/10/21 13:41:35 ET]
Table '2067822782 27' 9-max Seat #5 is the button
Seat 1: Zekko1983 (47651 in chips) 
Seat 2: APurchart (40772 in chips) 
Seat 3: PawelSlepzov (28740 in chips) 
Seat 4: ricardovinog (17275 in chips) 
Seat 5: TURoff (65983 in chips) 
Seat 6: G.R.N.24 (18900 in chips) 
Seat 7: Redron86 (7130 in chips) 
Seat 8: h@st@ baby (7188 in chips) 
Seat 9: Vascaino_017 (29138 in chips) 
Zekko1983: posts the ante 125
APurchart: posts the ante 125
PawelSlepzov: posts the ante 125
ricardovinog: posts the ante 125
TURoff: posts the ante 125
G.R.N.24: posts the ante 125
Redron86: posts the ante 125
h@st@ baby: posts the ante 125
Vascaino_017: posts the ante 125
G.R.N.24: posts small blind 500
Redron86: posts big blind 1000
*** HOLE CARDS ***
Dealt to TURoff [7s 3d]
h@st@ baby: folds 
Vascaino_017: folds 
Zekko1983: folds 
APurchart: folds 
PawelSlepzov: folds 
ricardovinog: raises 1000 to 2000
TURoff: folds 
G.R.N.24: folds 
Redron86: calls 1000
*** FLOP *** [5s Kd 9h]
Redron86: checks 
ricardovinog: bets 2000
Redron86: calls 2000
*** TURN *** [5s Kd 9h] [Qc]
Redron86: checks 
ricardovinog: bets 3369
Redron86: calls 3005 and is all-in
Uncalled bet (364) returned to ricardovinog
*** RIVER *** [5s Kd 9h Qc] [8s]
*** SHOW DOWN ***
Redron86: shows [Kh Qd] (two pair, Kings and Queens)
ricardovinog: shows [Ts As] (high card Ace)
Redron86 collected 15635 from pot
*** SUMMARY ***
Total pot 15635 | Rake 0 
Board [5s Kd 9h Qc 8s]
Seat 1: Zekko1983 folded before Flop (didn't bet)
Seat 2: APurchart folded before Flop (didn't bet)
Seat 3: PawelSlepzov folded before Flop (didn't bet)
Seat 4: ricardovinog showed [Ts As] and lost with high card Ace
Seat 5: TURoff (button) folded before Flop (didn't bet)
Seat 6: G.R.N.24 (small blind) folded before Flop
Seat 7: Redron86 (big blind) showed [Kh Qd] and won (15635) with two pair, Kings and Queens
Seat 8: h@st@ baby folded before Flop (didn't bet)
Seat 9: Vascaino_017 folded before Flop (didn't bet)





PokerStars Hand #177199855716: Tournament #2067822782, $1.00+$0.10 USD Hold'em No Limit - Level XVII (500/1000) - 2017/10/21 21:43:04 CUST [2017/10/21 13:43:04 ET]
Table '2067822782 27' 9-max Seat #6 is the button
Seat 1: Zekko1983 (47526 in chips) 
Seat 2: APurchart (40647 in chips) 
Seat 3: PawelSlepzov (28615 in chips) 
Seat 4: ricardovinog (10145 in chips) 
Seat 5: TURoff (65858 in chips) 
Seat 6: G.R.N.24 (18275 in chips) 
Seat 7: Redron86 (15635 in chips) 
Seat 8: h@st@ baby (7063 in chips) 
Seat 9: Vascaino_017 (29013 in chips) 
Zekko1983: posts the ante 125
APurchart: posts the ante 125
PawelSlepzov: posts the ante 125
ricardovinog: posts the ante 125
TURoff: posts the ante 125
G.R.N.24: posts the ante 125
Redron86: posts the ante 125
h@st@ baby: posts the ante 125
Vascaino_017: posts the ante 125
Redron86: posts small blind 500
h@st@ baby: posts big blind 1000
*** HOLE CARDS ***
Dealt to TURoff [Jd 8s]
Vascaino_017: folds 
Zekko1983: folds 
APurchart: raises 1080 to 2080
PawelSlepzov: folds 
ricardovinog: raises 7940 to 10020 and is all-in
TURoff: folds 
G.R.N.24: folds 
Redron86: folds 
h@st@ baby: folds 
APurchart: calls 7940
*** FLOP *** [7s Js Qd]
*** TURN *** [7s Js Qd] [Kd]
*** RIVER *** [7s Js Qd Kd] [Jc]
*** SHOW DOWN ***
APurchart: shows [Qh As] (two pair, Queens and Jacks)
ricardovinog: shows [8d 8h] (two pair, Jacks and Eights)
APurchart collected 22665 from pot
ricardovinog finished the tournament in 276th place and received $2.39.
*** SUMMARY ***
Total pot 22665 | Rake 0 
Board [7s Js Qd Kd Jc]
Seat 1: Zekko1983 folded before Flop (didn't bet)
Seat 2: APurchart showed [Qh As] and won (22665) with two pair, Queens and Jacks
Seat 3: PawelSlepzov folded before Flop (didn't bet)
Seat 4: ricardovinog showed [8d 8h] and lost with two pair, Jacks and Eights
Seat 5: TURoff folded before Flop (didn't bet)
Seat 6: G.R.N.24 (button) folded before Flop (didn't bet)
Seat 7: Redron86 (small blind) folded before Flop
Seat 8: h@st@ baby (big blind) folded before Flop
Seat 9: Vascaino_017 folded before Flop (didn't bet)





PokerStars Hand #177199891778: Tournament #2067822782, $1.00+$0.10 USD Hold'em No Limit - Level XVII (500/1000) - 2017/10/21 21:43:53 CUST [2017/10/21 13:43:53 ET]
Table '2067822782 27' 9-max Seat #7 is the button
Seat 1: Zekko1983 (47401 in chips) 
Seat 2: APurchart (53167 in chips) 
Seat 3: PawelSlepzov (28490 in chips) 
Seat 5: TURoff (65733 in chips) 
Seat 6: G.R.N.24 (18150 in chips) 
Seat 7: Redron86 (15010 in chips) 
Seat 8: h@st@ baby (5938 in chips) 
Seat 9: Vascaino_017 (28888 in chips) 
Zekko1983: posts the ante 125
APurchart: posts the ante 125
PawelSlepzov: posts the ante 125
TURoff: posts the ante 125
G.R.N.24: posts the ante 125
Redron86: posts the ante 125
h@st@ baby: posts the ante 125
Vascaino_017: posts the ante 125
h@st@ baby: posts small blind 500
Vascaino_017: posts big blind 1000
*** HOLE CARDS ***
Dealt to TURoff [4h 2s]
Zekko1983: calls 1000
APurchart: folds 
PawelSlepzov: folds 
TURoff: folds 
G.R.N.24: folds 
Redron86: folds 
h@st@ baby: folds 
Vascaino_017: checks 
*** FLOP *** [7c 6h As]
Vascaino_017: checks 
Zekko1983: checks 
*** TURN *** [7c 6h As] [Ad]
Vascaino_017: checks 
Zekko1983: checks 
*** RIVER *** [7c 6h As Ad] [Td]
Vascaino_017: checks 
Zekko1983: checks 
*** SHOW DOWN ***
Vascaino_017: shows [8c 3d] (a pair of Aces)
Zekko1983: shows [5d Ks] (a pair of Aces - King kicker)
Zekko1983 collected 3500 from pot
*** SUMMARY ***
Total pot 3500 | Rake 0 
Board [7c 6h As Ad Td]
Seat 1: Zekko1983 showed [5d Ks] and won (3500) with a pair of Aces
Seat 2: APurchart folded before Flop (didn't bet)
Seat 3: PawelSlepzov folded before Flop (didn't bet)
Seat 5: TURoff folded before Flop (didn't bet)
Seat 6: G.R.N.24 folded before Flop (didn't bet)
Seat 7: Redron86 (button) folded before Flop (didn't bet)
Seat 8: h@st@ baby (small blind) folded before Flop
Seat 9: Vascaino_017 (big blind) showed [8c 3d] and lost with a pair of Aces





PokerStars Hand #177199941136: Tournament #2067822782, $1.00+$0.10 USD Hold'em No Limit - Level XVII (500/1000) - 2017/10/21 21:45:00 CUST [2017/10/21 13:45:00 ET]
Table '2067822782 27' 9-max Seat #8 is the button
Seat 1: Zekko1983 (49776 in chips) 
Seat 2: APurchart (53042 in chips) 
Seat 3: PawelSlepzov (28365 in chips) 
Seat 4: MasterFrom17 (45377 in chips) 
Seat 5: TURoff (65608 in chips) 
Seat 6: G.R.N.24 (18025 in chips) 
Seat 7: Redron86 (14885 in chips) 
Seat 8: h@st@ baby (5313 in chips) 
Seat 9: Vascaino_017 (27763 in chips) 
Zekko1983: posts the ante 125
APurchart: posts the ante 125
PawelSlepzov: posts the ante 125
MasterFrom17: posts the ante 125
TURoff: posts the ante 125
G.R.N.24: posts the ante 125
Redron86: posts the ante 125
h@st@ baby: posts the ante 125
Vascaino_017: posts the ante 125
Vascaino_017: posts small blind 500
Zekko1983: posts big blind 1000
*** HOLE CARDS ***
Dealt to TURoff [Ad Ac]
APurchart: folds 
PawelSlepzov: raises 1200 to 2200
MasterFrom17: folds 
TURoff: raises 4800 to 7000
G.R.N.24: folds 
Redron86: folds 
h@st@ baby: folds 
Vascaino_017: folds 
Zekko1983: folds 
PawelSlepzov: calls 4800
*** FLOP *** [5d 4s 6s]
PawelSlepzov: checks 
TURoff: bets 8313
PawelSlepzov: folds 
Uncalled bet (8313) returned to TURoff
TURoff collected 16625 from pot
TURoff: doesn't show hand 
*** SUMMARY ***
Total pot 16625 | Rake 0 
Board [5d 4s 6s]
Seat 1: Zekko1983 (big blind) folded before Flop
Seat 2: APurchart folded before Flop (didn't bet)
Seat 3: PawelSlepzov folded on the Flop
Seat 4: MasterFrom17 folded before Flop (didn't bet)
Seat 5: TURoff collected (16625)
Seat 6: G.R.N.24 folded before Flop (didn't bet)
Seat 7: Redron86 folded before Flop (didn't bet)
Seat 8: h@st@ baby (button) folded before Flop (didn't bet)
Seat 9: Vascaino_017 (small blind) folded before Flop





PokerStars Hand #177200025243: Tournament #2067822782, $1.00+$0.10 USD Hold'em No Limit - Level XVII (500/1000) - 2017/10/21 21:46:56 CUST [2017/10/21 13:46:56 ET]
Table '2067822782 27' 9-max Seat #9 is the button
Seat 1: Zekko1983 (48651 in chips) 
Seat 2: APurchart (52917 in chips) 
Seat 3: PawelSlepzov (21240 in chips) 
Seat 4: MasterFrom17 (45252 in chips) 
Seat 5: TURoff (75108 in chips) 
Seat 6: G.R.N.24 (17900 in chips) 
Seat 7: Redron86 (14760 in chips) 
Seat 8: h@st@ baby (5188 in chips) 
Seat 9: Vascaino_017 (27138 in chips) 
Zekko1983: posts the ante 125
APurchart: posts the ante 125
PawelSlepzov: posts the ante 125
MasterFrom17: posts the ante 125
TURoff: posts the ante 125
G.R.N.24: posts the ante 125
Redron86: posts the ante 125
h@st@ baby: posts the ante 125
Vascaino_017: posts the ante 125
Zekko1983: posts small blind 500
APurchart: posts big blind 1000
*** HOLE CARDS ***
Dealt to TURoff [2c Td]
PawelSlepzov: folds 
MasterFrom17: folds 
TURoff: folds 
G.R.N.24: folds 
Redron86: folds 
h@st@ baby: folds 
Vascaino_017: folds 
Zekko1983: calls 500
APurchart: checks 
*** FLOP *** [Js 8s 5c]
Zekko1983: checks 
APurchart: checks 
*** TURN *** [Js 8s 5c] [5d]
Zekko1983: checks 
APurchart: checks 
*** RIVER *** [Js 8s 5c 5d] [5h]
Zekko1983: checks 
APurchart: bets 1469
Zekko1983: calls 1469
*** SHOW DOWN ***
APurchart: shows [4s 4d] (a full house, Fives full of Fours)
Zekko1983: mucks hand 
APurchart collected 6063 from pot
*** SUMMARY ***
Total pot 6063 | Rake 0 
Board [Js 8s 5c 5d 5h]
Seat 1: Zekko1983 (small blind) mucked [2h Qd]
Seat 2: APurchart (big blind) showed [4s 4d] and won (6063) with a full house, Fives full of Fours
Seat 3: PawelSlepzov folded before Flop (didn't bet)
Seat 4: MasterFrom17 folded before Flop (didn't bet)
Seat 5: TURoff folded before Flop (didn't bet)
Seat 6: G.R.N.24 folded before Flop (didn't bet)
Seat 7: Redron86 folded before Flop (didn't bet)
Seat 8: h@st@ baby folded before Flop (didn't bet)
Seat 9: Vascaino_017 (button) folded before Flop (didn't bet)





PokerStars Hand #177200071944: Tournament #2067822782, $1.00+$0.10 USD Hold'em No Limit - Level XVII (500/1000) - 2017/10/21 21:48:00 CUST [2017/10/21 13:48:00 ET]
Table '2067822782 27' 9-max Seat #1 is the button
Seat 1: Zekko1983 (46057 in chips) 
Seat 2: APurchart (56386 in chips) 
Seat 3: PawelSlepzov (21115 in chips) 
Seat 4: MasterFrom17 (45127 in chips) 
Seat 5: TURoff (74983 in chips) 
Seat 6: G.R.N.24 (17775 in chips) 
Seat 7: Redron86 (14635 in chips) 
Seat 8: h@st@ baby (5063 in chips) 
Seat 9: Vascaino_017 (27013 in chips) 
Zekko1983: posts the ante 125
APurchart: posts the ante 125
PawelSlepzov: posts the ante 125
MasterFrom17: posts the ante 125
TURoff: posts the ante 125
G.R.N.24: posts the ante 125
Redron86: posts the ante 125
h@st@ baby: posts the ante 125
Vascaino_017: posts the ante 125
APurchart: posts small blind 500
PawelSlepzov: posts big blind 1000
*** HOLE CARDS ***
Dealt to TURoff [2c 8c]
MasterFrom17: folds 
TURoff: folds 
G.R.N.24: raises 1230 to 2230
Redron86: folds 
h@st@ baby: folds 
Vascaino_017: folds 
Zekko1983: calls 2230
APurchart: folds 
PawelSlepzov: folds 
*** FLOP *** [6s Ts Jd]
G.R.N.24: checks 
Zekko1983: bets 7085
G.R.N.24: raises 8335 to 15420 and is all-in
Zekko1983: calls 8335
*** TURN *** [6s Ts Jd] [Js]
*** RIVER *** [6s Ts Jd Js] [6d]
*** SHOW DOWN ***
G.R.N.24: shows [Kc Qc] (two pair, Jacks and Sixes)
Zekko1983: shows [Jh Qd] (a full house, Jacks full of Sixes)
Zekko1983 collected 37925 from pot
G.R.N.24 finished the tournament in 238th place and received $2.76.
*** SUMMARY ***
Total pot 37925 | Rake 0 
Board [6s Ts Jd Js 6d]
Seat 1: Zekko1983 (button) showed [Jh Qd] and won (37925) with a full house, Jacks full of Sixes
Seat 2: APurchart (small blind) folded before Flop
Seat 3: PawelSlepzov (big blind) folded before Flop
Seat 4: MasterFrom17 folded before Flop (didn't bet)
Seat 5: TURoff folded before Flop (didn't bet)
Seat 6: G.R.N.24 showed [Kc Qc] and lost with two pair, Jacks and Sixes
Seat 7: Redron86 folded before Flop (didn't bet)
Seat 8: h@st@ baby folded before Flop (didn't bet)
Seat 9: Vascaino_017 folded before Flop (didn't bet)





PokerStars Hand #177200108294: Tournament #2067822782, $1.00+$0.10 USD Hold'em No Limit - Level XVII (500/1000) - 2017/10/21 21:48:50 CUST [2017/10/21 13:48:50 ET]
Table '2067822782 27' 9-max Seat #2 is the button
Seat 1: Zekko1983 (66207 in chips) 
Seat 2: APurchart (55761 in chips) 
Seat 3: PawelSlepzov (19990 in chips) 
Seat 4: MasterFrom17 (45002 in chips) 
Seat 5: TURoff (74858 in chips) 
Seat 7: Redron86 (14510 in chips) 
Seat 8: h@st@ baby (4938 in chips) 
Seat 9: Vascaino_017 (26888 in chips) 
Zekko1983: posts the ante 125
APurchart: posts the ante 125
PawelSlepzov: posts the ante 125
MasterFrom17: posts the ante 125
TURoff: posts the ante 125
Redron86: posts the ante 125
h@st@ baby: posts the ante 125
Vascaino_017: posts the ante 125
PawelSlepzov: posts small blind 500
MasterFrom17: posts big blind 1000
*** HOLE CARDS ***
Dealt to TURoff [6s 4c]
TURoff: folds 
Redron86: folds 
h@st@ baby: raises 3813 to 4813 and is all-in
Vascaino_017: folds 
Zekko1983: calls 4813
APurchart: folds 
PawelSlepzov: folds 
MasterFrom17: folds 
*** FLOP *** [Jd Ad 7h]
*** TURN *** [Jd Ad 7h] [Jc]
*** RIVER *** [Jd Ad 7h Jc] [8d]
*** SHOW DOWN ***
h@st@ baby: shows [Qc Kh] (a pair of Jacks)
Zekko1983: shows [Ah 5s] (two pair, Aces and Jacks)
Zekko1983 collected 12126 from pot
h@st@ baby finished the tournament in 237th place and received $2.76.
*** SUMMARY ***
Total pot 12126 | Rake 0 
Board [Jd Ad 7h Jc 8d]
Seat 1: Zekko1983 showed [Ah 5s] and won (12126) with two pair, Aces and Jacks
Seat 2: APurchart (button) folded before Flop (didn't bet)
Seat 3: PawelSlepzov (small blind) folded before Flop
Seat 4: MasterFrom17 (big blind) folded before Flop
Seat 5: TURoff folded before Flop (didn't bet)
Seat 7: Redron86 folded before Flop (didn't bet)
Seat 8: h@st@ baby showed [Qc Kh] and lost with a pair of Jacks
Seat 9: Vascaino_017 folded before Flop (didn't bet)





PokerStars Hand #177200124856: Tournament #2067822782, $1.00+$0.10 USD Hold'em No Limit - Level XVII (500/1000) - 2017/10/21 21:49:13 CUST [2017/10/21 13:49:13 ET]
Table '2067822782 27' 9-max Seat #3 is the button
Seat 1: Zekko1983 (73395 in chips) 
Seat 2: APurchart (55636 in chips) 
Seat 3: PawelSlepzov (19365 in chips) 
Seat 4: MasterFrom17 (43877 in chips) 
Seat 5: TURoff (74733 in chips) 
Seat 7: Redron86 (14385 in chips) 
Seat 9: Vascaino_017 (26763 in chips) 
Zekko1983: posts the ante 125
APurchart: posts the ante 125
PawelSlepzov: posts the ante 125
MasterFrom17: posts the ante 125
TURoff: posts the ante 125
Redron86: posts the ante 125
Vascaino_017: posts the ante 125
MasterFrom17: posts small blind 500
TURoff: posts big blind 1000
*** HOLE CARDS ***
Dealt to TURoff [As Kd]
Redron86: folds 
Vascaino_017: folds 
Zekko1983: calls 1000
APurchart: folds 
PawelSlepzov: folds 
MasterFrom17: calls 500
TURoff: raises 3000 to 4000
Zekko1983: calls 3000
MasterFrom17: calls 3000
*** FLOP *** [2c 2s 7s]
MasterFrom17: checks 
TURoff: bets 5000
Zekko1983: calls 5000
MasterFrom17: folds 
*** TURN *** [2c 2s 7s] [8d]
TURoff: checks 
Zekko1983: checks 
*** RIVER *** [2c 2s 7s 8d] [9d]
TURoff: checks 
Zekko1983: checks 
*** SHOW DOWN ***
TURoff: shows [As Kd] (a pair of Deuces)
Zekko1983: shows [5d 5h] (two pair, Fives and Deuces)
Zekko1983 collected 22875 from pot
*** SUMMARY ***
Total pot 22875 | Rake 0 
Board [2c 2s 7s 8d 9d]
Seat 1: Zekko1983 showed [5d 5h] and won (22875) with two pair, Fives and Deuces
Seat 2: APurchart folded before Flop (didn't bet)
Seat 3: PawelSlepzov (button) folded before Flop (didn't bet)
Seat 4: MasterFrom17 (small blind) folded on the Flop
Seat 5: TURoff (big blind) showed [As Kd] and lost with a pair of Deuces
Seat 7: Redron86 folded before Flop (didn't bet)
Seat 9: Vascaino_017 folded before Flop (didn't bet)





PokerStars Hand #177200173381: Tournament #2067822782, $1.00+$0.10 USD Hold'em No Limit - Level XVII (500/1000) - 2017/10/21 21:50:21 CUST [2017/10/21 13:50:21 ET]
Table '2067822782 27' 9-max Seat #4 is the button
Seat 1: Zekko1983 (87145 in chips) 
Seat 2: APurchart (55511 in chips) 
Seat 3: PawelSlepzov (19240 in chips) 
Seat 4: MasterFrom17 (39752 in chips) 
Seat 5: TURoff (65608 in chips) 
Seat 6: AlexeyM43 (21981 in chips) 
Seat 7: Redron86 (14260 in chips) 
Seat 8: Fiura25 (88636 in chips) 
Seat 9: Vascaino_017 (26638 in chips) 
Zekko1983: posts the ante 125
APurchart: posts the ante 125
PawelSlepzov: posts the ante 125
MasterFrom17: posts the ante 125
TURoff: posts the ante 125
AlexeyM43: posts the ante 125
Redron86: posts the ante 125
Fiura25: posts the ante 125
Vascaino_017: posts the ante 125
TURoff: posts small blind 500
AlexeyM43: posts big blind 1000
*** HOLE CARDS ***
Dealt to TURoff [3c 2h]
Redron86: folds 
Fiura25: folds 
Vascaino_017: folds 
Zekko1983: folds 
APurchart: folds 
PawelSlepzov: raises 18115 to 19115 and is all-in
MasterFrom17: folds 
TURoff: folds 
AlexeyM43: folds 
Uncalled bet (18115) returned to PawelSlepzov
PawelSlepzov collected 3625 from pot
*** SUMMARY ***
Total pot 3625 | Rake 0 
Seat 1: Zekko1983 folded before Flop (didn't bet)
Seat 2: APurchart folded before Flop (didn't bet)
Seat 3: PawelSlepzov collected (3625)
Seat 4: MasterFrom17 (button) folded before Flop (didn't bet)
Seat 5: TURoff (small blind) folded before Flop
Seat 6: AlexeyM43 (big blind) folded before Flop
Seat 7: Redron86 folded before Flop (didn't bet)
Seat 8: Fiura25 folded before Flop (didn't bet)
Seat 9: Vascaino_017 folded before Flop (didn't bet)





PokerStars Hand #177200193211: Tournament #2067822782, $1.00+$0.10 USD Hold'em No Limit - Level XVII (500/1000) - 2017/10/21 21:50:49 CUST [2017/10/21 13:50:49 ET]
Table '2067822782 27' 9-max Seat #5 is the button
Seat 1: Zekko1983 (87020 in chips) 
Seat 2: APurchart (55386 in chips) 
Seat 3: PawelSlepzov (21740 in chips) 
Seat 4: MasterFrom17 (39627 in chips) 
Seat 5: TURoff (64983 in chips) 
Seat 6: AlexeyM43 (20856 in chips) 
Seat 7: Redron86 (14135 in chips) 
Seat 8: Fiura25 (88511 in chips) 
Seat 9: Vascaino_017 (26513 in chips) 
Zekko1983: posts the ante 125
APurchart: posts the ante 125
PawelSlepzov: posts the ante 125
MasterFrom17: posts the ante 125
TURoff: posts the ante 125
AlexeyM43: posts the ante 125
Redron86: posts the ante 125
Fiura25: posts the ante 125
Vascaino_017: posts the ante 125
AlexeyM43: posts small blind 500
Redron86: posts big blind 1000
*** HOLE CARDS ***
Dealt to TURoff [9s 2h]
Fiura25: folds 
Vascaino_017: folds 
Zekko1983: folds 
APurchart: folds 
PawelSlepzov: raises 1200 to 2200
MasterFrom17: folds 
TURoff: folds 
AlexeyM43: folds 
Redron86: folds 
Uncalled bet (1200) returned to PawelSlepzov
PawelSlepzov collected 3625 from pot
*** SUMMARY ***
Total pot 3625 | Rake 0 
Seat 1: Zekko1983 folded before Flop (didn't bet)
Seat 2: APurchart folded before Flop (didn't bet)
Seat 3: PawelSlepzov collected (3625)
Seat 4: MasterFrom17 folded before Flop (didn't bet)
Seat 5: TURoff (button) folded before Flop (didn't bet)
Seat 6: AlexeyM43 (small blind) folded before Flop
Seat 7: Redron86 (big blind) folded before Flop
Seat 8: Fiura25 folded before Flop (didn't bet)
Seat 9: Vascaino_017 folded before Flop (didn't bet)





PokerStars Hand #177200213494: Tournament #2067822782, $1.00+$0.10 USD Hold'em No Limit - Level XVIII (600/1200) - 2017/10/21 21:51:17 CUST [2017/10/21 13:51:17 ET]
Table '2067822782 27' 9-max Seat #6 is the button
Seat 1: Zekko1983 (86895 in chips) 
Seat 2: APurchart (55261 in chips) 
Seat 3: PawelSlepzov (24240 in chips) 
Seat 4: MasterFrom17 (39502 in chips) 
Seat 5: TURoff (64858 in chips) 
Seat 6: AlexeyM43 (20231 in chips) 
Seat 7: Redron86 (13010 in chips) 
Seat 8: Fiura25 (88386 in chips) 
Seat 9: Vascaino_017 (26388 in chips) 
Zekko1983: posts the ante 150
APurchart: posts the ante 150
PawelSlepzov: posts the ante 150
MasterFrom17: posts the ante 150
TURoff: posts the ante 150
AlexeyM43: posts the ante 150
Redron86: posts the ante 150
Fiura25: posts the ante 150
Vascaino_017: posts the ante 150
Redron86: posts small blind 600
Fiura25: posts big blind 1200
*** HOLE CARDS ***
Dealt to TURoff [2s 4s]
Vascaino_017: folds 
Zekko1983: folds 
APurchart: folds 
PawelSlepzov: folds 
MasterFrom17: calls 1200
TURoff: folds 
AlexeyM43: calls 1200
Redron86: folds 
Fiura25: checks 
*** FLOP *** [Qh Qd 2d]
Fiura25: bets 1200
MasterFrom17: calls 1200
AlexeyM43: folds 
*** TURN *** [Qh Qd 2d] [6s]
Fiura25: bets 1200
MasterFrom17: calls 1200
*** RIVER *** [Qh Qd 2d 6s] [2h]
Fiura25: bets 15600
MasterFrom17: folds 
Uncalled bet (15600) returned to Fiura25
Fiura25 collected 10350 from pot
Fiura25: doesn't show hand 
*** SUMMARY ***
Total pot 10350 | Rake 0 
Board [Qh Qd 2d 6s 2h]
Seat 1: Zekko1983 folded before Flop (didn't bet)
Seat 2: APurchart folded before Flop (didn't bet)
Seat 3: PawelSlepzov folded before Flop (didn't bet)
Seat 4: MasterFrom17 folded on the River
Seat 5: TURoff folded before Flop (didn't bet)
Seat 6: AlexeyM43 (button) folded on the Flop
Seat 7: Redron86 (small blind) folded before Flop
Seat 8: Fiura25 (big blind) collected (10350)
Seat 9: Vascaino_017 folded before Flop (didn't bet)





PokerStars Hand #177200274315: Tournament #2067822782, $1.00+$0.10 USD Hold'em No Limit - Level XVIII (600/1200) - 2017/10/21 21:52:42 CUST [2017/10/21 13:52:42 ET]
Table '2067822782 27' 9-max Seat #7 is the button
Seat 1: Zekko1983 (86745 in chips) 
Seat 2: APurchart (55111 in chips) 
Seat 3: PawelSlepzov (24090 in chips) 
Seat 4: MasterFrom17 (35752 in chips) 
Seat 5: TURoff (64708 in chips) 
Seat 6: AlexeyM43 (18881 in chips) 
Seat 7: Redron86 (12260 in chips) 
Seat 8: Fiura25 (94986 in chips) 
Seat 9: Vascaino_017 (26238 in chips) 
Zekko1983: posts the ante 150
APurchart: posts the ante 150
PawelSlepzov: posts the ante 150
MasterFrom17: posts the ante 150
TURoff: posts the ante 150
AlexeyM43: posts the ante 150
Redron86: posts the ante 150
Fiura25: posts the ante 150
Vascaino_017: posts the ante 150
Fiura25: posts small blind 600
Vascaino_017: posts big blind 1200
*** HOLE CARDS ***
Dealt to TURoff [3d Td]
Zekko1983: folds 
APurchart: folds 
PawelSlepzov: folds 
MasterFrom17: calls 1200
TURoff: folds 
AlexeyM43: folds 
Redron86: folds 
Fiura25: folds 
Vascaino_017: checks 
*** FLOP *** [Kh Ks 7d]
Vascaino_017: checks 
MasterFrom17: checks 
*** TURN *** [Kh Ks 7d] [Ts]
Vascaino_017: checks 
MasterFrom17: bets 1200
Vascaino_017: folds 
Uncalled bet (1200) returned to MasterFrom17
MasterFrom17 collected 4350 from pot
*** SUMMARY ***
Total pot 4350 | Rake 0 
Board [Kh Ks 7d Ts]
Seat 1: Zekko1983 folded before Flop (didn't bet)
Seat 2: APurchart folded before Flop (didn't bet)
Seat 3: PawelSlepzov folded before Flop (didn't bet)
Seat 4: MasterFrom17 collected (4350)
Seat 5: TURoff folded before Flop (didn't bet)
Seat 6: AlexeyM43 folded before Flop (didn't bet)
Seat 7: Redron86 (button) folded before Flop (didn't bet)
Seat 8: Fiura25 (small blind) folded before Flop
Seat 9: Vascaino_017 (big blind) folded on the Turn





PokerStars Hand #177200304251: Tournament #2067822782, $1.00+$0.10 USD Hold'em No Limit - Level XVIII (600/1200) - 2017/10/21 21:53:24 CUST [2017/10/21 13:53:24 ET]
Table '2067822782 27' 9-max Seat #8 is the button
Seat 1: Zekko1983 (86595 in chips) 
Seat 2: APurchart (54961 in chips) 
Seat 3: PawelSlepzov (23940 in chips) 
Seat 4: MasterFrom17 (38752 in chips) 
Seat 5: TURoff (64558 in chips) 
Seat 6: AlexeyM43 (18731 in chips) 
Seat 7: Redron86 (12110 in chips) 
Seat 8: Fiura25 (94236 in chips) 
Seat 9: Vascaino_017 (24888 in chips) 
Zekko1983: posts the ante 150
APurchart: posts the ante 150
PawelSlepzov: posts the ante 150
MasterFrom17: posts the ante 150
TURoff: posts the ante 150
AlexeyM43: posts the ante 150
Redron86: posts the ante 150
Fiura25: posts the ante 150
Vascaino_017: posts the ante 150
Vascaino_017: posts small blind 600
Zekko1983: posts big blind 1200
*** HOLE CARDS ***
Dealt to TURoff [2d 4d]
APurchart: folds 
PawelSlepzov: folds 
MasterFrom17: folds 
TURoff: folds 
AlexeyM43: folds 
Redron86: folds 
Fiura25: folds 
Vascaino_017: folds 
Uncalled bet (600) returned to Zekko1983
Zekko1983 collected 2550 from pot
*** SUMMARY ***
Total pot 2550 | Rake 0 
Seat 1: Zekko1983 (big blind) collected (2550)
Seat 2: APurchart folded before Flop (didn't bet)
Seat 3: PawelSlepzov folded before Flop (didn't bet)
Seat 4: MasterFrom17 folded before Flop (didn't bet)
Seat 5: TURoff folded before Flop (didn't bet)
Seat 6: AlexeyM43 folded before Flop (didn't bet)
Seat 7: Redron86 folded before Flop (didn't bet)
Seat 8: Fiura25 (button) folded before Flop (didn't bet)
Seat 9: Vascaino_017 (small blind) folded before Flop





PokerStars Hand #177200322034: Tournament #2067822782, $1.00+$0.10 USD Hold'em No Limit - Level XVIII (600/1200) - 2017/10/21 21:53:49 CUST [2017/10/21 13:53:49 ET]
Table '2067822782 27' 9-max Seat #9 is the button
Seat 1: Zekko1983 (88395 in chips) 
Seat 2: APurchart (54811 in chips) 
Seat 3: PawelSlepzov (23790 in chips) 
Seat 4: MasterFrom17 (38602 in chips) 
Seat 5: TURoff (64408 in chips) 
Seat 6: AlexeyM43 (18581 in chips) 
Seat 7: Redron86 (11960 in chips) 
Seat 8: Fiura25 (94086 in chips) 
Seat 9: Vascaino_017 (24138 in chips) 
Zekko1983: posts the ante 150
APurchart: posts the ante 150
PawelSlepzov: posts the ante 150
MasterFrom17: posts the ante 150
TURoff: posts the ante 150
AlexeyM43: posts the ante 150
Redron86: posts the ante 150
Fiura25: posts the ante 150
Vascaino_017: posts the ante 150
Zekko1983: posts small blind 600
APurchart: posts big blind 1200
*** HOLE CARDS ***
Dealt to TURoff [Qh Kc]
PawelSlepzov: folds 
MasterFrom17: folds 
TURoff: raises 1440 to 2640
AlexeyM43: folds 
Redron86: folds 
Fiura25: folds 
Vascaino_017: folds 
Zekko1983: calls 2040
APurchart: folds 
*** FLOP *** [Jh Ts 2c]
Zekko1983: checks 
TURoff: bets 2400
Zekko1983: folds 
Uncalled bet (2400) returned to TURoff
TURoff collected 7830 from pot
TURoff: doesn't show hand 
*** SUMMARY ***
Total pot 7830 | Rake 0 
Board [Jh Ts 2c]
Seat 1: Zekko1983 (small blind) folded on the Flop
Seat 2: APurchart (big blind) folded before Flop
Seat 3: PawelSlepzov folded before Flop (didn't bet)
Seat 4: MasterFrom17 folded before Flop (didn't bet)
Seat 5: TURoff collected (7830)
Seat 6: AlexeyM43 folded before Flop (didn't bet)
Seat 7: Redron86 folded before Flop (didn't bet)
Seat 8: Fiura25 folded before Flop (didn't bet)
Seat 9: Vascaino_017 (button) folded before Flop (didn't bet)





PokerStars Hand #177200340402: Tournament #2067822782, $1.00+$0.10 USD Hold'em No Limit - Level XVIII (600/1200) - 2017/10/21 21:54:14 CUST [2017/10/21 13:54:14 ET]
Table '2067822782 27' 9-max Seat #1 is the button
Seat 1: Zekko1983 (85605 in chips) 
Seat 2: APurchart (53461 in chips) 
Seat 3: PawelSlepzov (23640 in chips) 
Seat 4: MasterFrom17 (38452 in chips) 
Seat 5: TURoff (69448 in chips) 
Seat 6: AlexeyM43 (18431 in chips) 
Seat 7: Redron86 (11810 in chips) 
Seat 8: Fiura25 (93936 in chips) 
Seat 9: Vascaino_017 (23988 in chips) 
Zekko1983: posts the ante 150
APurchart: posts the ante 150
PawelSlepzov: posts the ante 150
MasterFrom17: posts the ante 150
TURoff: posts the ante 150
AlexeyM43: posts the ante 150
Redron86: posts the ante 150
Fiura25: posts the ante 150
Vascaino_017: posts the ante 150
APurchart: posts small blind 600
PawelSlepzov: posts big blind 1200
*** HOLE CARDS ***
Dealt to TURoff [9h Jc]
MasterFrom17: calls 1200
TURoff: folds 
AlexeyM43: folds 
Redron86: folds 
Fiura25: folds 
Vascaino_017: raises 22638 to 23838 and is all-in
Zekko1983: folds 
APurchart: folds 
PawelSlepzov: folds 
MasterFrom17: folds 
Uncalled bet (22638) returned to Vascaino_017
Vascaino_017 collected 5550 from pot
Vascaino_017: doesn't show hand 
*** SUMMARY ***
Total pot 5550 | Rake 0 
Seat 1: Zekko1983 (button) folded before Flop (didn't bet)
Seat 2: APurchart (small blind) folded before Flop
Seat 3: PawelSlepzov (big blind) folded before Flop
Seat 4: MasterFrom17 folded before Flop
Seat 5: TURoff folded before Flop (didn't bet)
Seat 6: AlexeyM43 folded before Flop (didn't bet)
Seat 7: Redron86 folded before Flop (didn't bet)
Seat 8: Fiura25 folded before Flop (didn't bet)
Seat 9: Vascaino_017 collected (5550)





PokerStars Hand #177200373192: Tournament #2067822782, $1.00+$0.10 USD Hold'em No Limit - Level XVIII (600/1200) - 2017/10/21 21:55:00 CUST [2017/10/21 13:55:00 ET]
Table '2067822782 27' 9-max Seat #2 is the button
Seat 1: Zekko1983 (85455 in chips) 
Seat 2: APurchart (52711 in chips) 
Seat 3: PawelSlepzov (22290 in chips) 
Seat 4: MasterFrom17 (37102 in chips) 
Seat 5: TURoff (69298 in chips) 
Seat 6: AlexeyM43 (18281 in chips) 
Seat 7: Redron86 (11660 in chips) 
Seat 8: Fiura25 (93786 in chips) 
Seat 9: Vascaino_017 (28188 in chips) 
Zekko1983: posts the ante 150
APurchart: posts the ante 150
PawelSlepzov: posts the ante 150
MasterFrom17: posts the ante 150
TURoff: posts the ante 150
AlexeyM43: posts the ante 150
Redron86: posts the ante 150
Fiura25: posts the ante 150
Vascaino_017: posts the ante 150
PawelSlepzov: posts small blind 600
MasterFrom17: posts big blind 1200
*** HOLE CARDS ***
Dealt to TURoff [Qh 6d]
TURoff: folds 
AlexeyM43: folds 
Redron86: folds 
Fiura25: folds 
Vascaino_017: raises 1200 to 2400
Zekko1983: calls 2400
APurchart: folds 
PawelSlepzov: folds 
MasterFrom17: calls 1200
*** FLOP *** [3h 4d Jd]
MasterFrom17: checks 
Vascaino_017: checks 
Zekko1983: checks 
*** TURN *** [3h 4d Jd] [9h]
MasterFrom17: checks 
Vascaino_017: checks 
Zekko1983: bets 1200
MasterFrom17: calls 1200
Vascaino_017: calls 1200
*** RIVER *** [3h 4d Jd 9h] [8c]
MasterFrom17: checks 
Vascaino_017: checks 
Zekko1983: bets 1200
MasterFrom17: folds 
Vascaino_017: calls 1200
*** SHOW DOWN ***
Zekko1983: shows [Ah 9s] (a pair of Nines)
Vascaino_017: mucks hand 
Zekko1983 collected 15150 from pot
*** SUMMARY ***
Total pot 15150 | Rake 0 
Board [3h 4d Jd 9h 8c]
Seat 1: Zekko1983 showed [Ah 9s] and won (15150) with a pair of Nines
Seat 2: APurchart (button) folded before Flop (didn't bet)
Seat 3: PawelSlepzov (small blind) folded before Flop
Seat 4: MasterFrom17 (big blind) folded on the River
Seat 5: TURoff folded before Flop (didn't bet)
Seat 6: AlexeyM43 folded before Flop (didn't bet)
Seat 7: Redron86 folded before Flop (didn't bet)
Seat 8: Fiura25 folded before Flop (didn't bet)
Seat 9: Vascaino_017 mucked [As 8s]





PokerStars Hand #177200630231: Tournament #2067822782, $1.00+$0.10 USD Hold'em No Limit - Level XVIII (600/1200) - 2017/10/21 22:01:54 CUST [2017/10/21 14:01:54 ET]
Table '2067822782 27' 9-max Seat #3 is the button
Seat 1: Zekko1983 (95655 in chips) 
Seat 2: APurchart (52561 in chips) 
Seat 3: PawelSlepzov (21540 in chips) 
Seat 4: MasterFrom17 (33352 in chips) 
Seat 5: TURoff (69148 in chips) 
Seat 6: AlexeyM43 (18131 in chips) 
Seat 7: Redron86 (11510 in chips) 
Seat 8: Fiura25 (93636 in chips) 
Seat 9: Vascaino_017 (23238 in chips) 
Zekko1983: posts the ante 150
APurchart: posts the ante 150
PawelSlepzov: posts the ante 150
MasterFrom17: posts the ante 150
TURoff: posts the ante 150
AlexeyM43: posts the ante 150
Redron86: posts the ante 150
Fiura25: posts the ante 150
Vascaino_017: posts the ante 150
MasterFrom17: posts small blind 600
TURoff: posts big blind 1200
*** HOLE CARDS ***
Dealt to TURoff [5c Th]
AlexeyM43: folds 
Redron86: folds 
Fiura25: folds 
Vascaino_017: folds 
Zekko1983: folds 
APurchart: raises 1296 to 2496
PawelSlepzov: folds 
MasterFrom17: folds 
TURoff: folds 
Uncalled bet (1296) returned to APurchart
APurchart collected 4350 from pot
APurchart: doesn't show hand 
*** SUMMARY ***
Total pot 4350 | Rake 0 
Seat 1: Zekko1983 folded before Flop (didn't bet)
Seat 2: APurchart collected (4350)
Seat 3: PawelSlepzov (button) folded before Flop (didn't bet)
Seat 4: MasterFrom17 (small blind) folded before Flop
Seat 5: TURoff (big blind) folded before Flop
Seat 6: AlexeyM43 folded before Flop (didn't bet)
Seat 7: Redron86 folded before Flop (didn't bet)
Seat 8: Fiura25 folded before Flop (didn't bet)
Seat 9: Vascaino_017 folded before Flop (didn't bet)





PokerStars Hand #177200646253: Tournament #2067822782, $1.00+$0.10 USD Hold'em No Limit - Level XVIII (600/1200) - 2017/10/21 22:02:16 CUST [2017/10/21 14:02:16 ET]
Table '2067822782 27' 9-max Seat #4 is the button
Seat 1: Zekko1983 (95505 in chips) 
Seat 2: APurchart (55561 in chips) 
Seat 3: PawelSlepzov (21390 in chips) 
Seat 4: MasterFrom17 (32602 in chips) 
Seat 5: TURoff (67798 in chips) 
Seat 6: AlexeyM43 (17981 in chips) 
Seat 7: Redron86 (11360 in chips) 
Seat 8: Fiura25 (93486 in chips) 
Seat 9: Vascaino_017 (23088 in chips) 
Zekko1983: posts the ante 150
APurchart: posts the ante 150
PawelSlepzov: posts the ante 150
MasterFrom17: posts the ante 150
TURoff: posts the ante 150
AlexeyM43: posts the ante 150
Redron86: posts the ante 150
Fiura25: posts the ante 150
Vascaino_017: posts the ante 150
TURoff: posts small blind 600
AlexeyM43: posts big blind 1200
*** HOLE CARDS ***
Dealt to TURoff [Th 4h]
Redron86: folds 
Fiura25: folds 
Vascaino_017: folds 
Zekko1983: calls 1200
APurchart: folds 
PawelSlepzov: calls 1200
MasterFrom17: folds 
TURoff: calls 600
AlexeyM43: checks 
*** FLOP *** [4c 7s Kd]
TURoff: checks 
AlexeyM43: checks 
Zekko1983: checks 
PawelSlepzov: checks 
*** TURN *** [4c 7s Kd] [3d]
TURoff: bets 1200
AlexeyM43: folds 
Zekko1983: folds 
PawelSlepzov: calls 1200
*** RIVER *** [4c 7s Kd 3d] [Ad]
TURoff: checks 
PawelSlepzov: bets 4275
TURoff: folds 
Uncalled bet (4275) returned to PawelSlepzov
PawelSlepzov collected 8550 from pot
*** SUMMARY ***
Total pot 8550 | Rake 0 
Board [4c 7s Kd 3d Ad]
Seat 1: Zekko1983 folded on the Turn
Seat 2: APurchart folded before Flop (didn't bet)
Seat 3: PawelSlepzov collected (8550)
Seat 4: MasterFrom17 (button) folded before Flop (didn't bet)
Seat 5: TURoff (small blind) folded on the River
Seat 6: AlexeyM43 (big blind) folded on the Turn
Seat 7: Redron86 folded before Flop (didn't bet)
Seat 8: Fiura25 folded before Flop (didn't bet)
Seat 9: Vascaino_017 folded before Flop (didn't bet)





PokerStars Hand #177200705713: Tournament #2067822782, $1.00+$0.10 USD Hold'em No Limit - Level XVIII (600/1200) - 2017/10/21 22:03:33 CUST [2017/10/21 14:03:33 ET]
Table '2067822782 27' 9-max Seat #5 is the button
Seat 1: Zekko1983 (94155 in chips) 
Seat 2: APurchart (55411 in chips) 
Seat 3: PawelSlepzov (27390 in chips) 
Seat 4: MasterFrom17 (32452 in chips) 
Seat 5: TURoff (65248 in chips) 
Seat 6: AlexeyM43 (16631 in chips) 
Seat 7: Redron86 (11210 in chips) 
Seat 8: Fiura25 (93336 in chips) 
Seat 9: Vascaino_017 (22938 in chips) 
Zekko1983: posts the ante 150
APurchart: posts the ante 150
PawelSlepzov: posts the ante 150
MasterFrom17: posts the ante 150
TURoff: posts the ante 150
AlexeyM43: posts the ante 150
Redron86: posts the ante 150
Fiura25: posts the ante 150
Vascaino_017: posts the ante 150
AlexeyM43: posts small blind 600
Redron86: posts big blind 1200
*** HOLE CARDS ***
Dealt to TURoff [9c 2h]
Fiura25: folds 
Vascaino_017: folds 
Zekko1983: folds 
APurchart: folds 
PawelSlepzov: folds 
MasterFrom17: folds 
TURoff: folds 
AlexeyM43: calls 600
Redron86: checks 
*** FLOP *** [Ts As 3c]
AlexeyM43: checks 
Redron86: checks 
*** TURN *** [Ts As 3c] [Kc]
AlexeyM43: checks 
Redron86: checks 
*** RIVER *** [Ts As 3c Kc] [Ad]
AlexeyM43: checks 
Redron86: checks 
*** SHOW DOWN ***
AlexeyM43: shows [Qd 9h] (a pair of Aces)
Redron86: mucks hand 
AlexeyM43 collected 3750 from pot
*** SUMMARY ***
Total pot 3750 | Rake 0 
Board [Ts As 3c Kc Ad]
Seat 1: Zekko1983 folded before Flop (didn't bet)
Seat 2: APurchart folded before Flop (didn't bet)
Seat 3: PawelSlepzov folded before Flop (didn't bet)
Seat 4: MasterFrom17 folded before Flop (didn't bet)
Seat 5: TURoff (button) folded before Flop (didn't bet)
Seat 6: AlexeyM43 (small blind) showed [Qd 9h] and won (3750) with a pair of Aces
Seat 7: Redron86 (big blind) mucked [4d 7h]
Seat 8: Fiura25 folded before Flop (didn't bet)
Seat 9: Vascaino_017 folded before Flop (didn't bet)





PokerStars Hand #177200736648: Tournament #2067822782, $1.00+$0.10 USD Hold'em No Limit - Level XVIII (600/1200) - 2017/10/21 22:04:13 CUST [2017/10/21 14:04:13 ET]
Table '2067822782 27' 9-max Seat #6 is the button
Seat 1: Zekko1983 (94005 in chips) 
Seat 2: APurchart (55261 in chips) 
Seat 3: PawelSlepzov (27240 in chips) 
Seat 4: MasterFrom17 (32302 in chips) 
Seat 5: TURoff (65098 in chips) 
Seat 6: AlexeyM43 (19031 in chips) 
Seat 7: Redron86 (9860 in chips) 
Seat 8: Fiura25 (93186 in chips) 
Seat 9: Vascaino_017 (22788 in chips) 
Zekko1983: posts the ante 150
APurchart: posts the ante 150
PawelSlepzov: posts the ante 150
MasterFrom17: posts the ante 150
TURoff: posts the ante 150
AlexeyM43: posts the ante 150
Redron86: posts the ante 150
Fiura25: posts the ante 150
Vascaino_017: posts the ante 150
Redron86: posts small blind 600
Fiura25: posts big blind 1200
*** HOLE CARDS ***
Dealt to TURoff [5c 4d]
Vascaino_017: folds 
Zekko1983: raises 1200 to 2400
APurchart: calls 2400
PawelSlepzov: folds 
MasterFrom17: folds 
TURoff: folds 
AlexeyM43: folds 
Redron86: folds 
Fiura25: folds 
*** FLOP *** [Qh 6s 4s]
Zekko1983: bets 1200
APurchart: calls 1200
*** TURN *** [Qh 6s 4s] [3s]
Zekko1983: bets 1200
APurchart: calls 1200
*** RIVER *** [Qh 6s 4s 3s] [2d]
Zekko1983: bets 1200
APurchart: calls 1200
*** SHOW DOWN ***
Zekko1983: shows [Ks Kh] (a pair of Kings)
APurchart: mucks hand 
Zekko1983 collected 15150 from pot
*** SUMMARY ***
Total pot 15150 | Rake 0 
Board [Qh 6s 4s 3s 2d]
Seat 1: Zekko1983 showed [Ks Kh] and won (15150) with a pair of Kings
Seat 2: APurchart mucked [9s 9h]
Seat 3: PawelSlepzov folded before Flop (didn't bet)
Seat 4: MasterFrom17 folded before Flop (didn't bet)
Seat 5: TURoff folded before Flop (didn't bet)
Seat 6: AlexeyM43 (button) folded before Flop (didn't bet)
Seat 7: Redron86 (small blind) folded before Flop
Seat 8: Fiura25 (big blind) folded before Flop
Seat 9: Vascaino_017 folded before Flop (didn't bet)





PokerStars Hand #177200769488: Tournament #2067822782, $1.00+$0.10 USD Hold'em No Limit - Level XVIII (600/1200) - 2017/10/21 22:04:56 CUST [2017/10/21 14:04:56 ET]
Table '2067822782 27' 9-max Seat #7 is the button
Seat 1: Zekko1983 (103005 in chips) 
Seat 2: APurchart (49111 in chips) 
Seat 3: PawelSlepzov (27090 in chips) 
Seat 4: MasterFrom17 (32152 in chips) 
Seat 5: TURoff (64948 in chips) 
Seat 6: AlexeyM43 (18881 in chips) 
Seat 7: Redron86 (9110 in chips) 
Seat 8: Fiura25 (91836 in chips) 
Seat 9: Vascaino_017 (22638 in chips) 
Zekko1983: posts the ante 150
APurchart: posts the ante 150
PawelSlepzov: posts the ante 150
MasterFrom17: posts the ante 150
TURoff: posts the ante 150
AlexeyM43: posts the ante 150
Redron86: posts the ante 150
Fiura25: posts the ante 150
Vascaino_017: posts the ante 150
Fiura25: posts small blind 600
Vascaino_017: posts big blind 1200
*** HOLE CARDS ***
Dealt to TURoff [3d Kh]
Zekko1983: folds 
APurchart: folds 
PawelSlepzov: folds 
MasterFrom17: calls 1200
TURoff: folds 
AlexeyM43: raises 1200 to 2400
Redron86: folds 
Fiura25: folds 
Vascaino_017: folds 
MasterFrom17: calls 1200
*** FLOP *** [3s 9d Ah]
MasterFrom17: bets 8400
AlexeyM43: folds 
Uncalled bet (8400) returned to MasterFrom17
MasterFrom17 collected 7950 from pot
*** SUMMARY ***
Total pot 7950 | Rake 0 
Board [3s 9d Ah]
Seat 1: Zekko1983 folded before Flop (didn't bet)
Seat 2: APurchart folded before Flop (didn't bet)
Seat 3: PawelSlepzov folded before Flop (didn't bet)
Seat 4: MasterFrom17 collected (7950)
Seat 5: TURoff folded before Flop (didn't bet)
Seat 6: AlexeyM43 folded on the Flop
Seat 7: Redron86 (button) folded before Flop (didn't bet)
Seat 8: Fiura25 (small blind) folded before Flop
Seat 9: Vascaino_017 (big blind) folded before Flop





PokerStars Hand #177200812260: Tournament #2067822782, $1.00+$0.10 USD Hold'em No Limit - Level XVIII (600/1200) - 2017/10/21 22:05:50 CUST [2017/10/21 14:05:50 ET]
Table '2067822782 27' 9-max Seat #8 is the button
Seat 1: Zekko1983 (102855 in chips) 
Seat 2: APurchart (48961 in chips) 
Seat 3: PawelSlepzov (26940 in chips) 
Seat 4: MasterFrom17 (37552 in chips) 
Seat 5: TURoff (64798 in chips) 
Seat 6: AlexeyM43 (16331 in chips) 
Seat 7: Redron86 (8960 in chips) 
Seat 8: Fiura25 (91086 in chips) 
Seat 9: Vascaino_017 (21288 in chips) 
Zekko1983: posts the ante 150
APurchart: posts the ante 150
PawelSlepzov: posts the ante 150
MasterFrom17: posts the ante 150
TURoff: posts the ante 150
AlexeyM43: posts the ante 150
Redron86: posts the ante 150
Fiura25: posts the ante 150
Vascaino_017: posts the ante 150
Vascaino_017: posts small blind 600
Zekko1983: posts big blind 1200
*** HOLE CARDS ***
Dealt to TURoff [3h Kd]
APurchart: raises 1200 to 2400
PawelSlepzov: folds 
MasterFrom17: raises 7950 to 10350
TURoff: folds 
AlexeyM43: folds 
Redron86: folds 
Fiura25: folds 
Vascaino_017: folds 
Zekko1983: folds 
APurchart: folds 
Uncalled bet (7950) returned to MasterFrom17
MasterFrom17 collected 7950 from pot
*** SUMMARY ***
Total pot 7950 | Rake 0 
Seat 1: Zekko1983 (big blind) folded before Flop
Seat 2: APurchart folded before Flop
Seat 3: PawelSlepzov folded before Flop (didn't bet)
Seat 4: MasterFrom17 collected (7950)
Seat 5: TURoff folded before Flop (didn't bet)
Seat 6: AlexeyM43 folded before Flop (didn't bet)
Seat 7: Redron86 folded before Flop (didn't bet)
Seat 8: Fiura25 (button) folded before Flop (didn't bet)
Seat 9: Vascaino_017 (small blind) folded before Flop





PokerStars Hand #177200844670: Tournament #2067822782, $1.00+$0.10 USD Hold'em No Limit - Level XVIII (600/1200) - 2017/10/21 22:06:33 CUST [2017/10/21 14:06:33 ET]
Table '2067822782 27' 9-max Seat #9 is the button
Seat 1: Zekko1983 (101505 in chips) 
Seat 2: APurchart (46411 in chips) 
Seat 3: PawelSlepzov (26790 in chips) 
Seat 4: MasterFrom17 (42952 in chips) 
Seat 5: TURoff (64648 in chips) 
Seat 6: AlexeyM43 (16181 in chips) 
Seat 7: Redron86 (8810 in chips) 
Seat 8: Fiura25 (90936 in chips) 
Seat 9: Vascaino_017 (20538 in chips) 
Zekko1983: posts the ante 150
APurchart: posts the ante 150
PawelSlepzov: posts the ante 150
MasterFrom17: posts the ante 150
TURoff: posts the ante 150
AlexeyM43: posts the ante 150
Redron86: posts the ante 150
Fiura25: posts the ante 150
Vascaino_017: posts the ante 150
Zekko1983: posts small blind 600
APurchart: posts big blind 1200
*** HOLE CARDS ***
Dealt to TURoff [5d 4s]
PawelSlepzov: folds 
MasterFrom17: calls 1200
TURoff: folds 
AlexeyM43: folds 
Redron86: folds 
Fiura25: calls 1200
Vascaino_017: raises 19188 to 20388 and is all-in
Zekko1983: folds 
APurchart: folds 
MasterFrom17: folds 
Fiura25: folds 
Uncalled bet (19188) returned to Vascaino_017
Vascaino_017 collected 6750 from pot
Vascaino_017: doesn't show hand 
*** SUMMARY ***
Total pot 6750 | Rake 0 
Seat 1: Zekko1983 (small blind) folded before Flop
Seat 2: APurchart (big blind) folded before Flop
Seat 3: PawelSlepzov folded before Flop (didn't bet)
Seat 4: MasterFrom17 folded before Flop
Seat 5: TURoff folded before Flop (didn't bet)
Seat 6: AlexeyM43 folded before Flop (didn't bet)
Seat 7: Redron86 folded before Flop (didn't bet)
Seat 8: Fiura25 folded before Flop
Seat 9: Vascaino_017 (button) collected (6750)





PokerStars Hand #177200874854: Tournament #2067822782, $1.00+$0.10 USD Hold'em No Limit - Level XVIII (600/1200) - 2017/10/21 22:07:12 CUST [2017/10/21 14:07:12 ET]
Table '2067822782 27' 9-max Seat #1 is the button
Seat 1: Zekko1983 (100755 in chips) 
Seat 2: APurchart (45061 in chips) 
Seat 3: PawelSlepzov (26640 in chips) 
Seat 4: MasterFrom17 (41602 in chips) 
Seat 5: TURoff (64498 in chips) 
Seat 6: AlexeyM43 (16031 in chips) 
Seat 7: Redron86 (8660 in chips) 
Seat 8: Fiura25 (89586 in chips) 
Seat 9: Vascaino_017 (25938 in chips) 
Zekko1983: posts the ante 150
APurchart: posts the ante 150
PawelSlepzov: posts the ante 150
MasterFrom17: posts the ante 150
TURoff: posts the ante 150
AlexeyM43: posts the ante 150
Redron86: posts the ante 150
Fiura25: posts the ante 150
Vascaino_017: posts the ante 150
APurchart: posts small blind 600
PawelSlepzov: posts big blind 1200
*** HOLE CARDS ***
Dealt to TURoff [3s 5s]
MasterFrom17: folds 
TURoff: folds 
AlexeyM43: folds 
Redron86: folds 
Fiura25: folds 
Vascaino_017: folds 
Zekko1983: folds 
APurchart: folds 
Uncalled bet (600) returned to PawelSlepzov
PawelSlepzov collected 2550 from pot
*** SUMMARY ***
Total pot 2550 | Rake 0 
Seat 1: Zekko1983 (button) folded before Flop (didn't bet)
Seat 2: APurchart (small blind) folded before Flop
Seat 3: PawelSlepzov (big blind) collected (2550)
Seat 4: MasterFrom17 folded before Flop (didn't bet)
Seat 5: TURoff folded before Flop (didn't bet)
Seat 6: AlexeyM43 folded before Flop (didn't bet)
Seat 7: Redron86 folded before Flop (didn't bet)
Seat 8: Fiura25 folded before Flop (didn't bet)
Seat 9: Vascaino_017 folded before Flop (didn't bet)





PokerStars Hand #177200891129: Tournament #2067822782, $1.00+$0.10 USD Hold'em No Limit - Level XVIII (600/1200) - 2017/10/21 22:07:33 CUST [2017/10/21 14:07:33 ET]
Table '2067822782 27' 9-max Seat #2 is the button
Seat 1: Zekko1983 (100605 in chips) 
Seat 2: APurchart (44311 in chips) 
Seat 3: PawelSlepzov (28440 in chips) 
Seat 4: MasterFrom17 (41452 in chips) 
Seat 5: TURoff (64348 in chips) 
Seat 6: AlexeyM43 (15881 in chips) 
Seat 7: Redron86 (8510 in chips) 
Seat 8: Fiura25 (89436 in chips) 
Seat 9: Vascaino_017 (25788 in chips) 
Zekko1983: posts the ante 150
APurchart: posts the ante 150
PawelSlepzov: posts the ante 150
MasterFrom17: posts the ante 150
TURoff: posts the ante 150
AlexeyM43: posts the ante 150
Redron86: posts the ante 150
Fiura25: posts the ante 150
Vascaino_017: posts the ante 150
PawelSlepzov: posts small blind 600
MasterFrom17: posts big blind 1200
*** HOLE CARDS ***
Dealt to TURoff [9d 6c]
TURoff: folds 
AlexeyM43: folds 
Redron86: folds 
Fiura25: folds 
Vascaino_017: folds 
Zekko1983: calls 1200
APurchart: raises 3900 to 5100
PawelSlepzov: folds 
MasterFrom17: folds 
Zekko1983: folds 
Uncalled bet (3900) returned to APurchart
APurchart collected 5550 from pot
APurchart: doesn't show hand 
*** SUMMARY ***
Total pot 5550 | Rake 0 
Seat 1: Zekko1983 folded before Flop
Seat 2: APurchart (button) collected (5550)
Seat 3: PawelSlepzov (small blind) folded before Flop
Seat 4: MasterFrom17 (big blind) folded before Flop
Seat 5: TURoff folded before Flop (didn't bet)
Seat 6: AlexeyM43 folded before Flop (didn't bet)
Seat 7: Redron86 folded before Flop (didn't bet)
Seat 8: Fiura25 folded before Flop (didn't bet)
Seat 9: Vascaino_017 folded before Flop (didn't bet)





PokerStars Hand #177200921460: Tournament #2067822782, $1.00+$0.10 USD Hold'em No Limit - Level XIX (700/1400) - 2017/10/21 22:08:13 CUST [2017/10/21 14:08:13 ET]
Table '2067822782 27' 9-max Seat #3 is the button
Seat 1: Zekko1983 (99255 in chips) 
Seat 2: APurchart (48511 in chips) 
Seat 3: PawelSlepzov (27690 in chips) 
Seat 4: MasterFrom17 (40102 in chips) 
Seat 5: TURoff (64198 in chips) 
Seat 6: AlexeyM43 (15731 in chips) 
Seat 7: Redron86 (8360 in chips) 
Seat 8: Fiura25 (89286 in chips) 
Seat 9: Vascaino_017 (25638 in chips) 
Zekko1983: posts the ante 175
APurchart: posts the ante 175
PawelSlepzov: posts the ante 175
MasterFrom17: posts the ante 175
TURoff: posts the ante 175
AlexeyM43: posts the ante 175
Redron86: posts the ante 175
Fiura25: posts the ante 175
Vascaino_017: posts the ante 175
MasterFrom17: posts small blind 700
TURoff: posts big blind 1400
*** HOLE CARDS ***
Dealt to TURoff [5h 5s]
AlexeyM43: folds 
Redron86: folds 
Fiura25: folds 
Vascaino_017: folds 
Zekko1983: folds 
APurchart: raises 1400 to 2800
PawelSlepzov: folds 
MasterFrom17: folds 
TURoff: calls 1400
*** FLOP *** [Jh Jd 3s]
TURoff: checks 
APurchart: bets 2599
TURoff: calls 2599
*** TURN *** [Jh Jd 3s] [Ts]
TURoff: checks 
APurchart: bets 4314
TURoff: calls 4314
*** RIVER *** [Jh Jd 3s Ts] [Qc]
TURoff: checks 
APurchart: checks 
*** SHOW DOWN ***
TURoff: shows [5h 5s] (two pair, Jacks and Fives)
APurchart: mucks hand 
TURoff collected 21701 from pot
*** SUMMARY ***
Total pot 21701 | Rake 0 
Board [Jh Jd 3s Ts Qc]
Seat 1: Zekko1983 folded before Flop (didn't bet)
Seat 2: APurchart mucked [6s 8s]
Seat 3: PawelSlepzov (button) folded before Flop (didn't bet)
Seat 4: MasterFrom17 (small blind) folded before Flop
Seat 5: TURoff (big blind) showed [5h 5s] and won (21701) with two pair, Jacks and Fives
Seat 6: AlexeyM43 folded before Flop (didn't bet)
Seat 7: Redron86 folded before Flop (didn't bet)
Seat 8: Fiura25 folded before Flop (didn't bet)
Seat 9: Vascaino_017 folded before Flop (didn't bet)





PokerStars Hand #177200964649: Tournament #2067822782, $1.00+$0.10 USD Hold'em No Limit - Level XIX (700/1400) - 2017/10/21 22:09:09 CUST [2017/10/21 14:09:09 ET]
Table '2067822782 27' 9-max Seat #4 is the button
Seat 1: Zekko1983 (99080 in chips) 
Seat 2: APurchart (38623 in chips) 
Seat 3: PawelSlepzov (27515 in chips) 
Seat 4: MasterFrom17 (39227 in chips) 
Seat 5: TURoff (76011 in chips) 
Seat 6: AlexeyM43 (15556 in chips) 
Seat 7: Redron86 (8185 in chips) 
Seat 8: Fiura25 (89111 in chips) 
Seat 9: Vascaino_017 (25463 in chips) 
Zekko1983: posts the ante 175
APurchart: posts the ante 175
PawelSlepzov: posts the ante 175
MasterFrom17: posts the ante 175
TURoff: posts the ante 175
AlexeyM43: posts the ante 175
Redron86: posts the ante 175
Fiura25: posts the ante 175
Vascaino_017: posts the ante 175
TURoff: posts small blind 700
AlexeyM43: posts big blind 1400
*** HOLE CARDS ***
Dealt to TURoff [Qc Ts]
Redron86: folds 
Fiura25: folds 
Vascaino_017: folds 
Zekko1983: calls 1400
APurchart: folds 
PawelSlepzov: folds 
MasterFrom17: folds 
TURoff: calls 700
AlexeyM43: checks 
*** FLOP *** [3h 2c 7c]
TURoff: checks 
AlexeyM43: checks 
Zekko1983: checks 
*** TURN *** [3h 2c 7c] [Qs]
TURoff: bets 1400
AlexeyM43: calls 1400
Zekko1983: folds 
*** RIVER *** [3h 2c 7c Qs] [2h]
TURoff: bets 1400
AlexeyM43: calls 1400
*** SHOW DOWN ***
TURoff: shows [Qc Ts] (two pair, Queens and Deuces)
AlexeyM43: mucks hand 
TURoff collected 11375 from pot
*** SUMMARY ***
Total pot 11375 | Rake 0 
Board [3h 2c 7c Qs 2h]
Seat 1: Zekko1983 folded on the Turn
Seat 2: APurchart folded before Flop (didn't bet)
Seat 3: PawelSlepzov folded before Flop (didn't bet)
Seat 4: MasterFrom17 (button) folded before Flop (didn't bet)
Seat 5: TURoff (small blind) showed [Qc Ts] and won (11375) with two pair, Queens and Deuces
Seat 6: AlexeyM43 (big blind) mucked [3c Ks]
Seat 7: Redron86 folded before Flop (didn't bet)
Seat 8: Fiura25 folded before Flop (didn't bet)
Seat 9: Vascaino_017 folded before Flop (didn't bet)





PokerStars Hand #177201015302: Tournament #2067822782, $1.00+$0.10 USD Hold'em No Limit - Level XIX (700/1400) - 2017/10/21 22:10:15 CUST [2017/10/21 14:10:15 ET]
Table '2067822782 27' 9-max Seat #5 is the button
Seat 1: Zekko1983 (97505 in chips) 
Seat 2: APurchart (38448 in chips) 
Seat 3: PawelSlepzov (27340 in chips) 
Seat 4: MasterFrom17 (39052 in chips) 
Seat 5: TURoff (83011 in chips) 
Seat 6: AlexeyM43 (11181 in chips) 
Seat 7: Redron86 (8010 in chips) 
Seat 8: Fiura25 (88936 in chips) 
Seat 9: Vascaino_017 (25288 in chips) 
Zekko1983: posts the ante 175
APurchart: posts the ante 175
PawelSlepzov: posts the ante 175
MasterFrom17: posts the ante 175
TURoff: posts the ante 175
AlexeyM43: posts the ante 175
Redron86: posts the ante 175
Fiura25: posts the ante 175
Vascaino_017: posts the ante 175
AlexeyM43: posts small blind 700
Redron86: posts big blind 1400
*** HOLE CARDS ***
Dealt to TURoff [7s 4s]
Fiura25: folds 
Vascaino_017: folds 
Zekko1983: folds 
APurchart: folds 
PawelSlepzov: folds 
MasterFrom17: calls 1400
TURoff: calls 1400
AlexeyM43: calls 700
Redron86: checks 
*** FLOP *** [Qc Jd 4h]
AlexeyM43: bets 1400
Redron86: folds 
MasterFrom17: folds 
TURoff: calls 1400
*** TURN *** [Qc Jd 4h] [Jc]
AlexeyM43: bets 1400
TURoff: folds 
Uncalled bet (1400) returned to AlexeyM43
AlexeyM43 collected 9975 from pot
AlexeyM43: doesn't show hand 
*** SUMMARY ***
Total pot 9975 | Rake 0 
Board [Qc Jd 4h Jc]
Seat 1: Zekko1983 folded before Flop (didn't bet)
Seat 2: APurchart folded before Flop (didn't bet)
Seat 3: PawelSlepzov folded before Flop (didn't bet)
Seat 4: MasterFrom17 folded on the Flop
Seat 5: TURoff (button) folded on the Turn
Seat 6: AlexeyM43 (small blind) collected (9975)
Seat 7: Redron86 (big blind) folded on the Flop
Seat 8: Fiura25 folded before Flop (didn't bet)
Seat 9: Vascaino_017 folded before Flop (didn't bet)





PokerStars Hand #177201052429: Tournament #2067822782, $1.00+$0.10 USD Hold'em No Limit - Level XIX (700/1400) - 2017/10/21 22:11:03 CUST [2017/10/21 14:11:03 ET]
Table '2067822782 27' 9-max Seat #6 is the button
Seat 1: Zekko1983 (97330 in chips) 
Seat 2: APurchart (38273 in chips) 
Seat 3: PawelSlepzov (27165 in chips) 
Seat 4: MasterFrom17 (37477 in chips) 
Seat 5: TURoff (80036 in chips) 
Seat 6: AlexeyM43 (18181 in chips) 
Seat 7: Redron86 (6435 in chips) 
Seat 8: Fiura25 (88761 in chips) 
Seat 9: Vascaino_017 (25113 in chips) 
Zekko1983: posts the ante 175
APurchart: posts the ante 175
PawelSlepzov: posts the ante 175
MasterFrom17: posts the ante 175
TURoff: posts the ante 175
AlexeyM43: posts the ante 175
Redron86: posts the ante 175
Fiura25: posts the ante 175
Vascaino_017: posts the ante 175
Redron86: posts small blind 700
Fiura25: posts big blind 1400
*** HOLE CARDS ***
Dealt to TURoff [Kc Jc]
Vascaino_017: folds 
Zekko1983: calls 1400
APurchart: folds 
PawelSlepzov: folds 
MasterFrom17: folds 
TURoff: raises 1680 to 3080
AlexeyM43: folds 
Redron86: folds 
Fiura25: folds 
Zekko1983: calls 1680
*** FLOP *** [9d Ac 9c]
Zekko1983: bets 1400
TURoff: calls 1400
*** TURN *** [9d Ac 9c] [Jd]
Zekko1983: checks 
TURoff: checks 
*** RIVER *** [9d Ac 9c Jd] [6s]
Zekko1983: bets 1400
TURoff: calls 1400
*** SHOW DOWN ***
Zekko1983: shows [As Th] (two pair, Aces and Nines)
TURoff: mucks hand 
Zekko1983 collected 15435 from pot
*** SUMMARY ***
Total pot 15435 | Rake 0 
Board [9d Ac 9c Jd 6s]
Seat 1: Zekko1983 showed [As Th] and won (15435) with two pair, Aces and Nines
Seat 2: APurchart folded before Flop (didn't bet)
Seat 3: PawelSlepzov folded before Flop (didn't bet)
Seat 4: MasterFrom17 folded before Flop (didn't bet)
Seat 5: TURoff mucked [Kc Jc]
Seat 6: AlexeyM43 (button) folded before Flop (didn't bet)
Seat 7: Redron86 (small blind) folded before Flop
Seat 8: Fiura25 (big blind) folded before Flop
Seat 9: Vascaino_017 folded before Flop (didn't bet)





PokerStars Hand #177201092456: Tournament #2067822782, $1.00+$0.10 USD Hold'em No Limit - Level XIX (700/1400) - 2017/10/21 22:11:55 CUST [2017/10/21 14:11:55 ET]
Table '2067822782 27' 9-max Seat #7 is the button
Seat 1: Zekko1983 (106710 in chips) 
Seat 2: APurchart (38098 in chips) 
Seat 3: PawelSlepzov (26990 in chips) 
Seat 4: MasterFrom17 (37302 in chips) 
Seat 5: TURoff (73981 in chips) 
Seat 6: AlexeyM43 (18006 in chips) 
Seat 7: Redron86 (5560 in chips) 
Seat 8: Fiura25 (87186 in chips) 
Seat 9: Vascaino_017 (24938 in chips) 
Zekko1983: posts the ante 175
APurchart: posts the ante 175
PawelSlepzov: posts the ante 175
MasterFrom17: posts the ante 175
TURoff: posts the ante 175
AlexeyM43: posts the ante 175
Redron86: posts the ante 175
Fiura25: posts the ante 175
Vascaino_017: posts the ante 175
Fiura25: posts small blind 700
Vascaino_017: posts big blind 1400
*** HOLE CARDS ***
Dealt to TURoff [2c Jd]
Zekko1983: folds 
APurchart: folds 
Zekko1983 is sitting out
PawelSlepzov: folds 
MasterFrom17: calls 1400
TURoff: folds 
AlexeyM43: folds 
Redron86: folds 
Fiura25: folds 
Vascaino_017: checks 
*** FLOP *** [Ad Qc Ah]
Vascaino_017: checks 
MasterFrom17: bets 1400
Vascaino_017: folds 
Uncalled bet (1400) returned to MasterFrom17
MasterFrom17 collected 5075 from pot
*** SUMMARY ***
Total pot 5075 | Rake 0 
Board [Ad Qc Ah]
Seat 1: Zekko1983 folded before Flop (didn't bet)
Seat 2: APurchart folded before Flop (didn't bet)
Seat 3: PawelSlepzov folded before Flop (didn't bet)
Seat 4: MasterFrom17 collected (5075)
Seat 5: TURoff folded before Flop (didn't bet)
Seat 6: AlexeyM43 folded before Flop (didn't bet)
Seat 7: Redron86 (button) folded before Flop (didn't bet)
Seat 8: Fiura25 (small blind) folded before Flop
Seat 9: Vascaino_017 (big blind) folded on the Flop





PokerStars Hand #177201117480: Tournament #2067822782, $1.00+$0.10 USD Hold'em No Limit - Level XIX (700/1400) - 2017/10/21 22:12:28 CUST [2017/10/21 14:12:28 ET]
Table '2067822782 27' 9-max Seat #8 is the button
Seat 1: Zekko1983 (106535 in chips) is sitting out
Seat 2: APurchart (37923 in chips) 
Seat 3: PawelSlepzov (26815 in chips) 
Seat 4: MasterFrom17 (40802 in chips) 
Seat 5: TURoff (73806 in chips) 
Seat 6: AlexeyM43 (17831 in chips) 
Seat 7: Redron86 (5385 in chips) 
Seat 8: Fiura25 (86311 in chips) 
Seat 9: Vascaino_017 (23363 in chips) 
Zekko1983: posts the ante 175
APurchart: posts the ante 175
PawelSlepzov: posts the ante 175
MasterFrom17: posts the ante 175
TURoff: posts the ante 175
AlexeyM43: posts the ante 175
Redron86: posts the ante 175
Fiura25: posts the ante 175
Vascaino_017: posts the ante 175
Vascaino_017: posts small blind 700
Zekko1983: posts big blind 1400
*** HOLE CARDS ***
Dealt to TURoff [Ac Ad]
APurchart: folds 
PawelSlepzov: folds 
MasterFrom17: folds 
TURoff: raises 1680 to 3080
AlexeyM43: folds 
Redron86: folds 
Fiura25: calls 3080
Vascaino_017: folds 
Zekko1983: folds 
*** FLOP *** [7c 4h Kc]
TURoff: bets 4918
Fiura25: folds 
Uncalled bet (4918) returned to TURoff
TURoff collected 9835 from pot
TURoff: doesn't show hand 
Zekko1983 has returned
*** SUMMARY ***
Total pot 9835 | Rake 0 
Board [7c 4h Kc]
Seat 1: Zekko1983 (big blind) folded before Flop
Seat 2: APurchart folded before Flop (didn't bet)
Seat 3: PawelSlepzov folded before Flop (didn't bet)
Seat 4: MasterFrom17 folded before Flop (didn't bet)
Seat 5: TURoff collected (9835)
Seat 6: AlexeyM43 folded before Flop (didn't bet)
Seat 7: Redron86 folded before Flop (didn't bet)
Seat 8: Fiura25 (button) folded on the Flop
Seat 9: Vascaino_017 (small blind) folded before Flop





PokerStars Hand #177201146485: Tournament #2067822782, $1.00+$0.10 USD Hold'em No Limit - Level XIX (700/1400) - 2017/10/21 22:13:05 CUST [2017/10/21 14:13:05 ET]
Table '2067822782 27' 9-max Seat #9 is the button
Seat 1: Zekko1983 (104960 in chips) 
Seat 2: APurchart (37748 in chips) 
Seat 3: PawelSlepzov (26640 in chips) 
Seat 4: MasterFrom17 (40627 in chips) 
Seat 5: TURoff (80386 in chips) 
Seat 6: AlexeyM43 (17656 in chips) 
Seat 7: Redron86 (5210 in chips) 
Seat 8: Fiura25 (83056 in chips) 
Seat 9: Vascaino_017 (22488 in chips) 
Zekko1983: posts the ante 175
APurchart: posts the ante 175
PawelSlepzov: posts the ante 175
MasterFrom17: posts the ante 175
TURoff: posts the ante 175
AlexeyM43: posts the ante 175
Redron86: posts the ante 175
Fiura25: posts the ante 175
Vascaino_017: posts the ante 175
Zekko1983: posts small blind 700
APurchart: posts big blind 1400
*** HOLE CARDS ***
Dealt to TURoff [Ts Tc]
PawelSlepzov: folds 
MasterFrom17: calls 1400
TURoff: raises 1680 to 3080
AlexeyM43: folds 
Redron86: folds 
Fiura25: folds 
Vascaino_017: folds 
Zekko1983: calls 2380
APurchart: folds 
MasterFrom17: calls 1680
*** FLOP *** [Td 6c Qs]
Zekko1983: checks 
MasterFrom17: checks 
TURoff: bets 5600
Zekko1983: folds 
MasterFrom17: calls 5600
*** TURN *** [Td 6c Qs] [4h]
MasterFrom17: checks 
TURoff: bets 11200
MasterFrom17: calls 11200
*** RIVER *** [Td 6c Qs 4h] [Qc]
MasterFrom17: checks 
TURoff: bets 22908
MasterFrom17: folds 
Uncalled bet (22908) returned to TURoff
TURoff collected 45815 from pot
TURoff: doesn't show hand 
*** SUMMARY ***
Total pot 45815 | Rake 0 
Board [Td 6c Qs 4h Qc]
Seat 1: Zekko1983 (small blind) folded on the Flop
Seat 2: APurchart (big blind) folded before Flop
Seat 3: PawelSlepzov folded before Flop (didn't bet)
Seat 4: MasterFrom17 folded on the River
Seat 5: TURoff collected (45815)
Seat 6: AlexeyM43 folded before Flop (didn't bet)
Seat 7: Redron86 folded before Flop (didn't bet)
Seat 8: Fiura25 folded before Flop (didn't bet)
Seat 9: Vascaino_017 (button) folded before Flop (didn't bet)





PokerStars Hand #177201189433: Tournament #2067822782, $1.00+$0.10 USD Hold'em No Limit - Level XIX (700/1400) - 2017/10/21 22:14:02 CUST [2017/10/21 14:14:02 ET]
Table '2067822782 27' 9-max Seat #1 is the button
Seat 1: Zekko1983 (101705 in chips) 
Seat 2: APurchart (36173 in chips) 
Seat 3: PawelSlepzov (26465 in chips) 
Seat 4: MasterFrom17 (20572 in chips) 
Seat 5: TURoff (106146 in chips) 
Seat 6: AlexeyM43 (17481 in chips) 
Seat 7: Redron86 (5035 in chips) 
Seat 8: Fiura25 (82881 in chips) 
Seat 9: Vascaino_017 (22313 in chips) 
Zekko1983: posts the ante 175
APurchart: posts the ante 175
PawelSlepzov: posts the ante 175
MasterFrom17: posts the ante 175
TURoff: posts the ante 175
AlexeyM43: posts the ante 175
Redron86: posts the ante 175
Fiura25: posts the ante 175
Vascaino_017: posts the ante 175
APurchart: posts small blind 700
PawelSlepzov: posts big blind 1400
*** HOLE CARDS ***
Dealt to TURoff [5d Kh]
MasterFrom17: calls 1400
TURoff: folds 
AlexeyM43: folds 
Redron86: folds 
Fiura25: folds 
Vascaino_017: folds 
Zekko1983: calls 1400
APurchart: folds 
PawelSlepzov: checks 
*** FLOP *** [Kd 5h 3c]
PawelSlepzov: checks 
MasterFrom17: checks 
Zekko1983: checks 
*** TURN *** [Kd 5h 3c] [Tc]
PawelSlepzov: checks 
MasterFrom17: bets 1400
Zekko1983: folds 
PawelSlepzov: folds 
Uncalled bet (1400) returned to MasterFrom17
MasterFrom17 collected 6475 from pot
*** SUMMARY ***
Total pot 6475 | Rake 0 
Board [Kd 5h 3c Tc]
Seat 1: Zekko1983 (button) folded on the Turn
Seat 2: APurchart (small blind) folded before Flop
Seat 3: PawelSlepzov (big blind) folded on the Turn
Seat 4: MasterFrom17 collected (6475)
Seat 5: TURoff folded before Flop (didn't bet)
Seat 6: AlexeyM43 folded before Flop (didn't bet)
Seat 7: Redron86 folded before Flop (didn't bet)
Seat 8: Fiura25 folded before Flop (didn't bet)
Seat 9: Vascaino_017 folded before Flop (didn't bet)





PokerStars Hand #177201220677: Tournament #2067822782, $1.00+$0.10 USD Hold'em No Limit - Level XIX (700/1400) - 2017/10/21 22:14:43 CUST [2017/10/21 14:14:43 ET]
Table '2067822782 27' 9-max Seat #2 is the button
Seat 1: Zekko1983 (100130 in chips) 
Seat 2: APurchart (35298 in chips) 
Seat 3: PawelSlepzov (24890 in chips) 
Seat 4: MasterFrom17 (25472 in chips) 
Seat 5: TURoff (105971 in chips) 
Seat 6: AlexeyM43 (17306 in chips) 
Seat 7: Redron86 (4860 in chips) 
Seat 8: Fiura25 (82706 in chips) 
Seat 9: Vascaino_017 (22138 in chips) 
Zekko1983: posts the ante 175
APurchart: posts the ante 175
PawelSlepzov: posts the ante 175
MasterFrom17: posts the ante 175
TURoff: posts the ante 175
AlexeyM43: posts the ante 175
Redron86: posts the ante 175
Fiura25: posts the ante 175
Vascaino_017: posts the ante 175
PawelSlepzov: posts small blind 700
MasterFrom17: posts big blind 1400
*** HOLE CARDS ***
Dealt to TURoff [5h 8d]
TURoff: folds 
AlexeyM43: folds 
Redron86: folds 
Fiura25: folds 
Vascaino_017: folds 
Zekko1983: folds 
APurchart: folds 
PawelSlepzov: raises 23315 to 24715 and is all-in
MasterFrom17: calls 23315
*** FLOP *** [5c 7s Ah]
*** TURN *** [5c 7s Ah] [7c]
*** RIVER *** [5c 7s Ah 7c] [Js]
*** SHOW DOWN ***
PawelSlepzov: shows [Qs 9h] (a pair of Sevens)
MasterFrom17: shows [Ks Qd] (a pair of Sevens - Ace+King kicker)
MasterFrom17 collected 51005 from pot
PawelSlepzov finished the tournament in 173rd place and received $3.17.
*** SUMMARY ***
Total pot 51005 | Rake 0 
Board [5c 7s Ah 7c Js]
Seat 1: Zekko1983 folded before Flop (didn't bet)
Seat 2: APurchart (button) folded before Flop (didn't bet)
Seat 3: PawelSlepzov (small blind) showed [Qs 9h] and lost with a pair of Sevens
Seat 4: MasterFrom17 (big blind) showed [Ks Qd] and won (51005) with a pair of Sevens
Seat 5: TURoff folded before Flop (didn't bet)
Seat 6: AlexeyM43 folded before Flop (didn't bet)
Seat 7: Redron86 folded before Flop (didn't bet)
Seat 8: Fiura25 folded before Flop (didn't bet)
Seat 9: Vascaino_017 folded before Flop (didn't bet)





PokerStars Hand #177201258561: Tournament #2067822782, $1.00+$0.10 USD Hold'em No Limit - Level XIX (700/1400) - 2017/10/21 22:15:32 CUST [2017/10/21 14:15:32 ET]
Table '2067822782 27' 9-max Seat #4 is the button
Seat 1: Zekko1983 (99955 in chips) 
Seat 2: APurchart (35123 in chips) 
Seat 4: MasterFrom17 (51587 in chips) 
Seat 5: TURoff (105796 in chips) 
Seat 6: AlexeyM43 (17131 in chips) 
Seat 7: Redron86 (4685 in chips) 
Seat 8: Fiura25 (82531 in chips) 
Seat 9: Vascaino_017 (21963 in chips) 
Zekko1983: posts the ante 175
APurchart: posts the ante 175
MasterFrom17: posts the ante 175
TURoff: posts the ante 175
AlexeyM43: posts the ante 175
Redron86: posts the ante 175
Fiura25: posts the ante 175
Vascaino_017: posts the ante 175
TURoff: posts small blind 700
AlexeyM43: posts big blind 1400
*** HOLE CARDS ***
Dealt to TURoff [7h Th]
Redron86: folds 
Fiura25: folds 
Vascaino_017: folds 
Zekko1983: folds 
APurchart: folds 
MasterFrom17: folds 
TURoff: raises 1680 to 3080
AlexeyM43: folds 
Uncalled bet (1680) returned to TURoff
TURoff collected 4200 from pot
TURoff: doesn't show hand 
*** SUMMARY ***
Total pot 4200 | Rake 0 
Seat 1: Zekko1983 folded before Flop (didn't bet)
Seat 2: APurchart folded before Flop (didn't bet)
Seat 4: MasterFrom17 (button) folded before Flop (didn't bet)
Seat 5: TURoff (small blind) collected (4200)
Seat 6: AlexeyM43 (big blind) folded before Flop
Seat 7: Redron86 folded before Flop (didn't bet)
Seat 8: Fiura25 folded before Flop (didn't bet)
Seat 9: Vascaino_017 folded before Flop (didn't bet)





PokerStars Hand #177201278247: Tournament #2067822782, $1.00+$0.10 USD Hold'em No Limit - Level XIX (700/1400) - 2017/10/21 22:15:58 CUST [2017/10/21 14:15:58 ET]
Table '2067822782 27' 9-max Seat #5 is the button
Seat 1: Zekko1983 (99780 in chips) 
Seat 2: APurchart (34948 in chips) 
Seat 4: MasterFrom17 (51412 in chips) 
Seat 5: TURoff (108421 in chips) 
Seat 6: AlexeyM43 (15556 in chips) 
Seat 7: Redron86 (4510 in chips) 
Seat 8: Fiura25 (82356 in chips) 
Seat 9: Vascaino_017 (21788 in chips) 
Zekko1983: posts the ante 175
APurchart: posts the ante 175
MasterFrom17: posts the ante 175
TURoff: posts the ante 175
AlexeyM43: posts the ante 175
Redron86: posts the ante 175
Fiura25: posts the ante 175
Vascaino_017: posts the ante 175
AlexeyM43: posts small blind 700
Redron86: posts big blind 1400
*** HOLE CARDS ***
Dealt to TURoff [Jh Jc]
Fiura25: folds 
Vascaino_017: folds 
Zekko1983: calls 1400
APurchart: folds 
MasterFrom17: folds 
TURoff: raises 1680 to 3080
AlexeyM43: folds 
Redron86: folds 
Zekko1983: calls 1680
*** FLOP *** [Kc 6d 8c]
Zekko1983: checks 
TURoff: bets 3400
Zekko1983: folds 
Uncalled bet (3400) returned to TURoff
TURoff collected 9660 from pot
TURoff: doesn't show hand 
*** SUMMARY ***
Total pot 9660 | Rake 0 
Board [Kc 6d 8c]
Seat 1: Zekko1983 folded on the Flop
Seat 2: APurchart folded before Flop (didn't bet)
Seat 4: MasterFrom17 folded before Flop (didn't bet)
Seat 5: TURoff (button) collected (9660)
Seat 6: AlexeyM43 (small blind) folded before Flop
Seat 7: Redron86 (big blind) folded before Flop
Seat 8: Fiura25 folded before Flop (didn't bet)
Seat 9: Vascaino_017 folded before Flop (didn't bet)





PokerStars Hand #177201318038: Tournament #2067822782, $1.00+$0.10 USD Hold'em No Limit - Level XIX (700/1400) - 2017/10/21 22:16:50 CUST [2017/10/21 14:16:50 ET]
Table '2067822782 27' 9-max Seat #6 is the button
Seat 1: Zekko1983 (96525 in chips) 
Seat 2: APurchart (34773 in chips) 
Seat 3: Rotti.770 (13654 in chips) 
Seat 4: MasterFrom17 (51237 in chips) 
Seat 5: TURoff (114826 in chips) 
Seat 6: AlexeyM43 (14681 in chips) 
Seat 7: Redron86 (2935 in chips) 
Seat 8: Fiura25 (82181 in chips) 
Seat 9: Vascaino_017 (21613 in chips) 
Zekko1983: posts the ante 175
APurchart: posts the ante 175
Rotti.770: posts the ante 175
MasterFrom17: posts the ante 175
TURoff: posts the ante 175
AlexeyM43: posts the ante 175
Redron86: posts the ante 175
Fiura25: posts the ante 175
Vascaino_017: posts the ante 175
Redron86: posts small blind 700
Fiura25: posts big blind 1400
*** HOLE CARDS ***
Dealt to TURoff [6c 9d]
Vascaino_017: folds 
Zekko1983: calls 1400
APurchart: folds 
Rotti.770: calls 1400
MasterFrom17: calls 1400
TURoff: folds 
AlexeyM43: folds 
Redron86: folds 
Fiura25: checks 
*** FLOP *** [7h Ac 4h]
Fiura25: checks 
Zekko1983: checks 
Rotti.770: checks 
MasterFrom17 is disconnected 
MasterFrom17 has timed out while disconnected
MasterFrom17: checks 
*** TURN *** [7h Ac 4h] [2d]
Fiura25: checks 
Zekko1983: checks 
Rotti.770: bets 1400
MasterFrom17: calls 1400
Fiura25: folds 
Zekko1983: folds 
*** RIVER *** [7h Ac 4h 2d] [Jd]
Rotti.770: checks 
MasterFrom17: checks 
*** SHOW DOWN ***
Rotti.770: shows [7s 8c] (a pair of Sevens)
MasterFrom17: shows [As 5c] (a pair of Aces)
MasterFrom17 collected 10675 from pot
*** SUMMARY ***
Total pot 10675 | Rake 0 
Board [7h Ac 4h 2d Jd]
Seat 1: Zekko1983 folded on the Turn
Seat 2: APurchart folded before Flop (didn't bet)
Seat 3: Rotti.770 showed [7s 8c] and lost with a pair of Sevens
Seat 4: MasterFrom17 showed [As 5c] and won (10675) with a pair of Aces
Seat 5: TURoff folded before Flop (didn't bet)
Seat 6: AlexeyM43 (button) folded before Flop (didn't bet)
Seat 7: Redron86 (small blind) folded before Flop
Seat 8: Fiura25 (big blind) folded on the Turn
Seat 9: Vascaino_017 folded before Flop (didn't bet)





PokerStars Hand #177201402359: Tournament #2067822782, $1.00+$0.10 USD Hold'em No Limit - Level XX (800/1600) - 2017/10/21 22:18:40 CUST [2017/10/21 14:18:40 ET]
Table '2067822782 27' 9-max Seat #7 is the button
Seat 1: Zekko1983 (94950 in chips) 
Seat 2: APurchart (34598 in chips) 
Seat 3: Rotti.770 (10679 in chips) 
Seat 4: MasterFrom17 (58937 in chips) 
Seat 5: TURoff (114651 in chips) 
Seat 6: AlexeyM43 (14506 in chips) 
Seat 7: Redron86 (2060 in chips) 
Seat 8: Fiura25 (80606 in chips) 
Seat 9: Vascaino_017 (21438 in chips) 
Zekko1983: posts the ante 200
APurchart: posts the ante 200
Rotti.770: posts the ante 200
MasterFrom17: posts the ante 200
TURoff: posts the ante 200
AlexeyM43: posts the ante 200
Redron86: posts the ante 200
Fiura25: posts the ante 200
Vascaino_017: posts the ante 200
Fiura25: posts small blind 800
Vascaino_017: posts big blind 1600
*** HOLE CARDS ***
Dealt to TURoff [Kh 2d]
Zekko1983: calls 1600
APurchart: folds 
Rotti.770: folds 
MasterFrom17: folds 
TURoff: folds 
AlexeyM43: calls 1600
Redron86: folds 
Fiura25: calls 800
Vascaino_017: raises 19638 to 21238 and is all-in
Zekko1983: folds 
AlexeyM43: folds 
Fiura25: folds 
Uncalled bet (19638) returned to Vascaino_017
Vascaino_017 collected 8200 from pot
Vascaino_017: doesn't show hand 
*** SUMMARY ***
Total pot 8200 | Rake 0 
Seat 1: Zekko1983 folded before Flop
Seat 2: APurchart folded before Flop (didn't bet)
Seat 3: Rotti.770 folded before Flop (didn't bet)
Seat 4: MasterFrom17 folded before Flop (didn't bet)
Seat 5: TURoff folded before Flop (didn't bet)
Seat 6: AlexeyM43 folded before Flop
Seat 7: Redron86 (button) folded before Flop (didn't bet)
Seat 8: Fiura25 (small blind) folded before Flop
Seat 9: Vascaino_017 (big blind) collected (8200)





PokerStars Hand #177201445546: Tournament #2067822782, $1.00+$0.10 USD Hold'em No Limit - Level XX (800/1600) - 2017/10/21 22:19:35 CUST [2017/10/21 14:19:35 ET]
Table '2067822782 27' 9-max Seat #8 is the button
Seat 1: Zekko1983 (93150 in chips) 
Seat 2: APurchart (34398 in chips) 
Seat 3: Rotti.770 (10479 in chips) 
Seat 4: MasterFrom17 (58737 in chips) 
Seat 5: TURoff (114451 in chips) 
Seat 6: AlexeyM43 (12706 in chips) 
Seat 7: Redron86 (1860 in chips) 
Seat 8: Fiura25 (78806 in chips) 
Seat 9: Vascaino_017 (27838 in chips) 
Zekko1983: posts the ante 200
APurchart: posts the ante 200
Rotti.770: posts the ante 200
MasterFrom17: posts the ante 200
TURoff: posts the ante 200
AlexeyM43: posts the ante 200
Redron86: posts the ante 200
Fiura25: posts the ante 200
Vascaino_017: posts the ante 200
Vascaino_017: posts small blind 800
Zekko1983: posts big blind 1600
*** HOLE CARDS ***
Dealt to TURoff [8d 4c]
APurchart: folds 
Rotti.770: folds 
MasterFrom17: folds 
TURoff: folds 
AlexeyM43: folds 
Redron86: calls 1600
Fiura25: folds 
Vascaino_017: raises 6600 to 8200
Zekko1983: folds 
Redron86: calls 60 and is all-in
Uncalled bet (6540) returned to Vascaino_017
*** FLOP *** [As Ad Ac]
*** TURN *** [As Ad Ac] [3h]
*** RIVER *** [As Ad Ac 3h] [5d]
*** SHOW DOWN ***
Vascaino_017: shows [9h 9d] (a full house, Aces full of Nines)
Redron86: shows [Tc Td] (a full house, Aces full of Tens)
Redron86 collected 6720 from pot
*** SUMMARY ***
Total pot 6720 | Rake 0 
Board [As Ad Ac 3h 5d]
Seat 1: Zekko1983 (big blind) folded before Flop
Seat 2: APurchart folded before Flop (didn't bet)
Seat 3: Rotti.770 folded before Flop (didn't bet)
Seat 4: MasterFrom17 folded before Flop (didn't bet)
Seat 5: TURoff folded before Flop (didn't bet)
Seat 6: AlexeyM43 folded before Flop (didn't bet)
Seat 7: Redron86 showed [Tc Td] and won (6720) with a full house, Aces full of Tens
Seat 8: Fiura25 (button) folded before Flop (didn't bet)
Seat 9: Vascaino_017 (small blind) showed [9h 9d] and lost with a full house, Aces full of Nines





PokerStars Hand #177201482563: Tournament #2067822782, $1.00+$0.10 USD Hold'em No Limit - Level XX (800/1600) - 2017/10/21 22:20:23 CUST [2017/10/21 14:20:23 ET]
Table '2067822782 27' 9-max Seat #9 is the button
Seat 1: Zekko1983 (91350 in chips) 
Seat 2: APurchart (34198 in chips) 
Seat 3: Rotti.770 (10279 in chips) 
Seat 4: MasterFrom17 (58537 in chips) 
Seat 5: TURoff (114251 in chips) 
Seat 6: AlexeyM43 (12506 in chips) 
Seat 7: Redron86 (6720 in chips) 
Seat 8: Fiura25 (78606 in chips) 
Seat 9: Vascaino_017 (25978 in chips) 
Zekko1983: posts the ante 200
APurchart: posts the ante 200
Rotti.770: posts the ante 200
MasterFrom17: posts the ante 200
TURoff: posts the ante 200
AlexeyM43: posts the ante 200
Redron86: posts the ante 200
Fiura25: posts the ante 200
Vascaino_017: posts the ante 200
Zekko1983: posts small blind 800
APurchart: posts big blind 1600
*** HOLE CARDS ***
Dealt to TURoff [6d Ks]
Rotti.770: calls 1600
MasterFrom17: folds 
TURoff: folds 
AlexeyM43: folds 
Redron86: folds 
Fiura25: folds 
Vascaino_017: folds 
Zekko1983: folds 
APurchart: checks 
*** FLOP *** [Qs 8s Qh]
APurchart: checks 
Rotti.770: checks 
*** TURN *** [Qs 8s Qh] [4h]
APurchart: checks 
Rotti.770: bets 1600
APurchart: folds 
Uncalled bet (1600) returned to Rotti.770
Rotti.770 collected 5800 from pot
Rotti.770: doesn't show hand 
*** SUMMARY ***
Total pot 5800 | Rake 0 
Board [Qs 8s Qh 4h]
Seat 1: Zekko1983 (small blind) folded before Flop
Seat 2: APurchart (big blind) folded on the Turn
Seat 3: Rotti.770 collected (5800)
Seat 4: MasterFrom17 folded before Flop (didn't bet)
Seat 5: TURoff folded before Flop (didn't bet)
Seat 6: AlexeyM43 folded before Flop (didn't bet)
Seat 7: Redron86 folded before Flop (didn't bet)
Seat 8: Fiura25 folded before Flop (didn't bet)
Seat 9: Vascaino_017 (button) folded before Flop (didn't bet)





PokerStars Hand #177201515134: Tournament #2067822782, $1.00+$0.10 USD Hold'em No Limit - Level XX (800/1600) - 2017/10/21 22:21:05 CUST [2017/10/21 14:21:05 ET]
Table '2067822782 27' 9-max Seat #1 is the button
Seat 1: Zekko1983 (90350 in chips) 
Seat 2: APurchart (32398 in chips) 
Seat 3: Rotti.770 (14279 in chips) 
Seat 4: MasterFrom17 (58337 in chips) 
Seat 5: TURoff (114051 in chips) 
Seat 6: AlexeyM43 (12306 in chips) 
Seat 7: Redron86 (6520 in chips) 
Seat 8: Fiura25 (78406 in chips) 
Seat 9: Vascaino_017 (25778 in chips) 
Zekko1983: posts the ante 200
APurchart: posts the ante 200
Rotti.770: posts the ante 200
MasterFrom17: posts the ante 200
TURoff: posts the ante 200
AlexeyM43: posts the ante 200
Redron86: posts the ante 200
Fiura25: posts the ante 200
Vascaino_017: posts the ante 200
APurchart: posts small blind 800
Rotti.770: posts big blind 1600
*** HOLE CARDS ***
Dealt to TURoff [9s 9d]
MasterFrom17: folds 
TURoff: raises 1920 to 3520
AlexeyM43: folds 
Redron86: folds 
Fiura25: folds 
Vascaino_017: folds 
Zekko1983: calls 3520
APurchart: raises 28678 to 32198 and is all-in
Rotti.770: calls 12479 and is all-in
TURoff: folds 
Zekko1983: calls 28678
*** FLOP *** [5d 3s 2d]
*** TURN *** [5d 3s 2d] [9c]
*** RIVER *** [5d 3s 2d 9c] [5s]
*** SHOW DOWN ***
APurchart: shows [Ac Ah] (two pair, Aces and Fives)
Zekko1983: shows [Jd Ad] (a pair of Fives)
APurchart collected 36238 from side pot
Rotti.770: shows [Th Jh] (a pair of Fives)
APurchart collected 47557 from main pot
Rotti.770 finished the tournament in 154th place and received $3.17.
*** SUMMARY ***
Total pot 83795 Main pot 47557. Side pot 36238. | Rake 0 
Board [5d 3s 2d 9c 5s]
Seat 1: Zekko1983 (button) showed [Jd Ad] and lost with a pair of Fives
Seat 2: APurchart (small blind) showed [Ac Ah] and won (83795) with two pair, Aces and Fives
Seat 3: Rotti.770 (big blind) showed [Th Jh] and lost with a pair of Fives
Seat 4: MasterFrom17 folded before Flop (didn't bet)
Seat 5: TURoff folded before Flop
Seat 6: AlexeyM43 folded before Flop (didn't bet)
Seat 7: Redron86 folded before Flop (didn't bet)
Seat 8: Fiura25 folded before Flop (didn't bet)
Seat 9: Vascaino_017 folded before Flop (didn't bet)





PokerStars Hand #177201580408: Tournament #2067822782, $1.00+$0.10 USD Hold'em No Limit - Level XX (800/1600) - 2017/10/21 22:22:29 CUST [2017/10/21 14:22:29 ET]
Table '2067822782 63' 9-max Seat #6 is the button
Seat 1: AVG3625 (93405 in chips) 
Seat 2: ZAN ua (44760 in chips) 
Seat 3: studen6 (41818 in chips) 
Seat 4: ferraresi81 (29180 in chips) 
Seat 5: rikyrb (73675 in chips) 
Seat 6: shaneita (19965 in chips) 
Seat 7: scorpoli (49449 in chips) 
Seat 8: TURoff (110331 in chips) 
Seat 9: olya 01rus (16352 in chips) is sitting out
AVG3625: posts the ante 200
ZAN ua: posts the ante 200
studen6: posts the ante 200
ferraresi81: posts the ante 200
rikyrb: posts the ante 200
shaneita: posts the ante 200
scorpoli: posts the ante 200
TURoff: posts the ante 200
olya 01rus: posts the ante 200
scorpoli: posts small blind 800
TURoff: posts big blind 1600
*** HOLE CARDS ***
Dealt to TURoff [6d 9d]
olya 01rus: folds 
AVG3625: folds 
ZAN ua: folds 
olya 01rus has returned
studen6: folds 
ferraresi81: folds 
rikyrb: raises 1600 to 3200
shaneita: folds 
scorpoli: folds 
TURoff: calls 1600
*** FLOP *** [4c Jd Kc]
TURoff: checks 
rikyrb: bets 3200
TURoff: folds 
Uncalled bet (3200) returned to rikyrb
rikyrb collected 9000 from pot
*** SUMMARY ***
Total pot 9000 | Rake 0 
Board [4c Jd Kc]
Seat 1: AVG3625 folded before Flop (didn't bet)
Seat 2: ZAN ua folded before Flop (didn't bet)
Seat 3: studen6 folded before Flop (didn't bet)
Seat 4: ferraresi81 folded before Flop (didn't bet)
Seat 5: rikyrb collected (9000)
Seat 6: shaneita (button) folded before Flop (didn't bet)
Seat 7: scorpoli (small blind) folded before Flop
Seat 8: TURoff (big blind) folded on the Flop
Seat 9: olya 01rus folded before Flop (didn't bet)





PokerStars Hand #177201606798: Tournament #2067822782, $1.00+$0.10 USD Hold'em No Limit - Level XX (800/1600) - 2017/10/21 22:23:04 CUST [2017/10/21 14:23:04 ET]
Table '2067822782 63' 9-max Seat #7 is the button
Seat 1: AVG3625 (93205 in chips) 
Seat 2: ZAN ua (44560 in chips) 
Seat 3: studen6 (41618 in chips) 
Seat 4: ferraresi81 (28980 in chips) 
Seat 5: rikyrb (79275 in chips) 
Seat 6: shaneita (19765 in chips) 
Seat 7: scorpoli (48449 in chips) 
Seat 8: TURoff (106931 in chips) 
Seat 9: olya 01rus (16152 in chips) 
AVG3625: posts the ante 200
ZAN ua: posts the ante 200
studen6: posts the ante 200
ferraresi81: posts the ante 200
rikyrb: posts the ante 200
shaneita: posts the ante 200
scorpoli: posts the ante 200
TURoff: posts the ante 200
olya 01rus: posts the ante 200
TURoff: posts small blind 800
olya 01rus: posts big blind 1600
*** HOLE CARDS ***
Dealt to TURoff [5c 9s]
AVG3625: raises 1600 to 3200
ZAN ua: folds 
studen6: folds 
ferraresi81: folds 
rikyrb: folds 
shaneita: folds 
scorpoli: raises 45049 to 48249 and is all-in
TURoff: folds 
olya 01rus: folds 
AVG3625: folds 
Uncalled bet (45049) returned to scorpoli
scorpoli collected 10600 from pot
scorpoli: doesn't show hand 
*** SUMMARY ***
Total pot 10600 | Rake 0 
Seat 1: AVG3625 folded before Flop
Seat 2: ZAN ua folded before Flop (didn't bet)
Seat 3: studen6 folded before Flop (didn't bet)
Seat 4: ferraresi81 folded before Flop (didn't bet)
Seat 5: rikyrb folded before Flop (didn't bet)
Seat 6: shaneita folded before Flop (didn't bet)
Seat 7: scorpoli (button) collected (10600)
Seat 8: TURoff (small blind) folded before Flop
Seat 9: olya 01rus (big blind) folded before Flop





PokerStars Hand #177201631968: Tournament #2067822782, $1.00+$0.10 USD Hold'em No Limit - Level XX (800/1600) - 2017/10/21 22:23:36 CUST [2017/10/21 14:23:36 ET]
Table '2067822782 63' 9-max Seat #8 is the button
Seat 1: AVG3625 (89805 in chips) 
Seat 2: ZAN ua (44360 in chips) 
Seat 3: studen6 (41418 in chips) 
Seat 4: ferraresi81 (28780 in chips) 
Seat 5: rikyrb (79075 in chips) 
Seat 6: shaneita (19565 in chips) 
Seat 7: scorpoli (55649 in chips) 
Seat 8: TURoff (105931 in chips) 
Seat 9: olya 01rus (14352 in chips) 
AVG3625: posts the ante 200
ZAN ua: posts the ante 200
studen6: posts the ante 200
ferraresi81: posts the ante 200
rikyrb: posts the ante 200
shaneita: posts the ante 200
scorpoli: posts the ante 200
TURoff: posts the ante 200
olya 01rus: posts the ante 200
olya 01rus: posts small blind 800
AVG3625: posts big blind 1600
*** HOLE CARDS ***
Dealt to TURoff [9s Kh]
ZAN ua: folds 
studen6: folds 
ferraresi81: folds 
rikyrb: raises 1600 to 3200
shaneita: folds 
scorpoli: folds 
TURoff: folds 
olya 01rus: raises 1600 to 4800
AVG3625: folds 
rikyrb: calls 1600
*** FLOP *** [7h 2s Qs]
olya 01rus: bets 9352 and is all-in
rikyrb: calls 9352
*** TURN *** [7h 2s Qs] [4s]
*** RIVER *** [7h 2s Qs 4s] [9h]
*** SHOW DOWN ***
olya 01rus: shows [Ah 7d] (a pair of Sevens)
rikyrb: shows [Ac Ks] (high card Ace)
olya 01rus collected 31704 from pot
*** SUMMARY ***
Total pot 31704 | Rake 0 
Board [7h 2s Qs 4s 9h]
Seat 1: AVG3625 (big blind) folded before Flop
Seat 2: ZAN ua folded before Flop (didn't bet)
Seat 3: studen6 folded before Flop (didn't bet)
Seat 4: ferraresi81 folded before Flop (didn't bet)
Seat 5: rikyrb showed [Ac Ks] and lost with high card Ace
Seat 6: shaneita folded before Flop (didn't bet)
Seat 7: scorpoli folded before Flop (didn't bet)
Seat 8: TURoff (button) folded before Flop (didn't bet)
Seat 9: olya 01rus (small blind) showed [Ah 7d] and won (31704) with a pair of Sevens





PokerStars Hand #177201660398: Tournament #2067822782, $1.00+$0.10 USD Hold'em No Limit - Level XX (800/1600) - 2017/10/21 22:24:13 CUST [2017/10/21 14:24:13 ET]
Table '2067822782 63' 9-max Seat #9 is the button
Seat 1: AVG3625 (88005 in chips) 
Seat 2: ZAN ua (44160 in chips) 
Seat 3: studen6 (41218 in chips) 
Seat 4: ferraresi81 (28580 in chips) 
Seat 5: rikyrb (64723 in chips) 
Seat 6: shaneita (19365 in chips) 
Seat 7: scorpoli (55449 in chips) 
Seat 8: TURoff (105731 in chips) 
Seat 9: olya 01rus (31704 in chips) 
AVG3625: posts the ante 200
ZAN ua: posts the ante 200
studen6: posts the ante 200
ferraresi81: posts the ante 200
rikyrb: posts the ante 200
shaneita: posts the ante 200
scorpoli: posts the ante 200
TURoff: posts the ante 200
olya 01rus: posts the ante 200
AVG3625: posts small blind 800
ZAN ua: posts big blind 1600
*** HOLE CARDS ***
Dealt to TURoff [7d 6d]
studen6: folds 
ferraresi81: folds 
rikyrb: folds 
shaneita: folds 
scorpoli: folds 
TURoff: raises 1920 to 3520
olya 01rus: folds 
AVG3625: folds 
ZAN ua: calls 1920
*** FLOP *** [4h 6s 4s]
ZAN ua: checks 
TURoff: bets 3200
ZAN ua: folds 
Uncalled bet (3200) returned to TURoff
TURoff collected 9640 from pot
TURoff: doesn't show hand 
*** SUMMARY ***
Total pot 9640 | Rake 0 
Board [4h 6s 4s]
Seat 1: AVG3625 (small blind) folded before Flop
Seat 2: ZAN ua (big blind) folded on the Flop
Seat 3: studen6 folded before Flop (didn't bet)
Seat 4: ferraresi81 folded before Flop (didn't bet)
Seat 5: rikyrb folded before Flop (didn't bet)
Seat 6: shaneita folded before Flop (didn't bet)
Seat 7: scorpoli folded before Flop (didn't bet)
Seat 8: TURoff collected (9640)
Seat 9: olya 01rus (button) folded before Flop (didn't bet)





PokerStars Hand #177201688619: Tournament #2067822782, $1.00+$0.10 USD Hold'em No Limit - Level XX (800/1600) - 2017/10/21 22:24:49 CUST [2017/10/21 14:24:49 ET]
Table '2067822782 63' 9-max Seat #1 is the button
Seat 1: AVG3625 (87005 in chips) 
Seat 2: ZAN ua (40440 in chips) 
Seat 3: studen6 (41018 in chips) 
Seat 4: ferraresi81 (28380 in chips) 
Seat 5: rikyrb (64523 in chips) 
Seat 6: shaneita (19165 in chips) 
Seat 7: scorpoli (55249 in chips) 
Seat 8: TURoff (111651 in chips) 
Seat 9: olya 01rus (31504 in chips) 
AVG3625: posts the ante 200
ZAN ua: posts the ante 200
studen6: posts the ante 200
ferraresi81: posts the ante 200
rikyrb: posts the ante 200
shaneita: posts the ante 200
scorpoli: posts the ante 200
TURoff: posts the ante 200
olya 01rus: posts the ante 200
ZAN ua: posts small blind 800
studen6: posts big blind 1600
*** HOLE CARDS ***
Dealt to TURoff [5c Td]
ferraresi81: folds 
rikyrb: folds 
shaneita: folds 
scorpoli: folds 
TURoff: folds 
olya 01rus: calls 1600
AVG3625: folds 
ZAN ua: raises 3200 to 4800
studen6: raises 8000 to 12800
olya 01rus: folds 
ZAN ua: raises 8000 to 20800
studen6: raises 20018 to 40818 and is all-in
ZAN ua: calls 19440 and is all-in
Uncalled bet (578) returned to studen6
*** FLOP *** [7c Ad 2h]
*** TURN *** [7c Ad 2h] [4c]
*** RIVER *** [7c Ad 2h 4c] [2c]
*** SHOW DOWN ***
ZAN ua: shows [As Ac] (a full house, Aces full of Deuces)
studen6: shows [Kh Kd] (two pair, Kings and Deuces)
ZAN ua collected 83880 from pot
*** SUMMARY ***
Total pot 83880 | Rake 0 
Board [7c Ad 2h 4c 2c]
Seat 1: AVG3625 (button) folded before Flop (didn't bet)
Seat 2: ZAN ua (small blind) showed [As Ac] and won (83880) with a full house, Aces full of Deuces
Seat 3: studen6 (big blind) showed [Kh Kd] and lost with two pair, Kings and Deuces
Seat 4: ferraresi81 folded before Flop (didn't bet)
Seat 5: rikyrb folded before Flop (didn't bet)
Seat 6: shaneita folded before Flop (didn't bet)
Seat 7: scorpoli folded before Flop (didn't bet)
Seat 8: TURoff folded before Flop (didn't bet)
Seat 9: olya 01rus folded before Flop





PokerStars Hand #177201742561: Tournament #2067822782, $1.00+$0.10 USD Hold'em No Limit - Level XX (800/1600) - 2017/10/21 22:25:59 CUST [2017/10/21 14:25:59 ET]
Table '2067822782 63' 9-max Seat #2 is the button
Seat 1: AVG3625 (86805 in chips) 
Seat 2: ZAN ua (83880 in chips) 
Seat 3: studen6 (578 in chips) 
Seat 4: ferraresi81 (28180 in chips) 
Seat 5: rikyrb (64323 in chips) 
Seat 6: shaneita (18965 in chips) 
Seat 7: scorpoli (55049 in chips) 
Seat 8: TURoff (111451 in chips) 
Seat 9: olya 01rus (29704 in chips) 
AVG3625: posts the ante 200
ZAN ua: posts the ante 200
studen6: posts the ante 200
ferraresi81: posts the ante 200
rikyrb: posts the ante 200
shaneita: posts the ante 200
scorpoli: posts the ante 200
TURoff: posts the ante 200
olya 01rus: posts the ante 200
studen6: posts small blind 378 and is all-in
ferraresi81: posts big blind 1600
*** HOLE CARDS ***
Dealt to TURoff [6h 3c]
rikyrb: folds 
shaneita: folds 
scorpoli: folds 
TURoff: folds 
olya 01rus: folds 
AVG3625: raises 1600 to 3200
ZAN ua: folds 
ferraresi81: raises 24780 to 27980 and is all-in
AVG3625: folds 
Uncalled bet (24780) returned to ferraresi81
*** FLOP *** [9s 5s 5h]
*** TURN *** [9s 5s 5h] [Qc]
*** RIVER *** [9s 5s 5h Qc] [6s]
*** SHOW DOWN ***
ferraresi81: shows [As Td] (a pair of Fives)
ferraresi81 collected 5644 from side pot
studen6: shows [2h 9d] (two pair, Nines and Fives)
studen6 collected 2934 from main pot
*** SUMMARY ***
Total pot 8578 Main pot 2934. Side pot 5644. | Rake 0 
Board [9s 5s 5h Qc 6s]
Seat 1: AVG3625 folded before Flop
Seat 2: ZAN ua (button) folded before Flop (didn't bet)
Seat 3: studen6 (small blind) showed [2h 9d] and won (2934) with two pair, Nines and Fives
Seat 4: ferraresi81 (big blind) showed [As Td] and won (5644) with a pair of Fives
Seat 5: rikyrb folded before Flop (didn't bet)
Seat 6: shaneita folded before Flop (didn't bet)
Seat 7: scorpoli folded before Flop (didn't bet)
Seat 8: TURoff folded before Flop (didn't bet)
Seat 9: olya 01rus folded before Flop (didn't bet)





PokerStars Hand #177201793754: Tournament #2067822782, $1.00+$0.10 USD Hold'em No Limit - Level XX (800/1600) - 2017/10/21 22:27:05 CUST [2017/10/21 14:27:05 ET]
Table '2067822782 63' 9-max Seat #3 is the button
Seat 1: AVG3625 (83405 in chips) 
Seat 2: ZAN ua (83680 in chips) 
Seat 3: studen6 (2934 in chips) 
Seat 4: ferraresi81 (30424 in chips) 
Seat 5: rikyrb (64123 in chips) 
Seat 6: shaneita (18765 in chips) 
Seat 7: scorpoli (54849 in chips) 
Seat 8: TURoff (111251 in chips) 
Seat 9: olya 01rus (29504 in chips) 
AVG3625: posts the ante 200
ZAN ua: posts the ante 200
studen6: posts the ante 200
ferraresi81: posts the ante 200
rikyrb: posts the ante 200
shaneita: posts the ante 200
scorpoli: posts the ante 200
TURoff: posts the ante 200
olya 01rus: posts the ante 200
ferraresi81: posts small blind 800
rikyrb: posts big blind 1600
*** HOLE CARDS ***
Dealt to TURoff [5c 3h]
shaneita: folds 
scorpoli: folds 
TURoff: folds 
olya 01rus: raises 27704 to 29304 and is all-in
AVG3625: folds 
ZAN ua: folds 
studen6: calls 2734 and is all-in
ferraresi81: folds 
rikyrb: folds 
Uncalled bet (26570) returned to olya 01rus
*** FLOP *** [4d Kc 3c]
*** TURN *** [4d Kc 3c] [Jd]
*** RIVER *** [4d Kc 3c Jd] [4h]
*** SHOW DOWN ***
olya 01rus: shows [Tc Td] (two pair, Tens and Fours)
studen6: shows [Js 9s] (two pair, Jacks and Fours)
studen6 collected 9668 from pot
*** SUMMARY ***
Total pot 9668 | Rake 0 
Board [4d Kc 3c Jd 4h]
Seat 1: AVG3625 folded before Flop (didn't bet)
Seat 2: ZAN ua folded before Flop (didn't bet)
Seat 3: studen6 (button) showed [Js 9s] and won (9668) with two pair, Jacks and Fours
Seat 4: ferraresi81 (small blind) folded before Flop
Seat 5: rikyrb (big blind) folded before Flop
Seat 6: shaneita folded before Flop (didn't bet)
Seat 7: scorpoli folded before Flop (didn't bet)
Seat 8: TURoff folded before Flop (didn't bet)
Seat 9: olya 01rus showed [Tc Td] and lost with two pair, Tens and Fours





PokerStars Hand #177201870119: Tournament #2067822782, $1.00+$0.10 USD Hold'em No Limit - Level XXI (900/1800) - 2017/10/21 22:28:45 CUST [2017/10/21 14:28:45 ET]
Table '2067822782 63' 9-max Seat #4 is the button
Seat 1: AVG3625 (83205 in chips) 
Seat 2: ZAN ua (83480 in chips) 
Seat 3: studen6 (9668 in chips) 
Seat 4: ferraresi81 (29424 in chips) 
Seat 5: rikyrb (62323 in chips) 
Seat 6: shaneita (18565 in chips) 
Seat 7: scorpoli (54649 in chips) 
Seat 8: TURoff (111051 in chips) 
Seat 9: olya 01rus (26570 in chips) 
AVG3625: posts the ante 225
ZAN ua: posts the ante 225
studen6: posts the ante 225
ferraresi81: posts the ante 225
rikyrb: posts the ante 225
shaneita: posts the ante 225
scorpoli: posts the ante 225
TURoff: posts the ante 225
olya 01rus: posts the ante 225
rikyrb: posts small blind 900
shaneita: posts big blind 1800
*** HOLE CARDS ***
Dealt to TURoff [7h Js]
scorpoli: folds 
TURoff: folds 
olya 01rus: folds 
AVG3625: raises 1800 to 3600
ZAN ua: folds 
studen6: folds 
ferraresi81: folds 
rikyrb: folds 
shaneita: folds 
Uncalled bet (1800) returned to AVG3625
AVG3625 collected 6525 from pot
AVG3625: doesn't show hand 
*** SUMMARY ***
Total pot 6525 | Rake 0 
Seat 1: AVG3625 collected (6525)
Seat 2: ZAN ua folded before Flop (didn't bet)
Seat 3: studen6 folded before Flop (didn't bet)
Seat 4: ferraresi81 (button) folded before Flop (didn't bet)
Seat 5: rikyrb (small blind) folded before Flop
Seat 6: shaneita (big blind) folded before Flop
Seat 7: scorpoli folded before Flop (didn't bet)
Seat 8: TURoff folded before Flop (didn't bet)
Seat 9: olya 01rus folded before Flop (didn't bet)





PokerStars Hand #177201893532: Tournament #2067822782, $1.00+$0.10 USD Hold'em No Limit - Level XXI (900/1800) - 2017/10/21 22:29:15 CUST [2017/10/21 14:29:15 ET]
Table '2067822782 63' 9-max Seat #5 is the button
Seat 1: AVG3625 (87705 in chips) 
Seat 2: ZAN ua (83255 in chips) 
Seat 3: studen6 (9443 in chips) 
Seat 4: ferraresi81 (29199 in chips) 
Seat 5: rikyrb (61198 in chips) 
Seat 6: shaneita (16540 in chips) 
Seat 7: scorpoli (54424 in chips) 
Seat 8: TURoff (110826 in chips) 
Seat 9: olya 01rus (26345 in chips) 
AVG3625: posts the ante 225
ZAN ua: posts the ante 225
studen6: posts the ante 225
ferraresi81: posts the ante 225
rikyrb: posts the ante 225
shaneita: posts the ante 225
scorpoli: posts the ante 225
TURoff: posts the ante 225
olya 01rus: posts the ante 225
shaneita: posts small blind 900
scorpoli: posts big blind 1800
*** HOLE CARDS ***
Dealt to TURoff [7s 2h]
TURoff: folds 
olya 01rus: folds 
AVG3625: raises 1800 to 3600
ZAN ua: raises 5400 to 9000
studen6: folds 
ferraresi81: folds 
rikyrb: folds 
shaneita: folds 
scorpoli: folds 
AVG3625: folds 
Uncalled bet (5400) returned to ZAN ua
ZAN ua collected 11925 from pot
ZAN ua: doesn't show hand 
*** SUMMARY ***
Total pot 11925 | Rake 0 
Seat 1: AVG3625 folded before Flop
Seat 2: ZAN ua collected (11925)
Seat 3: studen6 folded before Flop (didn't bet)
Seat 4: ferraresi81 folded before Flop (didn't bet)
Seat 5: rikyrb (button) folded before Flop (didn't bet)
Seat 6: shaneita (small blind) folded before Flop
Seat 7: scorpoli (big blind) folded before Flop
Seat 8: TURoff folded before Flop (didn't bet)
Seat 9: olya 01rus folded before Flop (didn't bet)





PokerStars Hand #177201953850: Tournament #2067822782, $1.00+$0.10 USD Hold'em No Limit - Level XXI (900/1800) - 2017/10/21 22:30:32 CUST [2017/10/21 14:30:32 ET]
Table '2067822782 63' 9-max Seat #6 is the button
Seat 1: AVG3625 (83880 in chips) 
Seat 2: ZAN ua (91355 in chips) 
Seat 3: studen6 (9218 in chips) 
Seat 4: ferraresi81 (28974 in chips) 
Seat 5: rikyrb (60973 in chips) 
Seat 6: shaneita (15415 in chips) 
Seat 7: scorpoli (52399 in chips) 
Seat 8: TURoff (110601 in chips) 
Seat 9: olya 01rus (26120 in chips) 
AVG3625: posts the ante 225
ZAN ua: posts the ante 225
studen6: posts the ante 225
ferraresi81: posts the ante 225
rikyrb: posts the ante 225
shaneita: posts the ante 225
scorpoli: posts the ante 225
TURoff: posts the ante 225
olya 01rus: posts the ante 225
scorpoli: posts small blind 900
TURoff: posts big blind 1800
*** HOLE CARDS ***
Dealt to TURoff [Jc 4c]
olya 01rus: folds 
AVG3625: raises 1800 to 3600
ZAN ua: calls 3600
studen6: folds 
ferraresi81: folds 
rikyrb: calls 3600
shaneita: folds 
scorpoli: calls 2700
TURoff: calls 1800
*** FLOP *** [Kc Qd 6s]
scorpoli: checks 
TURoff: checks 
AVG3625: checks 
ZAN ua: checks 
rikyrb: checks 
*** TURN *** [Kc Qd 6s] [5c]
scorpoli: checks 
TURoff: checks 
AVG3625: checks 
ZAN ua: bets 3600
rikyrb: calls 3600
scorpoli: folds 
TURoff: folds 
AVG3625: folds 
*** RIVER *** [Kc Qd 6s 5c] [Qh]
ZAN ua: checks 
rikyrb: bets 13613
ZAN ua: folds 
Uncalled bet (13613) returned to rikyrb
rikyrb collected 27225 from pot
*** SUMMARY ***
Total pot 27225 | Rake 0 
Board [Kc Qd 6s 5c Qh]
Seat 1: AVG3625 folded on the Turn
Seat 2: ZAN ua folded on the River
Seat 3: studen6 folded before Flop (didn't bet)
Seat 4: ferraresi81 folded before Flop (didn't bet)
Seat 5: rikyrb collected (27225)
Seat 6: shaneita (button) folded before Flop (didn't bet)
Seat 7: scorpoli (small blind) folded on the Turn
Seat 8: TURoff (big blind) folded on the Turn
Seat 9: olya 01rus folded before Flop (didn't bet)





PokerStars Hand #177202058828: Tournament #2067822782, $1.00+$0.10 USD Hold'em No Limit - Level XXI (900/1800) - 2017/10/21 22:32:48 CUST [2017/10/21 14:32:48 ET]
Table '2067822782 63' 9-max Seat #7 is the button
Seat 1: AVG3625 (80055 in chips) 
Seat 2: ZAN ua (83930 in chips) 
Seat 3: studen6 (8993 in chips) 
Seat 4: ferraresi81 (28749 in chips) 
Seat 5: rikyrb (80773 in chips) 
Seat 6: shaneita (15190 in chips) 
Seat 7: scorpoli (48574 in chips) 
Seat 8: TURoff (106776 in chips) 
Seat 9: olya 01rus (25895 in chips) 
AVG3625: posts the ante 225
ZAN ua: posts the ante 225
studen6: posts the ante 225
ferraresi81: posts the ante 225
rikyrb: posts the ante 225
shaneita: posts the ante 225
scorpoli: posts the ante 225
TURoff: posts the ante 225
olya 01rus: posts the ante 225
TURoff: posts small blind 900
olya 01rus: posts big blind 1800
*** HOLE CARDS ***
Dealt to TURoff [Qc 5s]
AVG3625: folds 
ZAN ua: raises 2700 to 4500
studen6: folds 
ferraresi81: folds 
rikyrb: folds 
shaneita: folds 
scorpoli: folds 
TURoff has timed out
TURoff: folds 
TURoff is sitting out
olya 01rus: folds 
Uncalled bet (2700) returned to ZAN ua
ZAN ua collected 6525 from pot
ZAN ua: doesn't show hand 
TURoff has returned
*** SUMMARY ***
Total pot 6525 | Rake 0 
Seat 1: AVG3625 folded before Flop (didn't bet)
Seat 2: ZAN ua collected (6525)
Seat 3: studen6 folded before Flop (didn't bet)
Seat 4: ferraresi81 folded before Flop (didn't bet)
Seat 5: rikyrb folded before Flop (didn't bet)
Seat 6: shaneita folded before Flop (didn't bet)
Seat 7: scorpoli (button) folded before Flop (didn't bet)
Seat 8: TURoff (small blind) folded before Flop
Seat 9: olya 01rus (big blind) folded before Flop





PokerStars Hand #177202118731: Tournament #2067822782, $1.00+$0.10 USD Hold'em No Limit - Level XXI (900/1800) - 2017/10/21 22:34:04 CUST [2017/10/21 14:34:04 ET]
Table '2067822782 63' 9-max Seat #8 is the button
Seat 1: AVG3625 (79830 in chips) 
Seat 2: ZAN ua (88430 in chips) 
Seat 3: studen6 (8768 in chips) 
Seat 4: ferraresi81 (28524 in chips) 
Seat 5: rikyrb (80548 in chips) 
Seat 6: shaneita (14965 in chips) 
Seat 7: scorpoli (48349 in chips) 
Seat 8: TURoff (105651 in chips) 
Seat 9: olya 01rus (23870 in chips) 
AVG3625: posts the ante 225
ZAN ua: posts the ante 225
studen6: posts the ante 225
ferraresi81: posts the ante 225
rikyrb: posts the ante 225
shaneita: posts the ante 225
scorpoli: posts the ante 225
TURoff: posts the ante 225
olya 01rus: posts the ante 225
olya 01rus: posts small blind 900
AVG3625: posts big blind 1800
*** HOLE CARDS ***
Dealt to TURoff [Ac 5h]
ZAN ua: folds 
studen6: folds 
ferraresi81: raises 2088 to 3888
rikyrb: folds 
shaneita: folds 
scorpoli: folds 
TURoff: folds 
olya 01rus: folds 
AVG3625: calls 2088
*** FLOP *** [6s Td 2s]
AVG3625: checks 
ferraresi81: bets 5565
AVG3625: raises 70152 to 75717 and is all-in
ferraresi81: calls 18846 and is all-in
Uncalled bet (51306) returned to AVG3625
*** TURN *** [6s Td 2s] [7h]
*** RIVER *** [6s Td 2s 7h] [7d]
*** SHOW DOWN ***
AVG3625: shows [5s Qs] (a pair of Sevens)
ferraresi81: shows [Th Kh] (two pair, Tens and Sevens)
ferraresi81 collected 59523 from pot
*** SUMMARY ***
Total pot 59523 | Rake 0 
Board [6s Td 2s 7h 7d]
Seat 1: AVG3625 (big blind) showed [5s Qs] and lost with a pair of Sevens
Seat 2: ZAN ua folded before Flop (didn't bet)
Seat 3: studen6 folded before Flop (didn't bet)
Seat 4: ferraresi81 showed [Th Kh] and won (59523) with two pair, Tens and Sevens
Seat 5: rikyrb folded before Flop (didn't bet)
Seat 6: shaneita folded before Flop (didn't bet)
Seat 7: scorpoli folded before Flop (didn't bet)
Seat 8: TURoff (button) folded before Flop (didn't bet)
Seat 9: olya 01rus (small blind) folded before Flop





PokerStars Hand #177202166039: Tournament #2067822782, $1.00+$0.10 USD Hold'em No Limit - Level XXI (900/1800) - 2017/10/21 22:35:05 CUST [2017/10/21 14:35:05 ET]
Table '2067822782 63' 9-max Seat #9 is the button
Seat 1: AVG3625 (51306 in chips) 
Seat 2: ZAN ua (88205 in chips) 
Seat 3: studen6 (8543 in chips) 
Seat 4: ferraresi81 (59523 in chips) 
Seat 5: rikyrb (80323 in chips) 
Seat 6: shaneita (14740 in chips) 
Seat 7: scorpoli (48124 in chips) 
Seat 8: TURoff (105426 in chips) 
Seat 9: olya 01rus (22745 in chips) 
AVG3625: posts the ante 225
ZAN ua: posts the ante 225
studen6: posts the ante 225
ferraresi81: posts the ante 225
rikyrb: posts the ante 225
shaneita: posts the ante 225
scorpoli: posts the ante 225
TURoff: posts the ante 225
olya 01rus: posts the ante 225
AVG3625: posts small blind 900
ZAN ua: posts big blind 1800
*** HOLE CARDS ***
Dealt to TURoff [6c Qc]
studen6: folds 
ferraresi81: raises 2088 to 3888
rikyrb: folds 
shaneita: folds 
ferraresi81 said, "ty"
scorpoli: folds 
ferraresi81 said, "<3"
TURoff has timed out
TURoff: folds 
TURoff is sitting out
olya 01rus: folds 
AVG3625: raises 6912 to 10800
ZAN ua: folds 
ferraresi81: folds 
Uncalled bet (6912) returned to AVG3625
AVG3625 collected 11601 from pot
AVG3625: doesn't show hand 
*** SUMMARY ***
Total pot 11601 | Rake 0 
Seat 1: AVG3625 (small blind) collected (11601)
Seat 2: ZAN ua (big blind) folded before Flop
Seat 3: studen6 folded before Flop (didn't bet)
Seat 4: ferraresi81 folded before Flop
Seat 5: rikyrb folded before Flop (didn't bet)
Seat 6: shaneita folded before Flop (didn't bet)
Seat 7: scorpoli folded before Flop (didn't bet)
Seat 8: TURoff folded before Flop (didn't bet)
Seat 9: olya 01rus (button) folded before Flop (didn't bet)





PokerStars Hand #177202217588: Tournament #2067822782, $1.00+$0.10 USD Hold'em No Limit - Level XXI (900/1800) - 2017/10/21 22:36:12 CUST [2017/10/21 14:36:12 ET]
Table '2067822782 63' 9-max Seat #1 is the button
Seat 1: AVG3625 (58794 in chips) 
Seat 2: ZAN ua (86180 in chips) 
Seat 3: studen6 (8318 in chips) 
Seat 4: ferraresi81 (55410 in chips) 
Seat 5: rikyrb (80098 in chips) 
Seat 6: shaneita (14515 in chips) 
Seat 7: scorpoli (47899 in chips) 
Seat 8: TURoff (105201 in chips) is sitting out
Seat 9: olya 01rus (22520 in chips) 
AVG3625: posts the ante 225
ZAN ua: posts the ante 225
studen6: posts the ante 225
ferraresi81: posts the ante 225
rikyrb: posts the ante 225
shaneita: posts the ante 225
scorpoli: posts the ante 225
TURoff: posts the ante 225
olya 01rus: posts the ante 225
ZAN ua: posts small blind 900
studen6: posts big blind 1800
*** HOLE CARDS ***
Dealt to TURoff [9h 3s]
ferraresi81: folds 
rikyrb: folds 
shaneita: folds 
scorpoli: folds 
TURoff: folds 
olya 01rus: folds 
AVG3625: raises 1800 to 3600
ZAN ua: folds 
studen6: folds 
Uncalled bet (1800) returned to AVG3625
AVG3625 collected 6525 from pot
AVG3625: doesn't show hand 
*** SUMMARY ***
Total pot 6525 | Rake 0 
Seat 1: AVG3625 (button) collected (6525)
Seat 2: ZAN ua (small blind) folded before Flop
Seat 3: studen6 (big blind) folded before Flop
Seat 4: ferraresi81 folded before Flop (didn't bet)
Seat 5: rikyrb folded before Flop (didn't bet)
Seat 6: shaneita folded before Flop (didn't bet)
Seat 7: scorpoli folded before Flop (didn't bet)
Seat 8: TURoff folded before Flop (didn't bet)
Seat 9: olya 01rus folded before Flop (didn't bet)





PokerStars Hand #177202251570: Tournament #2067822782, $1.00+$0.10 USD Hold'em No Limit - Level XXI (900/1800) - 2017/10/21 22:36:56 CUST [2017/10/21 14:36:56 ET]
Table '2067822782 63' 9-max Seat #2 is the button
Seat 1: AVG3625 (63294 in chips) 
Seat 2: ZAN ua (85055 in chips) 
Seat 3: studen6 (6293 in chips) 
Seat 4: ferraresi81 (55185 in chips) 
Seat 5: rikyrb (79873 in chips) 
Seat 6: shaneita (14290 in chips) 
Seat 7: scorpoli (47674 in chips) 
Seat 8: TURoff (104976 in chips) is sitting out
Seat 9: olya 01rus (22295 in chips) 
AVG3625: posts the ante 225
ZAN ua: posts the ante 225
studen6: posts the ante 225
ferraresi81: posts the ante 225
rikyrb: posts the ante 225
shaneita: posts the ante 225
scorpoli: posts the ante 225
TURoff: posts the ante 225
olya 01rus: posts the ante 225
studen6: posts small blind 900
ferraresi81: posts big blind 1800
*** HOLE CARDS ***
Dealt to TURoff [As 6c]
rikyrb: folds 
shaneita: folds 
scorpoli: folds 
TURoff: folds 
olya 01rus: folds 
AVG3625: folds 
ZAN ua: folds 
studen6: raises 3600 to 5400
ferraresi81: folds 
Uncalled bet (3600) returned to studen6
studen6 collected 5625 from pot
*** SUMMARY ***
Total pot 5625 | Rake 0 
Seat 1: AVG3625 folded before Flop (didn't bet)
Seat 2: ZAN ua (button) folded before Flop (didn't bet)
Seat 3: studen6 (small blind) collected (5625)
Seat 4: ferraresi81 (big blind) folded before Flop
Seat 5: rikyrb folded before Flop (didn't bet)
Seat 6: shaneita folded before Flop (didn't bet)
Seat 7: scorpoli folded before Flop (didn't bet)
Seat 8: TURoff folded before Flop (didn't bet)
Seat 9: olya 01rus folded before Flop (didn't bet)





PokerStars Hand #177202283893: Tournament #2067822782, $1.00+$0.10 USD Hold'em No Limit - Level XXI (900/1800) - 2017/10/21 22:37:38 CUST [2017/10/21 14:37:38 ET]
Table '2067822782 63' 9-max Seat #3 is the button
Seat 1: AVG3625 (63069 in chips) 
Seat 2: ZAN ua (84830 in chips) 
Seat 3: studen6 (9893 in chips) 
Seat 4: ferraresi81 (53160 in chips) 
Seat 5: rikyrb (79648 in chips) 
Seat 6: shaneita (14065 in chips) 
Seat 7: scorpoli (47449 in chips) 
Seat 8: TURoff (104751 in chips) is sitting out
Seat 9: olya 01rus (22070 in chips) 
AVG3625: posts the ante 225
ZAN ua: posts the ante 225
studen6: posts the ante 225
ferraresi81: posts the ante 225
rikyrb: posts the ante 225
shaneita: posts the ante 225
scorpoli: posts the ante 225
TURoff: posts the ante 225
olya 01rus: posts the ante 225
ferraresi81: posts small blind 900
rikyrb: posts big blind 1800
*** HOLE CARDS ***
Dealt to TURoff [5h Kc]
shaneita: folds 
scorpoli: folds 
TURoff: folds 
olya 01rus: calls 1800
AVG3625: folds 
ZAN ua: folds 
studen6: folds 
ferraresi81: calls 900
rikyrb: checks 
*** FLOP *** [Qs Jd Tc]
ferraresi81: checks 
rikyrb: checks 
olya 01rus: checks 
*** TURN *** [Qs Jd Tc] [3c]
ferraresi81: checks 
rikyrb: checks 
olya 01rus: checks 
*** RIVER *** [Qs Jd Tc 3c] [4d]
ferraresi81: bets 3861
rikyrb: folds 
olya 01rus: raises 3861 to 7722
ferraresi81: folds 
Uncalled bet (3861) returned to olya 01rus
olya 01rus collected 15147 from pot
olya 01rus: doesn't show hand 
*** SUMMARY ***
Total pot 15147 | Rake 0 
Board [Qs Jd Tc 3c 4d]
Seat 1: AVG3625 folded before Flop (didn't bet)
Seat 2: ZAN ua folded before Flop (didn't bet)
Seat 3: studen6 (button) folded before Flop (didn't bet)
Seat 4: ferraresi81 (small blind) folded on the River
Seat 5: rikyrb (big blind) folded on the River
Seat 6: shaneita folded before Flop (didn't bet)
Seat 7: scorpoli folded before Flop (didn't bet)
Seat 8: TURoff folded before Flop (didn't bet)
Seat 9: olya 01rus collected (15147)





PokerStars Hand #177202349396: Tournament #2067822782, $1.00+$0.10 USD Hold'em No Limit - Level XXII (1000/2000) - 2017/10/21 22:39:02 CUST [2017/10/21 14:39:02 ET]
Table '2067822782 63' 9-max Seat #4 is the button
Seat 1: AVG3625 (62844 in chips) 
Seat 2: ZAN ua (84605 in chips) 
Seat 3: studen6 (9668 in chips) 
Seat 4: ferraresi81 (47274 in chips) 
Seat 5: rikyrb (77623 in chips) 
Seat 6: shaneita (13840 in chips) 
Seat 7: scorpoli (47224 in chips) 
Seat 8: TURoff (104526 in chips) is sitting out
Seat 9: olya 01rus (31331 in chips) 
AVG3625: posts the ante 250
ZAN ua: posts the ante 250
studen6: posts the ante 250
ferraresi81: posts the ante 250
rikyrb: posts the ante 250
shaneita: posts the ante 250
scorpoli: posts the ante 250
TURoff: posts the ante 250
olya 01rus: posts the ante 250
rikyrb: posts small blind 1000
shaneita: posts big blind 2000
*** HOLE CARDS ***
Dealt to TURoff [Kh 4d]
scorpoli: folds 
TURoff: folds 
olya 01rus: folds 
AVG3625: folds 
ZAN ua: raises 2000 to 4000
studen6: folds 
ferraresi81: calls 4000
rikyrb: folds 
shaneita: folds 
*** FLOP *** [7c 5c 7d]
ZAN ua: checks 
ferraresi81: bets 6890
ZAN ua: calls 6890
*** TURN *** [7c 5c 7d] [5s]
ZAN ua: checks 
ferraresi81: checks 
*** RIVER *** [7c 5c 7d 5s] [Tc]
ZAN ua: checks 
ferraresi81: checks 
*** SHOW DOWN ***
ZAN ua: shows [7s 8s] (a full house, Sevens full of Fives)
ferraresi81: mucks hand 
ZAN ua collected 27030 from pot
*** SUMMARY ***
Total pot 27030 | Rake 0 
Board [7c 5c 7d 5s Tc]
Seat 1: AVG3625 folded before Flop (didn't bet)
Seat 2: ZAN ua showed [7s 8s] and won (27030) with a full house, Sevens full of Fives
Seat 3: studen6 folded before Flop (didn't bet)
Seat 4: ferraresi81 (button) mucked [Ah Td]
Seat 5: rikyrb (small blind) folded before Flop
Seat 6: shaneita (big blind) folded before Flop
Seat 7: scorpoli folded before Flop (didn't bet)
Seat 8: TURoff folded before Flop (didn't bet)
Seat 9: olya 01rus folded before Flop (didn't bet)





PokerStars Hand #177202406097: Tournament #2067822782, $1.00+$0.10 USD Hold'em No Limit - Level XXII (1000/2000) - 2017/10/21 22:40:16 CUST [2017/10/21 14:40:16 ET]
Table '2067822782 63' 9-max Seat #5 is the button
Seat 1: AVG3625 (62594 in chips) 
Seat 2: ZAN ua (100495 in chips) 
Seat 3: studen6 (9418 in chips) 
Seat 4: ferraresi81 (36134 in chips) 
Seat 5: rikyrb (76373 in chips) 
Seat 6: shaneita (11590 in chips) 
Seat 7: scorpoli (46974 in chips) 
Seat 8: TURoff (104276 in chips) is sitting out
Seat 9: olya 01rus (31081 in chips) 
AVG3625: posts the ante 250
ZAN ua: posts the ante 250
studen6: posts the ante 250
ferraresi81: posts the ante 250
rikyrb: posts the ante 250
shaneita: posts the ante 250
scorpoli: posts the ante 250
TURoff: posts the ante 250
olya 01rus: posts the ante 250
shaneita: posts small blind 1000
scorpoli: posts big blind 2000
*** HOLE CARDS ***
Dealt to TURoff [4c Jc]
TURoff: folds 
olya 01rus: folds 
AVG3625: folds 
ZAN ua: folds 
studen6: folds 
ferraresi81: raises 2320 to 4320
rikyrb: folds 
shaneita: folds 
scorpoli: folds 
Uncalled bet (2320) returned to ferraresi81
ferraresi81 collected 7250 from pot
ferraresi81: doesn't show hand 
*** SUMMARY ***
Total pot 7250 | Rake 0 
Seat 1: AVG3625 folded before Flop (didn't bet)
Seat 2: ZAN ua folded before Flop (didn't bet)
Seat 3: studen6 folded before Flop (didn't bet)
Seat 4: ferraresi81 collected (7250)
Seat 5: rikyrb (button) folded before Flop (didn't bet)
Seat 6: shaneita (small blind) folded before Flop
Seat 7: scorpoli (big blind) folded before Flop
Seat 8: TURoff folded before Flop (didn't bet)
Seat 9: olya 01rus folded before Flop (didn't bet)





PokerStars Hand #177202436423: Tournament #2067822782, $1.00+$0.10 USD Hold'em No Limit - Level XXII (1000/2000) - 2017/10/21 22:40:55 CUST [2017/10/21 14:40:55 ET]
Table '2067822782 63' 9-max Seat #6 is the button
Seat 1: AVG3625 (62344 in chips) 
Seat 2: ZAN ua (100245 in chips) 
Seat 3: studen6 (9168 in chips) 
Seat 4: ferraresi81 (41134 in chips) 
Seat 5: rikyrb (76123 in chips) 
Seat 6: shaneita (10340 in chips) 
Seat 7: scorpoli (44724 in chips) 
Seat 8: TURoff (104026 in chips) is sitting out
Seat 9: olya 01rus (30831 in chips) 
AVG3625: posts the ante 250
ZAN ua: posts the ante 250
studen6: posts the ante 250
ferraresi81: posts the ante 250
rikyrb: posts the ante 250
shaneita: posts the ante 250
scorpoli: posts the ante 250
TURoff: posts the ante 250
olya 01rus: posts the ante 250
scorpoli: posts small blind 1000
TURoff: posts big blind 2000
*** HOLE CARDS ***
Dealt to TURoff [7h 5s]
olya 01rus: folds 
AVG3625: folds 
ZAN ua: folds 
studen6: folds 
ferraresi81: folds 
rikyrb: raises 2000 to 4000
shaneita: folds 
scorpoli: folds 
TURoff: folds 
Uncalled bet (2000) returned to rikyrb
rikyrb collected 7250 from pot
*** SUMMARY ***
Total pot 7250 | Rake 0 
Seat 1: AVG3625 folded before Flop (didn't bet)
Seat 2: ZAN ua folded before Flop (didn't bet)
Seat 3: studen6 folded before Flop (didn't bet)
Seat 4: ferraresi81 folded before Flop (didn't bet)
Seat 5: rikyrb collected (7250)
Seat 6: shaneita (button) folded before Flop (didn't bet)
Seat 7: scorpoli (small blind) folded before Flop
Seat 8: TURoff (big blind) folded before Flop
Seat 9: olya 01rus folded before Flop (didn't bet)





PokerStars Hand #177202458724: Tournament #2067822782, $1.00+$0.10 USD Hold'em No Limit - Level XXII (1000/2000) - 2017/10/21 22:41:24 CUST [2017/10/21 14:41:24 ET]
Table '2067822782 63' 9-max Seat #7 is the button
Seat 1: AVG3625 (62094 in chips) 
Seat 2: ZAN ua (99995 in chips) 
Seat 3: studen6 (8918 in chips) 
Seat 4: ferraresi81 (40884 in chips) 
Seat 5: rikyrb (81123 in chips) 
Seat 6: shaneita (10090 in chips) 
Seat 7: scorpoli (43474 in chips) 
Seat 8: TURoff (101776 in chips) is sitting out
Seat 9: olya 01rus (30581 in chips) 
AVG3625: posts the ante 250
ZAN ua: posts the ante 250
studen6: posts the ante 250
ferraresi81: posts the ante 250
rikyrb: posts the ante 250
shaneita: posts the ante 250
scorpoli: posts the ante 250
TURoff: posts the ante 250
olya 01rus: posts the ante 250
TURoff: posts small blind 1000
olya 01rus: posts big blind 2000
*** HOLE CARDS ***
Dealt to TURoff [Td 4s]
AVG3625: folds 
ZAN ua: folds 
studen6: folds 
ferraresi81: folds 
rikyrb: folds 
shaneita: raises 2000 to 4000
scorpoli: folds 
TURoff: folds 
olya 01rus: raises 4000 to 8000
shaneita: raises 1840 to 9840 and is all-in
olya 01rus: calls 1840
*** FLOP *** [6h 9h 7c]
*** TURN *** [6h 9h 7c] [Js]
*** RIVER *** [6h 9h 7c Js] [7d]
*** SHOW DOWN ***
olya 01rus: shows [Tc Kd] (a pair of Sevens)
shaneita: shows [Ad 2s] (a pair of Sevens - Ace kicker)
shaneita collected 22930 from pot
*** SUMMARY ***
Total pot 22930 | Rake 0 
Board [6h 9h 7c Js 7d]
Seat 1: AVG3625 folded before Flop (didn't bet)
Seat 2: ZAN ua folded before Flop (didn't bet)
Seat 3: studen6 folded before Flop (didn't bet)
Seat 4: ferraresi81 folded before Flop (didn't bet)
Seat 5: rikyrb folded before Flop (didn't bet)
Seat 6: shaneita showed [Ad 2s] and won (22930) with a pair of Sevens
Seat 7: scorpoli (button) folded before Flop (didn't bet)
Seat 8: TURoff (small blind) folded before Flop
Seat 9: olya 01rus (big blind) showed [Tc Kd] and lost with a pair of Sevens





PokerStars Hand #177202505913: Tournament #2067822782, $1.00+$0.10 USD Hold'em No Limit - Level XXII (1000/2000) - 2017/10/21 22:42:26 CUST [2017/10/21 14:42:26 ET]
Table '2067822782 63' 9-max Seat #8 is the button
Seat 1: AVG3625 (61844 in chips) 
Seat 2: ZAN ua (99745 in chips) 
Seat 3: studen6 (8668 in chips) 
Seat 4: ferraresi81 (40634 in chips) 
Seat 5: rikyrb (80873 in chips) 
Seat 6: shaneita (22930 in chips) 
Seat 7: scorpoli (43224 in chips) 
Seat 8: TURoff (100526 in chips) is sitting out
Seat 9: olya 01rus (20491 in chips) 
AVG3625: posts the ante 250
ZAN ua: posts the ante 250
studen6: posts the ante 250
ferraresi81: posts the ante 250
rikyrb: posts the ante 250
shaneita: posts the ante 250
scorpoli: posts the ante 250
TURoff: posts the ante 250
olya 01rus: posts the ante 250
olya 01rus: posts small blind 1000
AVG3625: posts big blind 2000
*** HOLE CARDS ***
Dealt to TURoff [5d 6h]
ZAN ua: folds 
studen6: folds 
ferraresi81: folds 
rikyrb: folds 
shaneita: folds 
scorpoli: folds 
TURoff: folds 
olya 01rus: calls 1000
AVG3625: checks 
*** FLOP *** [Qh Kd 4d]
olya 01rus: checks 
AVG3625: checks 
*** TURN *** [Qh Kd 4d] [8d]
olya 01rus: checks 
AVG3625: checks 
*** RIVER *** [Qh Kd 4d 8d] [2h]
olya 01rus: checks 
AVG3625: checks 
*** SHOW DOWN ***
olya 01rus: shows [6d 2s] (a pair of Deuces)
AVG3625: mucks hand 
olya 01rus collected 6250 from pot
*** SUMMARY ***
Total pot 6250 | Rake 0 
Board [Qh Kd 4d 8d 2h]
Seat 1: AVG3625 (big blind) mucked [3d Js]
Seat 2: ZAN ua folded before Flop (didn't bet)
Seat 3: studen6 folded before Flop (didn't bet)
Seat 4: ferraresi81 folded before Flop (didn't bet)
Seat 5: rikyrb folded before Flop (didn't bet)
Seat 6: shaneita folded before Flop (didn't bet)
Seat 7: scorpoli folded before Flop (didn't bet)
Seat 8: TURoff (button) folded before Flop (didn't bet)
Seat 9: olya 01rus (small blind) showed [6d 2s] and won (6250) with a pair of Deuces





PokerStars Hand #177202539888: Tournament #2067822782, $1.00+$0.10 USD Hold'em No Limit - Level XXII (1000/2000) - 2017/10/21 22:43:10 CUST [2017/10/21 14:43:10 ET]
Table '2067822782 63' 9-max Seat #9 is the button
Seat 1: AVG3625 (59594 in chips) 
Seat 2: ZAN ua (99495 in chips) 
Seat 3: studen6 (8418 in chips) 
Seat 4: ferraresi81 (40384 in chips) 
Seat 5: rikyrb (80623 in chips) 
Seat 6: shaneita (22680 in chips) 
Seat 7: scorpoli (42974 in chips) 
Seat 8: TURoff (100276 in chips) is sitting out
Seat 9: olya 01rus (24491 in chips) 
AVG3625: posts the ante 250
ZAN ua: posts the ante 250
studen6: posts the ante 250
ferraresi81: posts the ante 250
rikyrb: posts the ante 250
shaneita: posts the ante 250
scorpoli: posts the ante 250
TURoff: posts the ante 250
olya 01rus: posts the ante 250
AVG3625: posts small blind 1000
ZAN ua: posts big blind 2000
*** HOLE CARDS ***
Dealt to TURoff [4c As]
studen6: folds 
ferraresi81: folds 
rikyrb: folds 
shaneita: raises 2000 to 4000
scorpoli: folds 
TURoff: folds 
olya 01rus: folds 
AVG3625: folds 
ZAN ua: folds 
Uncalled bet (2000) returned to shaneita
shaneita collected 7250 from pot
shaneita: doesn't show hand 
*** SUMMARY ***
Total pot 7250 | Rake 0 
Seat 1: AVG3625 (small blind) folded before Flop
Seat 2: ZAN ua (big blind) folded before Flop
Seat 3: studen6 folded before Flop (didn't bet)
Seat 4: ferraresi81 folded before Flop (didn't bet)
Seat 5: rikyrb folded before Flop (didn't bet)
Seat 6: shaneita collected (7250)
Seat 7: scorpoli folded before Flop (didn't bet)
Seat 8: TURoff folded before Flop (didn't bet)
Seat 9: olya 01rus (button) folded before Flop (didn't bet)





PokerStars Hand #177202564008: Tournament #2067822782, $1.00+$0.10 USD Hold'em No Limit - Level XXII (1000/2000) - 2017/10/21 22:43:41 CUST [2017/10/21 14:43:41 ET]
Table '2067822782 63' 9-max Seat #1 is the button
Seat 1: AVG3625 (58344 in chips) 
Seat 2: ZAN ua (97245 in chips) 
Seat 3: studen6 (8168 in chips) 
Seat 4: ferraresi81 (40134 in chips) 
Seat 5: rikyrb (80373 in chips) 
Seat 6: shaneita (27680 in chips) 
Seat 7: scorpoli (42724 in chips) 
Seat 8: TURoff (100026 in chips) is sitting out
Seat 9: olya 01rus (24241 in chips) 
AVG3625: posts the ante 250
ZAN ua: posts the ante 250
studen6: posts the ante 250
ferraresi81: posts the ante 250
rikyrb: posts the ante 250
shaneita: posts the ante 250
scorpoli: posts the ante 250
TURoff: posts the ante 250
olya 01rus: posts the ante 250
ZAN ua: posts small blind 1000
studen6: posts big blind 2000
*** HOLE CARDS ***
Dealt to TURoff [6s Tc]
ferraresi81: folds 
rikyrb: folds 
shaneita: folds 
scorpoli: raises 40474 to 42474 and is all-in
TURoff: folds 
olya 01rus: folds 
AVG3625: folds 
ZAN ua: folds 
studen6: folds 
Uncalled bet (40474) returned to scorpoli
scorpoli collected 7250 from pot
scorpoli: doesn't show hand 
*** SUMMARY ***
Total pot 7250 | Rake 0 
Seat 1: AVG3625 (button) folded before Flop (didn't bet)
Seat 2: ZAN ua (small blind) folded before Flop
Seat 3: studen6 (big blind) folded before Flop
Seat 4: ferraresi81 folded before Flop (didn't bet)
Seat 5: rikyrb folded before Flop (didn't bet)
Seat 6: shaneita folded before Flop (didn't bet)
Seat 7: scorpoli collected (7250)
Seat 8: TURoff folded before Flop (didn't bet)
Seat 9: olya 01rus folded before Flop (didn't bet)





PokerStars Hand #177202587061: Tournament #2067822782, $1.00+$0.10 USD Hold'em No Limit - Level XXII (1000/2000) - 2017/10/21 22:44:11 CUST [2017/10/21 14:44:11 ET]
Table '2067822782 63' 9-max Seat #2 is the button
Seat 1: AVG3625 (58094 in chips) 
Seat 2: ZAN ua (95995 in chips) 
Seat 3: studen6 (5918 in chips) 
Seat 4: ferraresi81 (39884 in chips) 
Seat 5: rikyrb (80123 in chips) 
Seat 6: shaneita (27430 in chips) 
Seat 7: scorpoli (47724 in chips) 
Seat 8: TURoff (99776 in chips) is sitting out
Seat 9: olya 01rus (23991 in chips) 
AVG3625: posts the ante 250
ZAN ua: posts the ante 250
studen6: posts the ante 250
ferraresi81: posts the ante 250
rikyrb: posts the ante 250
shaneita: posts the ante 250
scorpoli: posts the ante 250
TURoff: posts the ante 250
olya 01rus: posts the ante 250
studen6: posts small blind 1000
ferraresi81: posts big blind 2000
*** HOLE CARDS ***
Dealt to TURoff [2h 2s]
rikyrb: folds 
shaneita: folds 
scorpoli: folds 
TURoff: folds 
olya 01rus: folds 
AVG3625: folds 
ZAN ua: folds 
studen6: raises 3668 to 5668 and is all-in
ferraresi81: calls 3668
*** FLOP *** [3c 9s Ac]
*** TURN *** [3c 9s Ac] [Ad]
*** RIVER *** [3c 9s Ac Ad] [Qc]
*** SHOW DOWN ***
studen6: shows [Js Kh] (a pair of Aces)
ferraresi81: shows [8d 7d] (a pair of Aces - lower kicker)
studen6 collected 13586 from pot
*** SUMMARY ***
Total pot 13586 | Rake 0 
Board [3c 9s Ac Ad Qc]
Seat 1: AVG3625 folded before Flop (didn't bet)
Seat 2: ZAN ua (button) folded before Flop (didn't bet)
Seat 3: studen6 (small blind) showed [Js Kh] and won (13586) with a pair of Aces
Seat 4: ferraresi81 (big blind) showed [8d 7d] and lost with a pair of Aces
Seat 5: rikyrb folded before Flop (didn't bet)
Seat 6: shaneita folded before Flop (didn't bet)
Seat 7: scorpoli folded before Flop (didn't bet)
Seat 8: TURoff folded before Flop (didn't bet)
Seat 9: olya 01rus folded before Flop (didn't bet)





PokerStars Hand #177202621018: Tournament #2067822782, $1.00+$0.10 USD Hold'em No Limit - Level XXII (1000/2000) - 2017/10/21 22:44:55 CUST [2017/10/21 14:44:55 ET]
Table '2067822782 63' 9-max Seat #3 is the button
Seat 1: AVG3625 (57844 in chips) 
Seat 2: ZAN ua (95745 in chips) 
Seat 3: studen6 (13586 in chips) 
Seat 4: ferraresi81 (33966 in chips) 
Seat 5: rikyrb (79873 in chips) 
Seat 6: shaneita (27180 in chips) 
Seat 7: scorpoli (47474 in chips) 
Seat 8: TURoff (99526 in chips) is sitting out
Seat 9: olya 01rus (23741 in chips) 
AVG3625: posts the ante 250
ZAN ua: posts the ante 250
studen6: posts the ante 250
ferraresi81: posts the ante 250
rikyrb: posts the ante 250
shaneita: posts the ante 250
scorpoli: posts the ante 250
TURoff: posts the ante 250
olya 01rus: posts the ante 250
ferraresi81: posts small blind 1000
rikyrb: posts big blind 2000
*** HOLE CARDS ***
Dealt to TURoff [Js Ad]
shaneita: folds 
scorpoli: calls 2000
TURoff: folds 
olya 01rus: raises 4000 to 6000
AVG3625: folds 
ZAN ua: folds 
studen6: folds 
ferraresi81: folds 
rikyrb: folds 
scorpoli: calls 4000
*** FLOP *** [Kh 9s 2d]
scorpoli: checks 
olya 01rus: bets 17491 and is all-in
scorpoli: folds 
Uncalled bet (17491) returned to olya 01rus
olya 01rus collected 17250 from pot
olya 01rus: doesn't show hand 
*** SUMMARY ***
Total pot 17250 | Rake 0 
Board [Kh 9s 2d]
Seat 1: AVG3625 folded before Flop (didn't bet)
Seat 2: ZAN ua folded before Flop (didn't bet)
Seat 3: studen6 (button) folded before Flop (didn't bet)
Seat 4: ferraresi81 (small blind) folded before Flop
Seat 5: rikyrb (big blind) folded before Flop
Seat 6: shaneita folded before Flop (didn't bet)
Seat 7: scorpoli folded on the Flop
Seat 8: TURoff folded before Flop (didn't bet)
Seat 9: olya 01rus collected (17250)





PokerStars Hand #177202672469: Tournament #2067822782, $1.00+$0.10 USD Hold'em No Limit - Level XXII (1000/2000) - 2017/10/21 22:46:02 CUST [2017/10/21 14:46:02 ET]
Table '2067822782 63' 9-max Seat #4 is the button
Seat 1: AVG3625 (57594 in chips) 
Seat 2: ZAN ua (95495 in chips) 
Seat 3: studen6 (13336 in chips) 
Seat 4: ferraresi81 (32716 in chips) 
Seat 5: rikyrb (77623 in chips) 
Seat 6: shaneita (26930 in chips) 
Seat 7: scorpoli (41224 in chips) 
Seat 8: TURoff (99276 in chips) is sitting out
Seat 9: olya 01rus (34741 in chips) 
AVG3625: posts the ante 250
ZAN ua: posts the ante 250
studen6: posts the ante 250
ferraresi81: posts the ante 250
rikyrb: posts the ante 250
shaneita: posts the ante 250
scorpoli: posts the ante 250
TURoff: posts the ante 250
olya 01rus: posts the ante 250
rikyrb: posts small blind 1000
shaneita: posts big blind 2000
*** HOLE CARDS ***
Dealt to TURoff [2c 5s]
scorpoli: folds 
TURoff: folds 
olya 01rus: folds 
AVG3625: folds 
ZAN ua: folds 
studen6: folds 
ferraresi81: raises 2320 to 4320
rikyrb: folds 
shaneita: calls 2320
*** FLOP *** [6d Td Qh]
shaneita: checks 
ferraresi81: checks 
*** TURN *** [6d Td Qh] [Jd]
shaneita: bets 4000
ferraresi81: folds 
Uncalled bet (4000) returned to shaneita
shaneita collected 11890 from pot
shaneita: doesn't show hand 
*** SUMMARY ***
Total pot 11890 | Rake 0 
Board [6d Td Qh Jd]
Seat 1: AVG3625 folded before Flop (didn't bet)
Seat 2: ZAN ua folded before Flop (didn't bet)
Seat 3: studen6 folded before Flop (didn't bet)
Seat 4: ferraresi81 (button) folded on the Turn
Seat 5: rikyrb (small blind) folded before Flop
Seat 6: shaneita (big blind) collected (11890)
Seat 7: scorpoli folded before Flop (didn't bet)
Seat 8: TURoff folded before Flop (didn't bet)
Seat 9: olya 01rus folded before Flop (didn't bet)





PokerStars Hand #177202729780: Tournament #2067822782, $1.00+$0.10 USD Hold'em No Limit - Level XXII (1000/2000) - 2017/10/21 22:47:16 CUST [2017/10/21 14:47:16 ET]
Table '2067822782 63' 9-max Seat #5 is the button
Seat 1: AVG3625 (57344 in chips) 
Seat 2: ZAN ua (95245 in chips) 
Seat 3: studen6 (13086 in chips) 
Seat 4: ferraresi81 (28146 in chips) 
Seat 5: rikyrb (76373 in chips) 
Seat 6: shaneita (34250 in chips) 
Seat 7: scorpoli (40974 in chips) 
Seat 8: TURoff (99026 in chips) is sitting out
Seat 9: olya 01rus (34491 in chips) 
AVG3625: posts the ante 250
ZAN ua: posts the ante 250
studen6: posts the ante 250
ferraresi81: posts the ante 250
rikyrb: posts the ante 250
shaneita: posts the ante 250
scorpoli: posts the ante 250
TURoff: posts the ante 250
olya 01rus: posts the ante 250
shaneita: posts small blind 1000
scorpoli: posts big blind 2000
*** HOLE CARDS ***
Dealt to TURoff [7s Kc]
TURoff: folds 
olya 01rus: calls 2000
AVG3625: folds 
ZAN ua: folds 
studen6: folds 
ferraresi81: folds 
rikyrb: calls 2000
shaneita: raises 2000 to 4000
scorpoli: calls 2000
olya 01rus: calls 2000
rikyrb: calls 2000
*** FLOP *** [8s 3d 7h]
shaneita: bets 4000
scorpoli: calls 4000
olya 01rus: calls 4000
rikyrb: folds 
*** TURN *** [8s 3d 7h] [Kh]
shaneita: bets 6000
scorpoli: folds 
olya 01rus: raises 8000 to 14000
shaneita: folds 
Uncalled bet (8000) returned to olya 01rus
olya 01rus collected 42250 from pot
olya 01rus: doesn't show hand 
*** SUMMARY ***
Total pot 42250 | Rake 0 
Board [8s 3d 7h Kh]
Seat 1: AVG3625 folded before Flop (didn't bet)
Seat 2: ZAN ua folded before Flop (didn't bet)
Seat 3: studen6 folded before Flop (didn't bet)
Seat 4: ferraresi81 folded before Flop (didn't bet)
Seat 5: rikyrb (button) folded on the Flop
Seat 6: shaneita (small blind) folded on the Turn
Seat 7: scorpoli (big blind) folded on the Turn
Seat 8: TURoff folded before Flop (didn't bet)
Seat 9: olya 01rus collected (42250)





PokerStars Hand #177202878373: Tournament #2067822782, $1.00+$0.10 USD Hold'em No Limit - Level XXIII (1200/2400) - 2017/10/21 22:50:30 CUST [2017/10/21 14:50:30 ET]
Table '2067822782 63' 9-max Seat #6 is the button
Seat 1: AVG3625 (57094 in chips) 
Seat 2: ZAN ua (94995 in chips) 
Seat 3: studen6 (12836 in chips) 
Seat 4: ferraresi81 (27896 in chips) 
Seat 5: rikyrb (72123 in chips) 
Seat 6: shaneita (20000 in chips) 
Seat 7: scorpoli (32724 in chips) 
Seat 8: TURoff (98776 in chips) is sitting out
Seat 9: olya 01rus (62491 in chips) 
AVG3625: posts the ante 300
ZAN ua: posts the ante 300
studen6: posts the ante 300
ferraresi81: posts the ante 300
rikyrb: posts the ante 300
shaneita: posts the ante 300
scorpoli: posts the ante 300
TURoff: posts the ante 300
olya 01rus: posts the ante 300
scorpoli: posts small blind 1200
TURoff: posts big blind 2400
*** HOLE CARDS ***
Dealt to TURoff [5d 7d]
olya 01rus: folds 
AVG3625: folds 
ZAN ua: folds 
studen6: folds 
ferraresi81: folds 
rikyrb: raises 2400 to 4800
shaneita: folds 
scorpoli: calls 3600
TURoff: folds 
*** FLOP *** [5s 8c Kd]
scorpoli: checks 
rikyrb: bets 7350
scorpoli has timed out
scorpoli: folds 
Uncalled bet (7350) returned to rikyrb
scorpoli is sitting out
scorpoli has returned
rikyrb collected 14700 from pot
*** SUMMARY ***
Total pot 14700 | Rake 0 
Board [5s 8c Kd]
Seat 1: AVG3625 folded before Flop (didn't bet)
Seat 2: ZAN ua folded before Flop (didn't bet)
Seat 3: studen6 folded before Flop (didn't bet)
Seat 4: ferraresi81 folded before Flop (didn't bet)
Seat 5: rikyrb collected (14700)
Seat 6: shaneita (button) folded before Flop (didn't bet)
Seat 7: scorpoli (small blind) folded on the Flop
Seat 8: TURoff (big blind) folded before Flop
Seat 9: olya 01rus folded before Flop (didn't bet)





PokerStars Hand #177202940865: Tournament #2067822782, $1.00+$0.10 USD Hold'em No Limit - Level XXIII (1200/2400) - 2017/10/21 22:51:51 CUST [2017/10/21 14:51:51 ET]
Table '2067822782 63' 9-max Seat #7 is the button
Seat 1: AVG3625 (56794 in chips) 
Seat 2: ZAN ua (94695 in chips) 
Seat 3: studen6 (12536 in chips) 
Seat 4: ferraresi81 (27596 in chips) 
Seat 5: rikyrb (81723 in chips) 
Seat 6: shaneita (19700 in chips) 
Seat 7: scorpoli (27624 in chips) 
Seat 8: TURoff (96076 in chips) is sitting out
Seat 9: olya 01rus (62191 in chips) 
AVG3625: posts the ante 300
ZAN ua: posts the ante 300
studen6: posts the ante 300
ferraresi81: posts the ante 300
rikyrb: posts the ante 300
shaneita: posts the ante 300
scorpoli: posts the ante 300
TURoff: posts the ante 300
olya 01rus: posts the ante 300
TURoff: posts small blind 1200
olya 01rus: posts big blind 2400
*** HOLE CARDS ***
Dealt to TURoff [Ts 5h]
AVG3625: folds 
ZAN ua: folds 
studen6: folds 
ferraresi81: folds 
rikyrb: folds 
shaneita: raises 2400 to 4800
scorpoli: folds 
TURoff: folds 
olya 01rus: calls 2400
*** FLOP *** [8s Ks Kd]
olya 01rus: checks 
shaneita: bets 4800
olya 01rus: calls 4800
*** TURN *** [8s Ks Kd] [Qs]
olya 01rus: bets 9600
shaneita: raises 200 to 9800 and is all-in
olya 01rus: calls 200
*** RIVER *** [8s Ks Kd Qs] [6d]
*** SHOW DOWN ***
olya 01rus: shows [2s 4s] (a flush, King high)
shaneita: shows [Ah 5d] (a pair of Kings)
olya 01rus collected 42700 from pot
shaneita finished the tournament in 93rd place and received $4.20.
*** SUMMARY ***
Total pot 42700 | Rake 0 
Board [8s Ks Kd Qs 6d]
Seat 1: AVG3625 folded before Flop (didn't bet)
Seat 2: ZAN ua folded before Flop (didn't bet)
Seat 3: studen6 folded before Flop (didn't bet)
Seat 4: ferraresi81 folded before Flop (didn't bet)
Seat 5: rikyrb folded before Flop (didn't bet)
Seat 6: shaneita showed [Ah 5d] and lost with a pair of Kings
Seat 7: scorpoli (button) folded before Flop (didn't bet)
Seat 8: TURoff (small blind) folded before Flop
Seat 9: olya 01rus (big blind) showed [2s 4s] and won (42700) with a flush, King high





PokerStars Hand #177203038102: Tournament #2067822782, $1.00+$0.10 USD Hold'em No Limit - Level XXIII (1200/2400) - 2017/10/21 22:54:00 CUST [2017/10/21 14:54:00 ET]
Table '2067822782 63' 9-max Seat #8 is the button
Seat 1: AVG3625 (56494 in chips) 
Seat 2: ZAN ua (94395 in chips) 
Seat 3: studen6 (12236 in chips) 
Seat 4: ferraresi81 (27296 in chips) 
Seat 5: rikyrb (81423 in chips) 
Seat 7: scorpoli (27324 in chips) 
Seat 8: TURoff (94576 in chips) is sitting out
Seat 9: olya 01rus (85191 in chips) 
AVG3625: posts the ante 300
ZAN ua: posts the ante 300
studen6: posts the ante 300
ferraresi81: posts the ante 300
rikyrb: posts the ante 300
scorpoli: posts the ante 300
TURoff: posts the ante 300
olya 01rus: posts the ante 300
olya 01rus: posts small blind 1200
AVG3625: posts big blind 2400
*** HOLE CARDS ***
Dealt to TURoff [4h 6s]
ZAN ua: raises 3600 to 6000
studen6: folds 
ferraresi81: folds 
rikyrb: folds 
scorpoli: folds 
TURoff: folds 
TURoff has returned
olya 01rus: folds 
AVG3625: folds 
Uncalled bet (3600) returned to ZAN ua
ZAN ua collected 8400 from pot
ZAN ua: doesn't show hand 
*** SUMMARY ***
Total pot 8400 | Rake 0 
Seat 1: AVG3625 (big blind) folded before Flop
Seat 2: ZAN ua collected (8400)
Seat 3: studen6 folded before Flop (didn't bet)
Seat 4: ferraresi81 folded before Flop (didn't bet)
Seat 5: rikyrb folded before Flop (didn't bet)
Seat 7: scorpoli folded before Flop (didn't bet)
Seat 8: TURoff (button) folded before Flop (didn't bet)
Seat 9: olya 01rus (small blind) folded before Flop





PokerStars Hand #177203066078: Tournament #2067822782, $1.00+$0.10 USD Hold'em No Limit - Level XXIII (1200/2400) - 2017/10/21 22:54:37 CUST [2017/10/21 14:54:37 ET]
Table '2067822782 63' 9-max Seat #9 is the button
Seat 1: AVG3625 (53794 in chips) 
Seat 2: ZAN ua (100095 in chips) 
Seat 3: studen6 (11936 in chips) 
Seat 4: ferraresi81 (26996 in chips) 
Seat 5: rikyrb (81123 in chips) 
Seat 7: scorpoli (27024 in chips) 
Seat 8: TURoff (94276 in chips) 
Seat 9: olya 01rus (83691 in chips) 
AVG3625: posts the ante 300
ZAN ua: posts the ante 300
studen6: posts the ante 300
ferraresi81: posts the ante 300
rikyrb: posts the ante 300
scorpoli: posts the ante 300
TURoff: posts the ante 300
olya 01rus: posts the ante 300
AVG3625: posts small blind 1200
ZAN ua: posts big blind 2400
*** HOLE CARDS ***
Dealt to TURoff [Js Td]
studen6: folds 
ferraresi81: folds 
rikyrb: folds 
scorpoli: folds 
TURoff: raises 2880 to 5280
olya 01rus: folds 
AVG3625: folds 
ZAN ua: calls 2880
*** FLOP *** [Jd 2h Ad]
ZAN ua: checks 
olya 01rus is sitting out
TURoff: bets 7080
ZAN ua: folds 
Uncalled bet (7080) returned to TURoff
TURoff collected 14160 from pot
TURoff: doesn't show hand 
*** SUMMARY ***
Total pot 14160 | Rake 0 
Board [Jd 2h Ad]
Seat 1: AVG3625 (small blind) folded before Flop
Seat 2: ZAN ua (big blind) folded on the Flop
Seat 3: studen6 folded before Flop (didn't bet)
Seat 4: ferraresi81 folded before Flop (didn't bet)
Seat 5: rikyrb folded before Flop (didn't bet)
Seat 7: scorpoli folded before Flop (didn't bet)
Seat 8: TURoff collected (14160)
Seat 9: olya 01rus (button) folded before Flop (didn't bet)





PokerStars Hand #177203303040: Tournament #2067822782, $1.00+$0.10 USD Hold'em No Limit - Level XXIII (1200/2400) - 2017/10/21 23:01:05 CUST [2017/10/21 15:01:05 ET]
Table '2067822782 63' 9-max Seat #1 is the button
Seat 1: AVG3625 (52294 in chips) 
Seat 2: ZAN ua (94515 in chips) 
Seat 3: studen6 (11636 in chips) 
Seat 4: ferraresi81 (26696 in chips) 
Seat 5: rikyrb (80823 in chips) 
Seat 6: vlados1414 (136602 in chips) 
Seat 7: scorpoli (26724 in chips) 
Seat 8: TURoff (102856 in chips) 
Seat 9: olya 01rus (83391 in chips) is sitting out
AVG3625: posts the ante 300
ZAN ua: posts the ante 300
studen6: posts the ante 300
ferraresi81: posts the ante 300
rikyrb: posts the ante 300
vlados1414: posts the ante 300
scorpoli: posts the ante 300
TURoff: posts the ante 300
olya 01rus: posts the ante 300
ZAN ua: posts small blind 1200
studen6: posts big blind 2400
*** HOLE CARDS ***
Dealt to TURoff [Kc 9s]
olya 01rus has returned
ferraresi81: folds 
rikyrb: folds 
vlados1414: folds 
scorpoli: folds 
TURoff: folds 
olya 01rus: folds 
AVG3625: folds 
ZAN ua: raises 7200 to 9600
studen6: raises 1736 to 11336 and is all-in
ZAN ua: calls 1736
*** FLOP *** [8c 5d Qs]
*** TURN *** [8c 5d Qs] [4d]
*** RIVER *** [8c 5d Qs 4d] [2h]
*** SHOW DOWN ***
ZAN ua: shows [4h Th] (a pair of Fours)
studen6: shows [Ah Qh] (a pair of Queens)
studen6 collected 25372 from pot
*** SUMMARY ***
Total pot 25372 | Rake 0 
Board [8c 5d Qs 4d 2h]
Seat 1: AVG3625 (button) folded before Flop (didn't bet)
Seat 2: ZAN ua (small blind) showed [4h Th] and lost with a pair of Fours
Seat 3: studen6 (big blind) showed [Ah Qh] and won (25372) with a pair of Queens
Seat 4: ferraresi81 folded before Flop (didn't bet)
Seat 5: rikyrb folded before Flop (didn't bet)
Seat 6: vlados1414 folded before Flop (didn't bet)
Seat 7: scorpoli folded before Flop (didn't bet)
Seat 8: TURoff folded before Flop (didn't bet)
Seat 9: olya 01rus folded before Flop (didn't bet)





PokerStars Hand #177203351074: Tournament #2067822782, $1.00+$0.10 USD Hold'em No Limit - Level XXIII (1200/2400) - 2017/10/21 23:02:07 CUST [2017/10/21 15:02:07 ET]
Table '2067822782 63' 9-max Seat #2 is the button
Seat 1: AVG3625 (51994 in chips) 
Seat 2: ZAN ua (82879 in chips) 
Seat 3: studen6 (25372 in chips) 
Seat 4: ferraresi81 (26396 in chips) 
Seat 5: rikyrb (80523 in chips) 
Seat 6: vlados1414 (136302 in chips) 
Seat 7: scorpoli (26424 in chips) 
Seat 8: TURoff (102556 in chips) 
Seat 9: olya 01rus (83091 in chips) 
AVG3625: posts the ante 300
ZAN ua: posts the ante 300
studen6: posts the ante 300
ferraresi81: posts the ante 300
rikyrb: posts the ante 300
vlados1414: posts the ante 300
scorpoli: posts the ante 300
TURoff: posts the ante 300
olya 01rus: posts the ante 300
studen6: posts small blind 1200
ferraresi81: posts big blind 2400
*** HOLE CARDS ***
Dealt to TURoff [2d Ah]
rikyrb: folds 
vlados1414: folds 
scorpoli: raises 23724 to 26124 and is all-in
TURoff: folds 
olya 01rus: folds 
AVG3625: folds 
ZAN ua: folds 
studen6: folds 
ferraresi81: folds 
Uncalled bet (23724) returned to scorpoli
scorpoli collected 8700 from pot
scorpoli: doesn't show hand 
*** SUMMARY ***
Total pot 8700 | Rake 0 
Seat 1: AVG3625 folded before Flop (didn't bet)
Seat 2: ZAN ua (button) folded before Flop (didn't bet)
Seat 3: studen6 (small blind) folded before Flop
Seat 4: ferraresi81 (big blind) folded before Flop
Seat 5: rikyrb folded before Flop (didn't bet)
Seat 6: vlados1414 folded before Flop (didn't bet)
Seat 7: scorpoli collected (8700)
Seat 8: TURoff folded before Flop (didn't bet)
Seat 9: olya 01rus folded before Flop (didn't bet)





PokerStars Hand #177203380029: Tournament #2067822782, $1.00+$0.10 USD Hold'em No Limit - Level XXIII (1200/2400) - 2017/10/21 23:02:44 CUST [2017/10/21 15:02:44 ET]
Table '2067822782 63' 9-max Seat #3 is the button
Seat 1: AVG3625 (51694 in chips) 
Seat 2: ZAN ua (82579 in chips) 
Seat 3: studen6 (23872 in chips) 
Seat 4: ferraresi81 (23696 in chips) 
Seat 5: rikyrb (80223 in chips) 
Seat 6: vlados1414 (136002 in chips) 
Seat 7: scorpoli (32424 in chips) 
Seat 8: TURoff (102256 in chips) 
Seat 9: olya 01rus (82791 in chips) 
AVG3625: posts the ante 300
ZAN ua: posts the ante 300
studen6: posts the ante 300
ferraresi81: posts the ante 300
rikyrb: posts the ante 300
vlados1414: posts the ante 300
scorpoli: posts the ante 300
TURoff: posts the ante 300
olya 01rus: posts the ante 300
ferraresi81: posts small blind 1200
rikyrb: posts big blind 2400
*** HOLE CARDS ***
Dealt to TURoff [8d 4c]
vlados1414: raises 4800 to 7200
scorpoli: folds 
TURoff: folds 
olya 01rus: folds 
AVG3625: folds 
ZAN ua: folds 
studen6: folds 
ferraresi81: folds 
rikyrb: folds 
Uncalled bet (4800) returned to vlados1414
vlados1414 collected 8700 from pot
vlados1414: doesn't show hand 
*** SUMMARY ***
Total pot 8700 | Rake 0 
Seat 1: AVG3625 folded before Flop (didn't bet)
Seat 2: ZAN ua folded before Flop (didn't bet)
Seat 3: studen6 (button) folded before Flop (didn't bet)
Seat 4: ferraresi81 (small blind) folded before Flop
Seat 5: rikyrb (big blind) folded before Flop
Seat 6: vlados1414 collected (8700)
Seat 7: scorpoli folded before Flop (didn't bet)
Seat 8: TURoff folded before Flop (didn't bet)
Seat 9: olya 01rus folded before Flop (didn't bet)





PokerStars Hand #177203410330: Tournament #2067822782, $1.00+$0.10 USD Hold'em No Limit - Level XXIII (1200/2400) - 2017/10/21 23:03:21 CUST [2017/10/21 15:03:21 ET]
Table '2067822782 63' 9-max Seat #4 is the button
Seat 2: ZAN ua (82279 in chips) 
Seat 3: studen6 (23572 in chips) 
Seat 4: ferraresi81 (22196 in chips) 
Seat 5: rikyrb (77523 in chips) 
Seat 6: vlados1414 (142002 in chips) 
Seat 7: scorpoli (32124 in chips) 
Seat 8: TURoff (101956 in chips) 
Seat 9: olya 01rus (82491 in chips) 
ZAN ua: posts the ante 300
studen6: posts the ante 300
ferraresi81: posts the ante 300
rikyrb: posts the ante 300
vlados1414: posts the ante 300
scorpoli: posts the ante 300
TURoff: posts the ante 300
olya 01rus: posts the ante 300
rikyrb: posts small blind 1200
vlados1414: posts big blind 2400
*** HOLE CARDS ***
Dealt to TURoff [8s Jc]
scorpoli: folds 
TURoff: folds 
olya 01rus: folds 
ZAN ua: folds 
studen6: folds 
ferraresi81: raises 19496 to 21896 and is all-in
rikyrb: folds 
vlados1414: folds 
Uncalled bet (19496) returned to ferraresi81
ferraresi81 collected 8400 from pot
ferraresi81: doesn't show hand 
*** SUMMARY ***
Total pot 8400 | Rake 0 
Seat 2: ZAN ua folded before Flop (didn't bet)
Seat 3: studen6 folded before Flop (didn't bet)
Seat 4: ferraresi81 (button) collected (8400)
Seat 5: rikyrb (small blind) folded before Flop
Seat 6: vlados1414 (big blind) folded before Flop
Seat 7: scorpoli folded before Flop (didn't bet)
Seat 8: TURoff folded before Flop (didn't bet)
Seat 9: olya 01rus folded before Flop (didn't bet)





PokerStars Hand #177203451770: Tournament #2067822782, $1.00+$0.10 USD Hold'em No Limit - Level XXIV (1400/2800) - 2017/10/21 23:04:14 CUST [2017/10/21 15:04:14 ET]
Table '2067822782 63' 9-max Seat #5 is the button
Seat 2: ZAN ua (81979 in chips) 
Seat 3: studen6 (23272 in chips) 
Seat 4: ferraresi81 (27896 in chips) 
Seat 5: rikyrb (76023 in chips) 
Seat 6: vlados1414 (139302 in chips) 
Seat 7: scorpoli (31824 in chips) 
Seat 8: TURoff (101656 in chips) 
Seat 9: olya 01rus (82191 in chips) 
ZAN ua: posts the ante 350
studen6: posts the ante 350
ferraresi81: posts the ante 350
rikyrb: posts the ante 350
vlados1414: posts the ante 350
scorpoli: posts the ante 350
TURoff: posts the ante 350
olya 01rus: posts the ante 350
vlados1414: posts small blind 1400
scorpoli: posts big blind 2800
*** HOLE CARDS ***
Dealt to TURoff [4c Ts]
TURoff: folds 
olya 01rus: calls 2800
ZAN ua: folds 
studen6: folds 
ferraresi81: folds 
rikyrb: folds 
vlados1414: calls 1400
scorpoli: checks 
*** FLOP *** [Tc 3c 2s]
vlados1414: checks 
scorpoli: checks 
olya 01rus: checks 
*** TURN *** [Tc 3c 2s] [7h]
vlados1414: checks 
scorpoli: checks 
olya 01rus: checks 
*** RIVER *** [Tc 3c 2s 7h] [2c]
vlados1414: bets 2800
scorpoli: folds 
olya 01rus: folds 
Uncalled bet (2800) returned to vlados1414
vlados1414 collected 11200 from pot
vlados1414: doesn't show hand 
*** SUMMARY ***
Total pot 11200 | Rake 0 
Board [Tc 3c 2s 7h 2c]
Seat 2: ZAN ua folded before Flop (didn't bet)
Seat 3: studen6 folded before Flop (didn't bet)
Seat 4: ferraresi81 folded before Flop (didn't bet)
Seat 5: rikyrb (button) folded before Flop (didn't bet)
Seat 6: vlados1414 (small blind) collected (11200)
Seat 7: scorpoli (big blind) folded on the River
Seat 8: TURoff folded before Flop (didn't bet)
Seat 9: olya 01rus folded on the River





PokerStars Hand #177203560152: Tournament #2067822782, $1.00+$0.10 USD Hold'em No Limit - Level XXIV (1400/2800) - 2017/10/21 23:06:27 CUST [2017/10/21 15:06:27 ET]
Table '2067822782 63' 9-max Seat #6 is the button
Seat 2: ZAN ua (81629 in chips) 
Seat 3: studen6 (22922 in chips) 
Seat 4: ferraresi81 (27546 in chips) 
Seat 5: rikyrb (75673 in chips) 
Seat 6: vlados1414 (147352 in chips) 
Seat 7: scorpoli (28674 in chips) 
Seat 8: TURoff (101306 in chips) 
Seat 9: olya 01rus (79041 in chips) 
ZAN ua: posts the ante 350
studen6: posts the ante 350
ferraresi81: posts the ante 350
rikyrb: posts the ante 350
vlados1414: posts the ante 350
scorpoli: posts the ante 350
TURoff: posts the ante 350
olya 01rus: posts the ante 350
scorpoli: posts small blind 1400
TURoff: posts big blind 2800
*** HOLE CARDS ***
Dealt to TURoff [5c 6d]
olya 01rus: raises 5600 to 8400
ZAN ua: folds 
studen6: folds 
ferraresi81: folds 
rikyrb: folds 
vlados1414: folds 
scorpoli: folds 
TURoff: folds 
Uncalled bet (5600) returned to olya 01rus
olya 01rus collected 9800 from pot
olya 01rus: doesn't show hand 
*** SUMMARY ***
Total pot 9800 | Rake 0 
Seat 2: ZAN ua folded before Flop (didn't bet)
Seat 3: studen6 folded before Flop (didn't bet)
Seat 4: ferraresi81 folded before Flop (didn't bet)
Seat 5: rikyrb folded before Flop (didn't bet)
Seat 6: vlados1414 (button) folded before Flop (didn't bet)
Seat 7: scorpoli (small blind) folded before Flop
Seat 8: TURoff (big blind) folded before Flop
Seat 9: olya 01rus collected (9800)





PokerStars Hand #177203589371: Tournament #2067822782, $1.00+$0.10 USD Hold'em No Limit - Level XXIV (1400/2800) - 2017/10/21 23:07:03 CUST [2017/10/21 15:07:03 ET]
Table '2067822782 63' 9-max Seat #7 is the button
Seat 2: ZAN ua (81279 in chips) 
Seat 3: studen6 (22572 in chips) 
Seat 4: ferraresi81 (27196 in chips) 
Seat 5: rikyrb (75323 in chips) 
Seat 6: vlados1414 (147002 in chips) 
Seat 7: scorpoli (26924 in chips) 
Seat 8: TURoff (98156 in chips) 
Seat 9: olya 01rus (85691 in chips) 
ZAN ua: posts the ante 350
studen6: posts the ante 350
ferraresi81: posts the ante 350
rikyrb: posts the ante 350
vlados1414: posts the ante 350
scorpoli: posts the ante 350
TURoff: posts the ante 350
olya 01rus: posts the ante 350
TURoff: posts small blind 1400
olya 01rus: posts big blind 2800
*** HOLE CARDS ***
Dealt to TURoff [9c 5s]
ZAN ua: raises 2800 to 5600
studen6: folds 
ferraresi81 has timed out
ferraresi81: folds 
ferraresi81 is sitting out
rikyrb: folds 
vlados1414: folds 
ferraresi81 has returned
scorpoli: raises 2800 to 8400
TURoff: folds 
olya 01rus: folds 
ZAN ua: folds 
Uncalled bet (2800) returned to scorpoli
scorpoli collected 18200 from pot
scorpoli: doesn't show hand 
*** SUMMARY ***
Total pot 18200 | Rake 0 
Seat 2: ZAN ua folded before Flop
Seat 3: studen6 folded before Flop (didn't bet)
Seat 4: ferraresi81 folded before Flop (didn't bet)
Seat 5: rikyrb folded before Flop (didn't bet)
Seat 6: vlados1414 folded before Flop (didn't bet)
Seat 7: scorpoli (button) collected (18200)
Seat 8: TURoff (small blind) folded before Flop
Seat 9: olya 01rus (big blind) folded before Flop





PokerStars Hand #177203638909: Tournament #2067822782, $1.00+$0.10 USD Hold'em No Limit - Level XXIV (1400/2800) - 2017/10/21 23:08:04 CUST [2017/10/21 15:08:04 ET]
Table '2067822782 63' 9-max Seat #8 is the button
Seat 2: ZAN ua (75329 in chips) 
Seat 3: studen6 (22222 in chips) 
Seat 4: ferraresi81 (26846 in chips) 
Seat 5: rikyrb (74973 in chips) 
Seat 6: vlados1414 (146652 in chips) 
Seat 7: scorpoli (39174 in chips) 
Seat 8: TURoff (96406 in chips) 
Seat 9: olya 01rus (82541 in chips) 
ZAN ua: posts the ante 350
studen6: posts the ante 350
ferraresi81: posts the ante 350
rikyrb: posts the ante 350
vlados1414: posts the ante 350
scorpoli: posts the ante 350
TURoff: posts the ante 350
olya 01rus: posts the ante 350
olya 01rus: posts small blind 1400
ZAN ua: posts big blind 2800
*** HOLE CARDS ***
Dealt to TURoff [9s Kc]
studen6: folds 
ferraresi81: folds 
rikyrb: folds 
vlados1414: folds 
scorpoli: folds 
TURoff: raises 3360 to 6160
olya 01rus: folds 
ZAN ua: raises 13440 to 19600
TURoff: folds 
Uncalled bet (13440) returned to ZAN ua
ZAN ua collected 16520 from pot
ZAN ua: doesn't show hand 
*** SUMMARY ***
Total pot 16520 | Rake 0 
Seat 2: ZAN ua (big blind) collected (16520)
Seat 3: studen6 folded before Flop (didn't bet)
Seat 4: ferraresi81 folded before Flop (didn't bet)
Seat 5: rikyrb folded before Flop (didn't bet)
Seat 6: vlados1414 folded before Flop (didn't bet)
Seat 7: scorpoli folded before Flop (didn't bet)
Seat 8: TURoff (button) folded before Flop
Seat 9: olya 01rus (small blind) folded before Flop





PokerStars Hand #177203680520: Tournament #2067822782, $1.00+$0.10 USD Hold'em No Limit - Level XXIV (1400/2800) - 2017/10/21 23:08:55 CUST [2017/10/21 15:08:55 ET]
Table '2067822782 63' 9-max Seat #9 is the button
Seat 1: hapunkt (43169 in chips) out of hand (moved from another table into small blind)
Seat 2: ZAN ua (85339 in chips) 
Seat 3: studen6 (21872 in chips) 
Seat 4: ferraresi81 (26496 in chips) 
Seat 5: rikyrb (74623 in chips) 
Seat 6: vlados1414 (146302 in chips) 
Seat 7: scorpoli (38824 in chips) 
Seat 8: TURoff (89896 in chips) 
Seat 9: olya 01rus (80791 in chips) 
ZAN ua: posts the ante 350
studen6: posts the ante 350
ferraresi81: posts the ante 350
rikyrb: posts the ante 350
vlados1414: posts the ante 350
scorpoli: posts the ante 350
TURoff: posts the ante 350
olya 01rus: posts the ante 350
ZAN ua: posts small blind 1400
studen6: posts big blind 2800
*** HOLE CARDS ***
Dealt to TURoff [6s 9h]
ferraresi81: raises 23346 to 26146 and is all-in
rikyrb: folds 
vlados1414: folds 
scorpoli: folds 
TURoff: folds 
olya 01rus: folds 
ZAN ua: folds 
studen6: folds 
Uncalled bet (23346) returned to ferraresi81
ferraresi81 collected 9800 from pot
ferraresi81: doesn't show hand 
*** SUMMARY ***
Total pot 9800 | Rake 0 
Seat 2: ZAN ua (small blind) folded before Flop
Seat 3: studen6 (big blind) folded before Flop
Seat 4: ferraresi81 collected (9800)
Seat 5: rikyrb folded before Flop (didn't bet)
Seat 6: vlados1414 folded before Flop (didn't bet)
Seat 7: scorpoli folded before Flop (didn't bet)
Seat 8: TURoff folded before Flop (didn't bet)
Seat 9: olya 01rus (button) folded before Flop (didn't bet)





PokerStars Hand #177203702496: Tournament #2067822782, $1.00+$0.10 USD Hold'em No Limit - Level XXIV (1400/2800) - 2017/10/21 23:09:22 CUST [2017/10/21 15:09:22 ET]
Table '2067822782 63' 9-max Seat #2 is the button
Seat 1: hapunkt (43169 in chips) 
Seat 2: ZAN ua (83589 in chips) 
Seat 3: studen6 (18722 in chips) 
Seat 4: ferraresi81 (33146 in chips) 
Seat 5: rikyrb (74273 in chips) 
Seat 6: vlados1414 (145952 in chips) 
Seat 7: scorpoli (38474 in chips) 
Seat 8: TURoff (89546 in chips) 
Seat 9: olya 01rus (80441 in chips) 
hapunkt: posts the ante 350
ZAN ua: posts the ante 350
studen6: posts the ante 350
ferraresi81: posts the ante 350
rikyrb: posts the ante 350
vlados1414: posts the ante 350
scorpoli: posts the ante 350
TURoff: posts the ante 350
olya 01rus: posts the ante 350
studen6: posts small blind 1400
ferraresi81: posts big blind 2800
*** HOLE CARDS ***
Dealt to TURoff [Td As]
rikyrb: folds 
vlados1414: folds 
scorpoli: folds 
TURoff: raises 3360 to 6160
olya 01rus: folds 
hapunkt: folds 
ZAN ua: folds 
studen6: raises 7840 to 14000
ferraresi81: folds 
TURoff: raises 7840 to 21840
studen6: calls 4372 and is all-in
Uncalled bet (3468) returned to TURoff
*** FLOP *** [9h Ad Ts]
*** TURN *** [9h Ad Ts] [9c]
*** RIVER *** [9h Ad Ts 9c] [6d]
*** SHOW DOWN ***
studen6: shows [Kh Ks] (two pair, Kings and Nines)
TURoff: shows [Td As] (two pair, Aces and Tens)
TURoff collected 42694 from pot
studen6 finished the tournament in 78th place and received $4.20.
*** SUMMARY ***
Total pot 42694 | Rake 0 
Board [9h Ad Ts 9c 6d]
Seat 1: hapunkt folded before Flop (didn't bet)
Seat 2: ZAN ua (button) folded before Flop (didn't bet)
Seat 3: studen6 (small blind) showed [Kh Ks] and lost with two pair, Kings and Nines
Seat 4: ferraresi81 (big blind) folded before Flop
Seat 5: rikyrb folded before Flop (didn't bet)
Seat 6: vlados1414 folded before Flop (didn't bet)
Seat 7: scorpoli folded before Flop (didn't bet)
Seat 8: TURoff showed [Td As] and won (42694) with two pair, Aces and Tens
Seat 9: olya 01rus folded before Flop (didn't bet)





PokerStars Hand #177203739507: Tournament #2067822782, $1.00+$0.10 USD Hold'em No Limit - Level XXIV (1400/2800) - 2017/10/21 23:10:07 CUST [2017/10/21 15:10:07 ET]
Table '2067822782 63' 9-max Seat #4 is the button
Seat 1: hapunkt (42819 in chips) 
Seat 2: ZAN ua (83239 in chips) 
Seat 4: ferraresi81 (29996 in chips) 
Seat 5: rikyrb (73923 in chips) 
Seat 6: vlados1414 (145602 in chips) 
Seat 7: scorpoli (38124 in chips) 
Seat 8: TURoff (113518 in chips) 
Seat 9: olya 01rus (80091 in chips) 
hapunkt: posts the ante 350
ZAN ua: posts the ante 350
ferraresi81: posts the ante 350
rikyrb: posts the ante 350
vlados1414: posts the ante 350
scorpoli: posts the ante 350
TURoff: posts the ante 350
olya 01rus: posts the ante 350
rikyrb: posts small blind 1400
vlados1414: posts big blind 2800
*** HOLE CARDS ***
Dealt to TURoff [7c Kh]
scorpoli: folds 
TURoff: folds 
olya 01rus: folds 
hapunkt: folds 
ZAN ua: folds 
ferraresi81: folds 
rikyrb: folds 
Uncalled bet (1400) returned to vlados1414
vlados1414 collected 5600 from pot
vlados1414: doesn't show hand 
*** SUMMARY ***
Total pot 5600 | Rake 0 
Seat 1: hapunkt folded before Flop (didn't bet)
Seat 2: ZAN ua folded before Flop (didn't bet)
Seat 4: ferraresi81 (button) folded before Flop (didn't bet)
Seat 5: rikyrb (small blind) folded before Flop
Seat 6: vlados1414 (big blind) collected (5600)
Seat 7: scorpoli folded before Flop (didn't bet)
Seat 8: TURoff folded before Flop (didn't bet)
Seat 9: olya 01rus folded before Flop (didn't bet)





PokerStars Hand #177203766653: Tournament #2067822782, $1.00+$0.10 USD Hold'em No Limit - Level XXIV (1400/2800) - 2017/10/21 23:10:41 CUST [2017/10/21 15:10:41 ET]
Table '2067822782 63' 9-max Seat #5 is the button
Seat 1: hapunkt (42469 in chips) 
Seat 2: ZAN ua (82889 in chips) 
Seat 4: ferraresi81 (29646 in chips) 
Seat 5: rikyrb (72173 in chips) 
Seat 6: vlados1414 (149452 in chips) 
Seat 7: scorpoli (37774 in chips) 
Seat 8: TURoff (113168 in chips) 
Seat 9: olya 01rus (79741 in chips) 
hapunkt: posts the ante 350
ZAN ua: posts the ante 350
ferraresi81: posts the ante 350
rikyrb: posts the ante 350
vlados1414: posts the ante 350
scorpoli: posts the ante 350
TURoff: posts the ante 350
olya 01rus: posts the ante 350
vlados1414: posts small blind 1400
scorpoli: posts big blind 2800
*** HOLE CARDS ***
Dealt to TURoff [7h 5s]
TURoff: folds 
olya 01rus: calls 2800
hapunkt: folds 
ZAN ua: folds 
ferraresi81: folds 
rikyrb: raises 5600 to 8400
vlados1414: folds 
scorpoli: folds 
olya 01rus: folds 
Uncalled bet (5600) returned to rikyrb
rikyrb collected 12600 from pot
*** SUMMARY ***
Total pot 12600 | Rake 0 
Seat 1: hapunkt folded before Flop (didn't bet)
Seat 2: ZAN ua folded before Flop (didn't bet)
Seat 4: ferraresi81 folded before Flop (didn't bet)
Seat 5: rikyrb (button) collected (12600)
Seat 6: vlados1414 (small blind) folded before Flop
Seat 7: scorpoli (big blind) folded before Flop
Seat 8: TURoff folded before Flop (didn't bet)
Seat 9: olya 01rus folded before Flop





PokerStars Hand #177203819548: Tournament #2067822782, $1.00+$0.10 USD Hold'em No Limit - Level XXIV (1400/2800) - 2017/10/21 23:11:46 CUST [2017/10/21 15:11:46 ET]
Table '2067822782 63' 9-max Seat #6 is the button
Seat 1: hapunkt (42119 in chips) 
Seat 2: ZAN ua (82539 in chips) 
Seat 4: ferraresi81 (29296 in chips) 
Seat 5: rikyrb (81623 in chips) 
Seat 6: vlados1414 (147702 in chips) 
Seat 7: scorpoli (34624 in chips) 
Seat 8: TURoff (112818 in chips) 
Seat 9: olya 01rus (76591 in chips) 
hapunkt: posts the ante 350
ZAN ua: posts the ante 350
ferraresi81: posts the ante 350
rikyrb: posts the ante 350
vlados1414: posts the ante 350
scorpoli: posts the ante 350
TURoff: posts the ante 350
olya 01rus: posts the ante 350
scorpoli: posts small blind 1400
TURoff: posts big blind 2800
*** HOLE CARDS ***
Dealt to TURoff [Kc 8h]
olya 01rus: folds 
hapunkt: folds 
ZAN ua: folds 
ferraresi81: folds 
rikyrb: folds 
vlados1414: folds 
scorpoli: raises 31474 to 34274 and is all-in
TURoff: folds 
Uncalled bet (31474) returned to scorpoli
scorpoli collected 8400 from pot
scorpoli: doesn't show hand 
*** SUMMARY ***
Total pot 8400 | Rake 0 
Seat 1: hapunkt folded before Flop (didn't bet)
Seat 2: ZAN ua folded before Flop (didn't bet)
Seat 4: ferraresi81 folded before Flop (didn't bet)
Seat 5: rikyrb folded before Flop (didn't bet)
Seat 6: vlados1414 (button) folded before Flop (didn't bet)
Seat 7: scorpoli (small blind) collected (8400)
Seat 8: TURoff (big blind) folded before Flop
Seat 9: olya 01rus folded before Flop (didn't bet)





PokerStars Hand #177203840280: Tournament #2067822782, $1.00+$0.10 USD Hold'em No Limit - Level XXIV (1400/2800) - 2017/10/21 23:12:12 CUST [2017/10/21 15:12:12 ET]
Table '2067822782 63' 9-max Seat #7 is the button
Seat 1: hapunkt (41769 in chips) 
Seat 2: ZAN ua (82189 in chips) 
Seat 4: ferraresi81 (28946 in chips) 
Seat 5: rikyrb (81273 in chips) 
Seat 6: vlados1414 (147352 in chips) 
Seat 7: scorpoli (39874 in chips) 
Seat 8: TURoff (109668 in chips) 
Seat 9: olya 01rus (76241 in chips) 
hapunkt: posts the ante 350
ZAN ua: posts the ante 350
ferraresi81: posts the ante 350
rikyrb: posts the ante 350
vlados1414: posts the ante 350
scorpoli: posts the ante 350
TURoff: posts the ante 350
olya 01rus: posts the ante 350
TURoff: posts small blind 1400
olya 01rus: posts big blind 2800
*** HOLE CARDS ***
Dealt to TURoff [3s Qd]
hapunkt: folds 
ZAN ua: raises 4200 to 7000
ferraresi81: folds 
rikyrb: folds 
vlados1414: folds 
scorpoli: folds 
TURoff: folds 
olya 01rus: folds 
Uncalled bet (4200) returned to ZAN ua
ZAN ua collected 9800 from pot
ZAN ua: doesn't show hand 
*** SUMMARY ***
Total pot 9800 | Rake 0 
Seat 1: hapunkt folded before Flop (didn't bet)
Seat 2: ZAN ua collected (9800)
Seat 4: ferraresi81 folded before Flop (didn't bet)
Seat 5: rikyrb folded before Flop (didn't bet)
Seat 6: vlados1414 folded before Flop (didn't bet)
Seat 7: scorpoli (button) folded before Flop (didn't bet)
Seat 8: TURoff (small blind) folded before Flop
Seat 9: olya 01rus (big blind) folded before Flop





PokerStars Hand #177203869104: Tournament #2067822782, $1.00+$0.10 USD Hold'em No Limit - Level XXIV (1400/2800) - 2017/10/21 23:12:48 CUST [2017/10/21 15:12:48 ET]
Table '2067822782 63' 9-max Seat #8 is the button
Seat 1: hapunkt (41419 in chips) 
Seat 2: ZAN ua (88839 in chips) 
Seat 4: ferraresi81 (28596 in chips) 
Seat 5: rikyrb (80923 in chips) 
Seat 6: vlados1414 (147002 in chips) 
Seat 7: scorpoli (39524 in chips) 
Seat 8: TURoff (107918 in chips) 
Seat 9: olya 01rus (73091 in chips) 
hapunkt: posts the ante 350
ZAN ua: posts the ante 350
ferraresi81: posts the ante 350
rikyrb: posts the ante 350
vlados1414: posts the ante 350
scorpoli: posts the ante 350
TURoff: posts the ante 350
olya 01rus: posts the ante 350
olya 01rus: posts small blind 1400
hapunkt: posts big blind 2800
*** HOLE CARDS ***
Dealt to TURoff [6h 3s]
ZAN ua: folds 
ferraresi81: folds 
rikyrb: folds 
vlados1414: calls 2800
scorpoli: folds 
TURoff: folds 
olya 01rus: calls 1400
hapunkt: checks 
*** FLOP *** [Jc Kh 2d]
olya 01rus: checks 
hapunkt: checks 
vlados1414: bets 2800
olya 01rus: raises 2800 to 5600
hapunkt: folds 
vlados1414: calls 2800
*** TURN *** [Jc Kh 2d] [4h]
olya 01rus: checks 
vlados1414: checks 
*** RIVER *** [Jc Kh 2d 4h] [Jd]
olya 01rus: bets 2800
vlados1414: folds 
Uncalled bet (2800) returned to olya 01rus
olya 01rus collected 22400 from pot
olya 01rus: doesn't show hand 
*** SUMMARY ***
Total pot 22400 | Rake 0 
Board [Jc Kh 2d 4h Jd]
Seat 1: hapunkt (big blind) folded on the Flop
Seat 2: ZAN ua folded before Flop (didn't bet)
Seat 4: ferraresi81 folded before Flop (didn't bet)
Seat 5: rikyrb folded before Flop (didn't bet)
Seat 6: vlados1414 folded on the River
Seat 7: scorpoli folded before Flop (didn't bet)
Seat 8: TURoff (button) folded before Flop (didn't bet)
Seat 9: olya 01rus (small blind) collected (22400)





PokerStars Hand #177203942015: Tournament #2067822782, $1.00+$0.10 USD Hold'em No Limit - Level XXV (1600/3200) - 2017/10/21 23:14:18 CUST [2017/10/21 15:14:18 ET]
Table '2067822782 63' 9-max Seat #9 is the button
Seat 1: hapunkt (38269 in chips) 
Seat 2: ZAN ua (88489 in chips) 
Seat 4: ferraresi81 (28246 in chips) 
Seat 5: rikyrb (80573 in chips) 
Seat 6: vlados1414 (138252 in chips) 
Seat 7: scorpoli (39174 in chips) 
Seat 8: TURoff (107568 in chips) 
Seat 9: olya 01rus (86741 in chips) 
hapunkt: posts the ante 400
ZAN ua: posts the ante 400
ferraresi81: posts the ante 400
rikyrb: posts the ante 400
vlados1414: posts the ante 400
scorpoli: posts the ante 400
TURoff: posts the ante 400
olya 01rus: posts the ante 400
hapunkt: posts small blind 1600
ZAN ua: posts big blind 3200
*** HOLE CARDS ***
Dealt to TURoff [3d Js]
ferraresi81: folds 
rikyrb: folds 
vlados1414: folds 
scorpoli: folds 
TURoff: folds 
olya 01rus: calls 3200
hapunkt: folds 
ZAN ua: checks 
*** FLOP *** [Td 7c Tc]
ZAN ua: checks 
olya 01rus: bets 5600
ZAN ua: folds 
Uncalled bet (5600) returned to olya 01rus
olya 01rus collected 11200 from pot
olya 01rus: doesn't show hand 
*** SUMMARY ***
Total pot 11200 | Rake 0 
Board [Td 7c Tc]
Seat 1: hapunkt (small blind) folded before Flop
Seat 2: ZAN ua (big blind) folded on the Flop
Seat 4: ferraresi81 folded before Flop (didn't bet)
Seat 5: rikyrb folded before Flop (didn't bet)
Seat 6: vlados1414 folded before Flop (didn't bet)
Seat 7: scorpoli folded before Flop (didn't bet)
Seat 8: TURoff folded before Flop (didn't bet)
Seat 9: olya 01rus (button) collected (11200)





PokerStars Hand #177203984813: Tournament #2067822782, $1.00+$0.10 USD Hold'em No Limit - Level XXV (1600/3200) - 2017/10/21 23:15:11 CUST [2017/10/21 15:15:11 ET]
Table '2067822782 63' 9-max Seat #1 is the button
Seat 1: hapunkt (36269 in chips) 
Seat 2: ZAN ua (84889 in chips) 
Seat 4: ferraresi81 (27846 in chips) 
Seat 5: rikyrb (80173 in chips) 
Seat 6: vlados1414 (137852 in chips) 
Seat 7: scorpoli (38774 in chips) 
Seat 8: TURoff (107168 in chips) 
Seat 9: olya 01rus (94341 in chips) 
hapunkt: posts the ante 400
ZAN ua: posts the ante 400
ferraresi81: posts the ante 400
rikyrb: posts the ante 400
vlados1414: posts the ante 400
scorpoli: posts the ante 400
TURoff: posts the ante 400
olya 01rus: posts the ante 400
ZAN ua: posts small blind 1600
ferraresi81: posts big blind 3200
*** HOLE CARDS ***
Dealt to TURoff [Ts 9s]
rikyrb: folds 
vlados1414: folds 
scorpoli: folds 
TURoff: raises 3840 to 7040
olya 01rus: folds 
hapunkt: folds 
ZAN ua: raises 77449 to 84489 and is all-in
ferraresi81: folds 
TURoff: folds 
Uncalled bet (77449) returned to ZAN ua
ZAN ua collected 20480 from pot
ZAN ua: doesn't show hand 
*** SUMMARY ***
Total pot 20480 | Rake 0 
Seat 1: hapunkt (button) folded before Flop (didn't bet)
Seat 2: ZAN ua (small blind) collected (20480)
Seat 4: ferraresi81 (big blind) folded before Flop
Seat 5: rikyrb folded before Flop (didn't bet)
Seat 6: vlados1414 folded before Flop (didn't bet)
Seat 7: scorpoli folded before Flop (didn't bet)
Seat 8: TURoff folded before Flop
Seat 9: olya 01rus folded before Flop (didn't bet)





PokerStars Hand #177204021364: Tournament #2067822782, $1.00+$0.10 USD Hold'em No Limit - Level XXV (1600/3200) - 2017/10/21 23:15:56 CUST [2017/10/21 15:15:56 ET]
Table '2067822782 63' 9-max Seat #2 is the button
Seat 1: hapunkt (35869 in chips) 
Seat 2: ZAN ua (97929 in chips) 
Seat 4: ferraresi81 (24246 in chips) 
Seat 5: rikyrb (79773 in chips) 
Seat 6: vlados1414 (137452 in chips) 
Seat 7: scorpoli (38374 in chips) 
Seat 8: TURoff (99728 in chips) 
Seat 9: olya 01rus (93941 in chips) 
hapunkt: posts the ante 400
ZAN ua: posts the ante 400
ferraresi81: posts the ante 400
rikyrb: posts the ante 400
vlados1414: posts the ante 400
scorpoli: posts the ante 400
TURoff: posts the ante 400
olya 01rus: posts the ante 400
ferraresi81: posts small blind 1600
rikyrb: posts big blind 3200
*** HOLE CARDS ***
Dealt to TURoff [Ks 4c]
vlados1414: calls 3200
scorpoli: calls 3200
TURoff: folds 
olya 01rus: folds 
hapunkt: raises 32269 to 35469 and is all-in
ZAN ua: folds 
ferraresi81: folds 
rikyrb: folds 
vlados1414: folds 
scorpoli: calls 32269
*** FLOP *** [6d 7h 2s]
*** TURN *** [6d 7h 2s] [Td]
*** RIVER *** [6d 7h 2s Td] [Kd]
*** SHOW DOWN ***
scorpoli: shows [3c 3s] (a pair of Threes)
hapunkt: shows [Ac 8s] (high card Ace)
scorpoli collected 82138 from pot
hapunkt finished the tournament in 73rd place and received $4.20.
*** SUMMARY ***
Total pot 82138 | Rake 0 
Board [6d 7h 2s Td Kd]
Seat 1: hapunkt showed [Ac 8s] and lost with high card Ace
Seat 2: ZAN ua (button) folded before Flop (didn't bet)
Seat 4: ferraresi81 (small blind) folded before Flop
Seat 5: rikyrb (big blind) folded before Flop
Seat 6: vlados1414 folded before Flop
Seat 7: scorpoli showed [3c 3s] and won (82138) with a pair of Threes
Seat 8: TURoff folded before Flop (didn't bet)
Seat 9: olya 01rus folded before Flop (didn't bet)





PokerStars Hand #177204104313: Tournament #2067822782, $1.00+$0.10 USD Hold'em No Limit - Level XXV (1600/3200) - 2017/10/21 23:17:38 CUST [2017/10/21 15:17:38 ET]
Table '2067822782 41' 9-max Seat #7 is the button
Seat 1: IIlllllllII (133681 in chips) 
Seat 2: rgvaz85 (95411 in chips) 
Seat 3: iudicus (49725 in chips) 
Seat 4: PECAHE (129460 in chips) 
Seat 5: harley947 (120747 in chips) 
Seat 6: Fiura25 (159149 in chips) 
Seat 7: <Bogolal> (89466 in chips) 
Seat 8: HiredGun99 (122456 in chips) 
Seat 9: TURoff (99328 in chips) 
IIlllllllII: posts the ante 400
rgvaz85: posts the ante 400
iudicus: posts the ante 400
PECAHE: posts the ante 400
harley947: posts the ante 400
Fiura25: posts the ante 400
<Bogolal>: posts the ante 400
HiredGun99: posts the ante 400
TURoff: posts the ante 400
HiredGun99: posts small blind 1600
TURoff: posts big blind 3200
*** HOLE CARDS ***
Dealt to TURoff [4s 3s]
IIlllllllII: folds 
rgvaz85: folds 
iudicus: raises 46125 to 49325 and is all-in
PECAHE: folds 
harley947: folds 
Fiura25: folds 
<Bogolal>: folds 
HiredGun99: folds 
TURoff: folds 
Uncalled bet (46125) returned to iudicus
iudicus collected 11600 from pot
iudicus: doesn't show hand 
*** SUMMARY ***
Total pot 11600 | Rake 0 
Seat 1: IIlllllllII folded before Flop (didn't bet)
Seat 2: rgvaz85 folded before Flop (didn't bet)
Seat 3: iudicus collected (11600)
Seat 4: PECAHE folded before Flop (didn't bet)
Seat 5: harley947 folded before Flop (didn't bet)
Seat 6: Fiura25 folded before Flop (didn't bet)
Seat 7: <Bogolal> (button) folded before Flop (didn't bet)
Seat 8: HiredGun99 (small blind) folded before Flop
Seat 9: TURoff (big blind) folded before Flop





PokerStars Hand #177204135358: Tournament #2067822782, $1.00+$0.10 USD Hold'em No Limit - Level XXV (1600/3200) - 2017/10/21 23:18:16 CUST [2017/10/21 15:18:16 ET]
Table '2067822782 41' 9-max Seat #8 is the button
Seat 1: IIlllllllII (133281 in chips) 
Seat 2: rgvaz85 (95011 in chips) 
Seat 3: iudicus (57725 in chips) 
Seat 4: PECAHE (129060 in chips) 
Seat 5: harley947 (120347 in chips) 
Seat 6: Fiura25 (158749 in chips) 
Seat 7: <Bogolal> (89066 in chips) 
Seat 8: HiredGun99 (120456 in chips) 
Seat 9: TURoff (95728 in chips) 
IIlllllllII: posts the ante 400
rgvaz85: posts the ante 400
iudicus: posts the ante 400
PECAHE: posts the ante 400
harley947: posts the ante 400
Fiura25: posts the ante 400
<Bogolal>: posts the ante 400
HiredGun99: posts the ante 400
TURoff: posts the ante 400
TURoff: posts small blind 1600
IIlllllllII: posts big blind 3200
*** HOLE CARDS ***
Dealt to TURoff [6c 6d]
rgvaz85: folds 
iudicus: folds 
PECAHE: folds 
harley947: folds 
Fiura25: raises 6400 to 9600
<Bogolal>: folds 
HiredGun99: folds 
TURoff: calls 8000
IIlllllllII: folds 
*** FLOP *** [Jc 4c 7d]
TURoff: checks 
Fiura25: bets 3200
TURoff: calls 3200
*** TURN *** [Jc 4c 7d] [3s]
TURoff: checks 
Fiura25: bets 32400
TURoff: folds 
Uncalled bet (32400) returned to Fiura25
Fiura25 collected 32400 from pot
Fiura25: doesn't show hand 
*** SUMMARY ***
Total pot 32400 | Rake 0 
Board [Jc 4c 7d 3s]
Seat 1: IIlllllllII (big blind) folded before Flop
Seat 2: rgvaz85 folded before Flop (didn't bet)
Seat 3: iudicus folded before Flop (didn't bet)
Seat 4: PECAHE folded before Flop (didn't bet)
Seat 5: harley947 folded before Flop (didn't bet)
Seat 6: Fiura25 collected (32400)
Seat 7: <Bogolal> folded before Flop (didn't bet)
Seat 8: HiredGun99 (button) folded before Flop (didn't bet)
Seat 9: TURoff (small blind) folded on the Turn





PokerStars Hand #177204170067: Tournament #2067822782, $1.00+$0.10 USD Hold'em No Limit - Level XXV (1600/3200) - 2017/10/21 23:18:59 CUST [2017/10/21 15:18:59 ET]
Table '2067822782 41' 9-max Seat #9 is the button
Seat 1: IIlllllllII (129681 in chips) 
Seat 2: rgvaz85 (94611 in chips) 
Seat 3: iudicus (57325 in chips) 
Seat 4: PECAHE (128660 in chips) 
Seat 5: harley947 (119947 in chips) 
Seat 6: Fiura25 (177949 in chips) 
Seat 7: <Bogolal> (88666 in chips) 
Seat 8: HiredGun99 (120056 in chips) 
Seat 9: TURoff (82528 in chips) 
IIlllllllII: posts the ante 400
rgvaz85: posts the ante 400
iudicus: posts the ante 400
PECAHE: posts the ante 400
harley947: posts the ante 400
Fiura25: posts the ante 400
<Bogolal>: posts the ante 400
HiredGun99: posts the ante 400
TURoff: posts the ante 400
IIlllllllII: posts small blind 1600
rgvaz85: posts big blind 3200
*** HOLE CARDS ***
Dealt to TURoff [7s Qc]
iudicus: folds 
PECAHE: folds 
harley947: calls 3200
Fiura25: raises 4800 to 8000
<Bogolal>: folds 
HiredGun99: folds 
TURoff: folds 
IIlllllllII: folds 
rgvaz85: folds 
harley947: calls 4800
*** FLOP *** [4s Jc 5d]
harley947: checks 
Fiura25: bets 12200
harley947: calls 12200
*** TURN *** [4s Jc 5d] [7h]
harley947: checks 
Fiura25: bets 12800
harley947: calls 12800
*** RIVER *** [4s Jc 5d 7h] [7d]
harley947: bets 86547 and is all-in
Fiura25: folds 
Uncalled bet (86547) returned to harley947
harley947 collected 74400 from pot
harley947: shows [3s As] (a pair of Sevens)
*** SUMMARY ***
Total pot 74400 | Rake 0 
Board [4s Jc 5d 7h 7d]
Seat 1: IIlllllllII (small blind) folded before Flop
Seat 2: rgvaz85 (big blind) folded before Flop
Seat 3: iudicus folded before Flop (didn't bet)
Seat 4: PECAHE folded before Flop (didn't bet)
Seat 5: harley947 collected (74400)
Seat 6: Fiura25 folded on the River
Seat 7: <Bogolal> folded before Flop (didn't bet)
Seat 8: HiredGun99 folded before Flop (didn't bet)
Seat 9: TURoff (button) folded before Flop (didn't bet)





PokerStars Hand #177204211661: Tournament #2067822782, $1.00+$0.10 USD Hold'em No Limit - Level XXV (1600/3200) - 2017/10/21 23:19:50 CUST [2017/10/21 15:19:50 ET]
Table '2067822782 41' 9-max Seat #1 is the button
Seat 1: IIlllllllII (127681 in chips) 
Seat 2: rgvaz85 (91011 in chips) 
Seat 3: iudicus (56925 in chips) 
Seat 4: PECAHE (128260 in chips) 
Seat 5: harley947 (160947 in chips) 
Seat 6: Fiura25 (144549 in chips) 
Seat 7: <Bogolal> (88266 in chips) 
Seat 8: HiredGun99 (119656 in chips) 
Seat 9: TURoff (82128 in chips) 
IIlllllllII: posts the ante 400
rgvaz85: posts the ante 400
iudicus: posts the ante 400
PECAHE: posts the ante 400
harley947: posts the ante 400
Fiura25: posts the ante 400
<Bogolal>: posts the ante 400
HiredGun99: posts the ante 400
TURoff: posts the ante 400
rgvaz85: posts small blind 1600
iudicus: posts big blind 3200
*** HOLE CARDS ***
Dealt to TURoff [Tc Ks]
PECAHE: folds 
harley947: folds 
Fiura25: folds 
<Bogolal>: folds 
HiredGun99: raises 3200 to 6400
TURoff: folds 
IIlllllllII: folds 
rgvaz85: folds 
iudicus: raises 50125 to 56525 and is all-in
HiredGun99: calls 50125
*** FLOP *** [3s 6c Qh]
*** TURN *** [3s 6c Qh] [7s]
*** RIVER *** [3s 6c Qh 7s] [4c]
*** SHOW DOWN ***
iudicus: shows [Kh Ad] (high card Ace)
HiredGun99: shows [9s Ah] (high card Ace - lower kicker)
iudicus collected 118250 from pot
*** SUMMARY ***
Total pot 118250 | Rake 0 
Board [3s 6c Qh 7s 4c]
Seat 1: IIlllllllII (button) folded before Flop (didn't bet)
Seat 2: rgvaz85 (small blind) folded before Flop
Seat 3: iudicus (big blind) showed [Kh Ad] and won (118250) with high card Ace
Seat 4: PECAHE folded before Flop (didn't bet)
Seat 5: harley947 folded before Flop (didn't bet)
Seat 6: Fiura25 folded before Flop (didn't bet)
Seat 7: <Bogolal> folded before Flop (didn't bet)
Seat 8: HiredGun99 showed [9s Ah] and lost with high card Ace
Seat 9: TURoff folded before Flop (didn't bet)





PokerStars Hand #177204245998: Tournament #2067822782, $1.00+$0.10 USD Hold'em No Limit - Level XXV (1600/3200) - 2017/10/21 23:20:32 CUST [2017/10/21 15:20:32 ET]
Table '2067822782 41' 9-max Seat #2 is the button
Seat 1: IIlllllllII (127281 in chips) 
Seat 2: rgvaz85 (89011 in chips) 
Seat 3: iudicus (118250 in chips) 
Seat 4: PECAHE (127860 in chips) 
Seat 5: harley947 (160547 in chips) 
Seat 6: Fiura25 (144149 in chips) 
Seat 7: <Bogolal> (87866 in chips) 
Seat 8: HiredGun99 (62731 in chips) 
Seat 9: TURoff (81728 in chips) 
IIlllllllII: posts the ante 400
rgvaz85: posts the ante 400
iudicus: posts the ante 400
PECAHE: posts the ante 400
harley947: posts the ante 400
Fiura25: posts the ante 400
<Bogolal>: posts the ante 400
HiredGun99: posts the ante 400
TURoff: posts the ante 400
iudicus: posts small blind 1600
PECAHE: posts big blind 3200
*** HOLE CARDS ***
Dealt to TURoff [6c As]
harley947: calls 3200
Fiura25: raises 3200 to 6400
<Bogolal>: folds 
HiredGun99: raises 55931 to 62331 and is all-in
TURoff: folds 
IIlllllllII: folds 
rgvaz85: folds 
iudicus: folds 
PECAHE: folds 
harley947: folds 
Fiura25: folds 
Uncalled bet (55931) returned to HiredGun99
HiredGun99 collected 24400 from pot
HiredGun99: doesn't show hand 
*** SUMMARY ***
Total pot 24400 | Rake 0 
Seat 1: IIlllllllII folded before Flop (didn't bet)
Seat 2: rgvaz85 (button) folded before Flop (didn't bet)
Seat 3: iudicus (small blind) folded before Flop
Seat 4: PECAHE (big blind) folded before Flop
Seat 5: harley947 folded before Flop
Seat 6: Fiura25 folded before Flop
Seat 7: <Bogolal> folded before Flop (didn't bet)
Seat 8: HiredGun99 collected (24400)
Seat 9: TURoff folded before Flop (didn't bet)





PokerStars Hand #177204280704: Tournament #2067822782, $1.00+$0.10 USD Hold'em No Limit - Level XXV (1600/3200) - 2017/10/21 23:21:15 CUST [2017/10/21 15:21:15 ET]
Table '2067822782 41' 9-max Seat #3 is the button
Seat 1: IIlllllllII (126881 in chips) 
Seat 2: rgvaz85 (88611 in chips) 
Seat 3: iudicus (116250 in chips) 
Seat 4: PECAHE (124260 in chips) 
Seat 5: harley947 (156947 in chips) 
Seat 6: Fiura25 (137349 in chips) 
Seat 7: <Bogolal> (87466 in chips) 
Seat 8: HiredGun99 (80331 in chips) 
Seat 9: TURoff (81328 in chips) 
IIlllllllII: posts the ante 400
rgvaz85: posts the ante 400
iudicus: posts the ante 400
PECAHE: posts the ante 400
harley947: posts the ante 400
Fiura25: posts the ante 400
<Bogolal>: posts the ante 400
HiredGun99: posts the ante 400
TURoff: posts the ante 400
PECAHE: posts small blind 1600
harley947: posts big blind 3200
*** HOLE CARDS ***
Dealt to TURoff [9c 7h]
Fiura25: folds 
<Bogolal>: folds 
HiredGun99: folds 
TURoff: folds 
IIlllllllII: raises 3968 to 7168
rgvaz85: folds 
iudicus: folds 
PECAHE: folds 
harley947: calls 3968
*** FLOP *** [7d 5c Qc]
harley947: checks 
IIlllllllII: bets 8791
harley947: calls 8791
*** TURN *** [7d 5c Qc] [As]
harley947: checks 
IIlllllllII: bets 27467
harley947: calls 27467
*** RIVER *** [7d 5c Qc As] [5s]
harley947: bets 3200
IIlllllllII: calls 3200
*** SHOW DOWN ***
harley947: shows [9h Ac] (two pair, Aces and Fives)
IIlllllllII: mucks hand 
harley947 collected 98452 from pot
*** SUMMARY ***
Total pot 98452 | Rake 0 
Board [7d 5c Qc As 5s]
Seat 1: IIlllllllII mucked [8s 8c]
Seat 2: rgvaz85 folded before Flop (didn't bet)
Seat 3: iudicus (button) folded before Flop (didn't bet)
Seat 4: PECAHE (small blind) folded before Flop
Seat 5: harley947 (big blind) showed [9h Ac] and won (98452) with two pair, Aces and Fives
Seat 6: Fiura25 folded before Flop (didn't bet)
Seat 7: <Bogolal> folded before Flop (didn't bet)
Seat 8: HiredGun99 folded before Flop (didn't bet)
Seat 9: TURoff folded before Flop (didn't bet)





PokerStars Hand #177204332700: Tournament #2067822782, $1.00+$0.10 USD Hold'em No Limit - Level XXV (1600/3200) - 2017/10/21 23:22:19 CUST [2017/10/21 15:22:19 ET]
Table '2067822782 41' 9-max Seat #4 is the button
Seat 1: IIlllllllII (79855 in chips) 
Seat 2: rgvaz85 (88211 in chips) 
Seat 3: iudicus (115850 in chips) 
Seat 4: PECAHE (122260 in chips) 
Seat 5: harley947 (208373 in chips) 
Seat 6: Fiura25 (136949 in chips) 
Seat 7: <Bogolal> (87066 in chips) 
Seat 8: HiredGun99 (79931 in chips) 
Seat 9: TURoff (80928 in chips) 
IIlllllllII: posts the ante 400
rgvaz85: posts the ante 400
iudicus: posts the ante 400
PECAHE: posts the ante 400
harley947: posts the ante 400
Fiura25: posts the ante 400
<Bogolal>: posts the ante 400
HiredGun99: posts the ante 400
TURoff: posts the ante 400
harley947: posts small blind 1600
Fiura25: posts big blind 3200
*** HOLE CARDS ***
Dealt to TURoff [7h Ac]
<Bogolal>: folds 
HiredGun99: folds 
TURoff: folds 
IIlllllllII: calls 3200
rgvaz85: raises 11100 to 14300
iudicus: folds 
PECAHE: folds 
harley947: folds 
Fiura25: folds 
IIlllllllII: calls 11100
*** FLOP *** [5d 4h 2h]
IIlllllllII: checks 
rgvaz85: bets 27750
IIlllllllII: folds 
Uncalled bet (27750) returned to rgvaz85
rgvaz85 collected 37000 from pot
rgvaz85: doesn't show hand 
*** SUMMARY ***
Total pot 37000 | Rake 0 
Board [5d 4h 2h]
Seat 1: IIlllllllII folded on the Flop
Seat 2: rgvaz85 collected (37000)
Seat 3: iudicus folded before Flop (didn't bet)
Seat 4: PECAHE (button) folded before Flop (didn't bet)
Seat 5: harley947 (small blind) folded before Flop
Seat 6: Fiura25 (big blind) folded before Flop
Seat 7: <Bogolal> folded before Flop (didn't bet)
Seat 8: HiredGun99 folded before Flop (didn't bet)
Seat 9: TURoff folded before Flop (didn't bet)





PokerStars Hand #177204374856: Tournament #2067822782, $1.00+$0.10 USD Hold'em No Limit - Level XXV (1600/3200) - 2017/10/21 23:23:11 CUST [2017/10/21 15:23:11 ET]
Table '2067822782 41' 9-max Seat #5 is the button
Seat 1: IIlllllllII (65155 in chips) 
Seat 2: rgvaz85 (110511 in chips) 
Seat 3: iudicus (115450 in chips) 
Seat 5: harley947 (206373 in chips) 
Seat 6: Fiura25 (133349 in chips) 
Seat 7: <Bogolal> (86666 in chips) 
Seat 8: HiredGun99 (79531 in chips) 
Seat 9: TURoff (80528 in chips) 
IIlllllllII: posts the ante 400
rgvaz85: posts the ante 400
iudicus: posts the ante 400
harley947: posts the ante 400
Fiura25: posts the ante 400
<Bogolal>: posts the ante 400
HiredGun99: posts the ante 400
TURoff: posts the ante 400
Fiura25: posts small blind 1600
<Bogolal>: posts big blind 3200
*** HOLE CARDS ***
Dealt to TURoff [3d Qs]
HiredGun99: raises 3200 to 6400
TURoff: folds 
IIlllllllII: folds 
rgvaz85: folds 
iudicus: folds 
harley947 has timed out
harley947: folds 
harley947 is sitting out
Fiura25: folds 
<Bogolal>: folds 
Uncalled bet (3200) returned to HiredGun99
HiredGun99 collected 11200 from pot
HiredGun99: doesn't show hand 
*** SUMMARY ***
Total pot 11200 | Rake 0 
Seat 1: IIlllllllII folded before Flop (didn't bet)
Seat 2: rgvaz85 folded before Flop (didn't bet)
Seat 3: iudicus folded before Flop (didn't bet)
Seat 5: harley947 (button) folded before Flop (didn't bet)
Seat 6: Fiura25 (small blind) folded before Flop
Seat 7: <Bogolal> (big blind) folded before Flop
Seat 8: HiredGun99 collected (11200)
Seat 9: TURoff folded before Flop (didn't bet)





PokerStars Hand #177204414030: Tournament #2067822782, $1.00+$0.10 USD Hold'em No Limit - Level XXV (1600/3200) - 2017/10/21 23:24:00 CUST [2017/10/21 15:24:00 ET]
Table '2067822782 41' 9-max Seat #6 is the button
Seat 1: IIlllllllII (64755 in chips) 
Seat 2: rgvaz85 (110111 in chips) 
Seat 3: iudicus (115050 in chips) 
Seat 5: harley947 (205973 in chips) is sitting out
Seat 6: Fiura25 (131349 in chips) 
Seat 7: <Bogolal> (83066 in chips) 
Seat 8: HiredGun99 (87131 in chips) 
Seat 9: TURoff (80128 in chips) 
IIlllllllII: posts the ante 400
rgvaz85: posts the ante 400
iudicus: posts the ante 400
harley947: posts the ante 400
Fiura25: posts the ante 400
<Bogolal>: posts the ante 400
HiredGun99: posts the ante 400
TURoff: posts the ante 400
<Bogolal>: posts small blind 1600
HiredGun99: posts big blind 3200
*** HOLE CARDS ***
Dealt to TURoff [6s Jd]
TURoff: folds 
IIlllllllII: folds 
harley947 has returned
rgvaz85: folds 
iudicus: folds 
harley947: calls 3200
Fiura25: raises 4800 to 8000
<Bogolal>: folds 
HiredGun99: calls 4800
harley947: calls 4800
*** FLOP *** [6h 2c 7h]
HiredGun99: checks 
harley947: bets 3200
Fiura25: raises 35200 to 38400
HiredGun99: folds 
harley947: calls 35200
*** TURN *** [6h 2c 7h] [Ts]
harley947: bets 6400
Fiura25: raises 78149 to 84549 and is all-in
harley947: calls 78149
*** RIVER *** [6h 2c 7h Ts] [8c]
*** SHOW DOWN ***
harley947: shows [Kh Th] (a pair of Tens)
Fiura25: shows [As 7s] (a pair of Sevens)
harley947 collected 274698 from pot
Fiura25 finished the tournament in 64th place and received $4.84.
*** SUMMARY ***
Total pot 274698 | Rake 0 
Board [6h 2c 7h Ts 8c]
Seat 1: IIlllllllII folded before Flop (didn't bet)
Seat 2: rgvaz85 folded before Flop (didn't bet)
Seat 3: iudicus folded before Flop (didn't bet)
Seat 5: harley947 showed [Kh Th] and won (274698) with a pair of Tens
Seat 6: Fiura25 (button) showed [As 7s] and lost with a pair of Sevens
Seat 7: <Bogolal> (small blind) folded before Flop
Seat 8: HiredGun99 (big blind) folded on the Flop
Seat 9: TURoff folded before Flop (didn't bet)





PokerStars Hand #177204484296: Tournament #2067822782, $1.00+$0.10 USD Hold'em No Limit - Level XXVI (1800/3600) - 2017/10/21 23:25:27 CUST [2017/10/21 15:25:27 ET]
Table '2067822782 1' 9-max Seat #3 is the button
Seat 2: StyaRT10 (94236 in chips) 
Seat 3: gugalondon (37226 in chips) 
Seat 4: 1955092020 (115211 in chips) 
Seat 5: TURoff (79728 in chips) 
Seat 6: Allucardy_BR (167901 in chips) 
Seat 7: berna733 (264523 in chips) 
Seat 8: APurchart (154685 in chips) 
Seat 9: jucabala32 (33894 in chips) 
StyaRT10: posts the ante 450
gugalondon: posts the ante 450
1955092020: posts the ante 450
TURoff: posts the ante 450
Allucardy_BR: posts the ante 450
berna733: posts the ante 450
APurchart: posts the ante 450
jucabala32: posts the ante 450
1955092020: posts small blind 1800
TURoff: posts big blind 3600
*** HOLE CARDS ***
Dealt to TURoff [8d 8s]
Allucardy_BR: folds 
berna733: folds 
APurchart: folds 
jucabala32: folds 
StyaRT10: folds 
gugalondon: raises 33176 to 36776 and is all-in
1955092020: folds 
TURoff: folds 
Uncalled bet (33176) returned to gugalondon
gugalondon collected 12600 from pot
*** SUMMARY ***
Total pot 12600 | Rake 0 
Seat 2: StyaRT10 folded before Flop (didn't bet)
Seat 3: gugalondon (button) collected (12600)
Seat 4: 1955092020 (small blind) folded before Flop
Seat 5: TURoff (big blind) folded before Flop
Seat 6: Allucardy_BR folded before Flop (didn't bet)
Seat 7: berna733 folded before Flop (didn't bet)
Seat 8: APurchart folded before Flop (didn't bet)
Seat 9: jucabala32 folded before Flop (didn't bet)





PokerStars Hand #177204505092: Tournament #2067822782, $1.00+$0.10 USD Hold'em No Limit - Level XXVI (1800/3600) - 2017/10/21 23:25:53 CUST [2017/10/21 15:25:53 ET]
Table '2067822782 1' 9-max Seat #4 is the button
Seat 2: StyaRT10 (93786 in chips) 
Seat 3: gugalondon (45776 in chips) 
Seat 4: 1955092020 (112961 in chips) 
Seat 5: TURoff (75678 in chips) 
Seat 6: Allucardy_BR (167451 in chips) 
Seat 7: berna733 (264073 in chips) 
Seat 8: APurchart (154235 in chips) 
Seat 9: jucabala32 (33444 in chips) 
StyaRT10: posts the ante 450
gugalondon: posts the ante 450
1955092020: posts the ante 450
TURoff: posts the ante 450
Allucardy_BR: posts the ante 450
berna733: posts the ante 450
APurchart: posts the ante 450
jucabala32: posts the ante 450
TURoff: posts small blind 1800
Allucardy_BR: posts big blind 3600
*** HOLE CARDS ***
Dealt to TURoff [2s 5s]
berna733: folds 
APurchart: folds 
jucabala32: folds 
StyaRT10: folds 
gugalondon: folds 
1955092020: raises 108911 to 112511 and is all-in
TURoff: folds 
Allucardy_BR: folds 
Uncalled bet (108911) returned to 1955092020
1955092020 collected 12600 from pot
1955092020: doesn't show hand 
*** SUMMARY ***
Total pot 12600 | Rake 0 
Seat 2: StyaRT10 folded before Flop (didn't bet)
Seat 3: gugalondon folded before Flop (didn't bet)
Seat 4: 1955092020 (button) collected (12600)
Seat 5: TURoff (small blind) folded before Flop
Seat 6: Allucardy_BR (big blind) folded before Flop
Seat 7: berna733 folded before Flop (didn't bet)
Seat 8: APurchart folded before Flop (didn't bet)
Seat 9: jucabala32 folded before Flop (didn't bet)





PokerStars Hand #177204530314: Tournament #2067822782, $1.00+$0.10 USD Hold'em No Limit - Level XXVI (1800/3600) - 2017/10/21 23:26:24 CUST [2017/10/21 15:26:24 ET]
Table '2067822782 1' 9-max Seat #5 is the button
Seat 2: StyaRT10 (93336 in chips) 
Seat 3: gugalondon (45326 in chips) 
Seat 4: 1955092020 (121511 in chips) 
Seat 5: TURoff (73428 in chips) 
Seat 6: Allucardy_BR (163401 in chips) 
Seat 7: berna733 (263623 in chips) 
Seat 8: APurchart (153785 in chips) 
Seat 9: jucabala32 (32994 in chips) 
StyaRT10: posts the ante 450
gugalondon: posts the ante 450
1955092020: posts the ante 450
TURoff: posts the ante 450
Allucardy_BR: posts the ante 450
berna733: posts the ante 450
APurchart: posts the ante 450
jucabala32: posts the ante 450
Allucardy_BR: posts small blind 1800
berna733: posts big blind 3600
*** HOLE CARDS ***
Dealt to TURoff [8h 9s]
APurchart: folds 
jucabala32: raises 28944 to 32544 and is all-in
StyaRT10: folds 
gugalondon: folds 
1955092020: folds 
TURoff: folds 
Allucardy_BR: folds 
berna733: folds 
Uncalled bet (28944) returned to jucabala32
jucabala32 collected 12600 from pot
*** SUMMARY ***
Total pot 12600 | Rake 0 
Seat 2: StyaRT10 folded before Flop (didn't bet)
Seat 3: gugalondon folded before Flop (didn't bet)
Seat 4: 1955092020 folded before Flop (didn't bet)
Seat 5: TURoff (button) folded before Flop (didn't bet)
Seat 6: Allucardy_BR (small blind) folded before Flop
Seat 7: berna733 (big blind) folded before Flop
Seat 8: APurchart folded before Flop (didn't bet)
Seat 9: jucabala32 collected (12600)





PokerStars Hand #177204544342: Tournament #2067822782, $1.00+$0.10 USD Hold'em No Limit - Level XXVI (1800/3600) - 2017/10/21 23:26:42 CUST [2017/10/21 15:26:42 ET]
Table '2067822782 1' 9-max Seat #6 is the button
Seat 2: StyaRT10 (92886 in chips) 
Seat 3: gugalondon (44876 in chips) 
Seat 4: 1955092020 (121061 in chips) 
Seat 5: TURoff (72978 in chips) 
Seat 6: Allucardy_BR (161151 in chips) 
Seat 7: berna733 (259573 in chips) 
Seat 8: APurchart (153335 in chips) 
Seat 9: jucabala32 (41544 in chips) 
StyaRT10: posts the ante 450
gugalondon: posts the ante 450
1955092020: posts the ante 450
TURoff: posts the ante 450
Allucardy_BR: posts the ante 450
berna733: posts the ante 450
APurchart: posts the ante 450
jucabala32: posts the ante 450
berna733: posts small blind 1800
APurchart: posts big blind 3600
*** HOLE CARDS ***
Dealt to TURoff [4s 7d]
jucabala32: folds 
StyaRT10: folds 
gugalondon: raises 4320 to 7920
1955092020: folds 
TURoff: folds 
Allucardy_BR: folds 
berna733: folds 
APurchart: raises 144965 to 152885 and is all-in
gugalondon: calls 36506 and is all-in
Uncalled bet (108459) returned to APurchart
*** FLOP *** [Qh 9c 9d]
*** TURN *** [Qh 9c 9d] [Ts]
*** RIVER *** [Qh 9c 9d Ts] [6c]
*** SHOW DOWN ***
APurchart: shows [Jh Ah] (a pair of Nines)
gugalondon: shows [Ks Kh] (two pair, Kings and Nines)
gugalondon collected 94252 from pot
*** SUMMARY ***
Total pot 94252 | Rake 0 
Board [Qh 9c 9d Ts 6c]
Seat 2: StyaRT10 folded before Flop (didn't bet)
Seat 3: gugalondon showed [Ks Kh] and won (94252) with two pair, Kings and Nines
Seat 4: 1955092020 folded before Flop (didn't bet)
Seat 5: TURoff folded before Flop (didn't bet)
Seat 6: Allucardy_BR (button) folded before Flop (didn't bet)
Seat 7: berna733 (small blind) folded before Flop
Seat 8: APurchart (big blind) showed [Jh Ah] and lost with a pair of Nines
Seat 9: jucabala32 folded before Flop (didn't bet)





PokerStars Hand #177204571456: Tournament #2067822782, $1.00+$0.10 USD Hold'em No Limit - Level XXVI (1800/3600) - 2017/10/21 23:27:16 CUST [2017/10/21 15:27:16 ET]
Table '2067822782 1' 9-max Seat #7 is the button
Seat 2: StyaRT10 (92436 in chips) 
Seat 3: gugalondon (94252 in chips) 
Seat 4: 1955092020 (120611 in chips) 
Seat 5: TURoff (72528 in chips) 
Seat 6: Allucardy_BR (160701 in chips) 
Seat 7: berna733 (257323 in chips) 
Seat 8: APurchart (108459 in chips) 
Seat 9: jucabala32 (41094 in chips) 
StyaRT10: posts the ante 450
gugalondon: posts the ante 450
1955092020: posts the ante 450
TURoff: posts the ante 450
Allucardy_BR: posts the ante 450
berna733: posts the ante 450
APurchart: posts the ante 450
jucabala32: posts the ante 450
APurchart: posts small blind 1800
jucabala32: posts big blind 3600
*** HOLE CARDS ***
Dealt to TURoff [Kd 5h]
StyaRT10: folds 
gugalondon: raises 4320 to 7920
1955092020: folds 
TURoff: folds 
Allucardy_BR: folds 
berna733: calls 7920
APurchart: folds 
jucabala32: calls 4320
*** FLOP *** [Ts 6h 9s]
jucabala32: checks 
gugalondon: checks 
berna733: checks 
*** TURN *** [Ts 6h 9s] [8s]
jucabala32: checks 
gugalondon: checks 
berna733: checks 
*** RIVER *** [Ts 6h 9s 8s] [3h]
jucabala32: checks 
gugalondon: checks 
berna733: checks 
*** SHOW DOWN ***
jucabala32: shows [2d Jd] (high card Jack)
gugalondon: shows [Jc 9h] (a pair of Nines)
berna733: mucks hand 
gugalondon collected 29160 from pot
*** SUMMARY ***
Total pot 29160 | Rake 0 
Board [Ts 6h 9s 8s 3h]
Seat 2: StyaRT10 folded before Flop (didn't bet)
Seat 3: gugalondon showed [Jc 9h] and won (29160) with a pair of Nines
Seat 4: 1955092020 folded before Flop (didn't bet)
Seat 5: TURoff folded before Flop (didn't bet)
Seat 6: Allucardy_BR folded before Flop (didn't bet)
Seat 7: berna733 (button) mucked [4h 4s]
Seat 8: APurchart (small blind) folded before Flop
Seat 9: jucabala32 (big blind) showed [2d Jd] and lost with high card Jack





PokerStars Hand #177204625799: Tournament #2067822782, $1.00+$0.10 USD Hold'em No Limit - Level XXVI (1800/3600) - 2017/10/21 23:28:24 CUST [2017/10/21 15:28:24 ET]
Table '2067822782 1' 9-max Seat #8 is the button
Seat 2: StyaRT10 (91986 in chips) 
Seat 3: gugalondon (115042 in chips) 
Seat 4: 1955092020 (120161 in chips) 
Seat 5: TURoff (72078 in chips) 
Seat 6: Allucardy_BR (160251 in chips) 
Seat 7: berna733 (248953 in chips) 
Seat 8: APurchart (106209 in chips) 
Seat 9: jucabala32 (32724 in chips) 
StyaRT10: posts the ante 450
gugalondon: posts the ante 450
1955092020: posts the ante 450
TURoff: posts the ante 450
Allucardy_BR: posts the ante 450
berna733: posts the ante 450
APurchart: posts the ante 450
jucabala32: posts the ante 450
jucabala32: posts small blind 1800
StyaRT10: posts big blind 3600
*** HOLE CARDS ***
Dealt to TURoff [2d 3s]
gugalondon: raises 5760 to 9360
1955092020: calls 9360
TURoff: folds 
Allucardy_BR: calls 9360
berna733: folds 
APurchart: folds 
jucabala32: folds 
StyaRT10: folds 
*** FLOP *** [6s As Ks]
gugalondon: bets 20394
1955092020: folds 
Allucardy_BR: raises 27254 to 47648
gugalondon: raises 57584 to 105232 and is all-in
Allucardy_BR: calls 57584
*** TURN *** [6s As Ks] [Qd]
*** RIVER *** [6s As Ks Qd] [Kc]
*** SHOW DOWN ***
gugalondon: shows [Kh Ac] (a full house, Kings full of Aces)
Allucardy_BR: shows [Ah Qs] (two pair, Aces and Kings)
gugalondon collected 247544 from pot
*** SUMMARY ***
Total pot 247544 | Rake 0 
Board [6s As Ks Qd Kc]
Seat 2: StyaRT10 (big blind) folded before Flop
Seat 3: gugalondon showed [Kh Ac] and won (247544) with a full house, Kings full of Aces
Seat 4: 1955092020 folded on the Flop
Seat 5: TURoff folded before Flop (didn't bet)
Seat 6: Allucardy_BR showed [Ah Qs] and lost with two pair, Aces and Kings
Seat 7: berna733 folded before Flop (didn't bet)
Seat 8: APurchart (button) folded before Flop (didn't bet)
Seat 9: jucabala32 (small blind) folded before Flop





PokerStars Hand #177204661835: Tournament #2067822782, $1.00+$0.10 USD Hold'em No Limit - Level XXVI (1800/3600) - 2017/10/21 23:29:10 CUST [2017/10/21 15:29:10 ET]
Table '2067822782 1' 9-max Seat #9 is the button
Seat 2: StyaRT10 (87936 in chips) 
Seat 3: gugalondon (247544 in chips) 
Seat 4: 1955092020 (110351 in chips) 
Seat 5: TURoff (71628 in chips) 
Seat 6: Allucardy_BR (45209 in chips) 
Seat 7: berna733 (248503 in chips) 
Seat 8: APurchart (105759 in chips) 
Seat 9: jucabala32 (30474 in chips) 
StyaRT10: posts the ante 450
gugalondon: posts the ante 450
1955092020: posts the ante 450
TURoff: posts the ante 450
Allucardy_BR: posts the ante 450
berna733: posts the ante 450
APurchart: posts the ante 450
jucabala32: posts the ante 450
StyaRT10: posts small blind 1800
gugalondon: posts big blind 3600
*** HOLE CARDS ***
Dealt to TURoff [8d 6d]
1955092020: folds 
TURoff: folds 
Allucardy_BR: folds 
berna733: folds 
APurchart: raises 3600 to 7200
jucabala32: folds 
Allucardy_BR said, "nice"
StyaRT10: calls 5400
gugalondon: calls 3600
*** FLOP *** [2s 5c 8h]
StyaRT10: checks 
gugalondon: checks 
APurchart: bets 17892
StyaRT10: folds 
gugalondon: folds 
Uncalled bet (17892) returned to APurchart
APurchart collected 25200 from pot
APurchart: doesn't show hand 
*** SUMMARY ***
Total pot 25200 | Rake 0 
Board [2s 5c 8h]
Seat 2: StyaRT10 (small blind) folded on the Flop
Seat 3: gugalondon (big blind) folded on the Flop
Seat 4: 1955092020 folded before Flop (didn't bet)
Seat 5: TURoff folded before Flop (didn't bet)
Seat 6: Allucardy_BR folded before Flop (didn't bet)
Seat 7: berna733 folded before Flop (didn't bet)
Seat 8: APurchart collected (25200)
Seat 9: jucabala32 (button) folded before Flop (didn't bet)





PokerStars Hand #177204688216: Tournament #2067822782, $1.00+$0.10 USD Hold'em No Limit - Level XXVI (1800/3600) - 2017/10/21 23:29:43 CUST [2017/10/21 15:29:43 ET]
Table '2067822782 1' 9-max Seat #2 is the button
Seat 2: StyaRT10 (80286 in chips) 
Seat 3: gugalondon (239894 in chips) 
Seat 4: 1955092020 (109901 in chips) 
Seat 5: TURoff (71178 in chips) 
Seat 6: Allucardy_BR (44759 in chips) 
Seat 7: berna733 (248053 in chips) 
Seat 8: APurchart (123309 in chips) 
Seat 9: jucabala32 (30024 in chips) 
StyaRT10: posts the ante 450
gugalondon: posts the ante 450
1955092020: posts the ante 450
TURoff: posts the ante 450
Allucardy_BR: posts the ante 450
berna733: posts the ante 450
APurchart: posts the ante 450
jucabala32: posts the ante 450
gugalondon: posts small blind 1800
1955092020: posts big blind 3600
*** HOLE CARDS ***
Dealt to TURoff [2s Ks]
TURoff: folds 
Allucardy_BR: folds 
berna733: folds 
APurchart: folds 
jucabala32: folds 
StyaRT10: folds 
gugalondon: raises 5760 to 9360
1955092020: calls 5760
*** FLOP *** [9c Kh 6h]
gugalondon: bets 8258
1955092020: calls 8258
*** TURN *** [9c Kh 6h] [3d]
gugalondon: checks 
1955092020: bets 91833 and is all-in
gugalondon: folds 
Uncalled bet (91833) returned to 1955092020
1955092020 collected 38836 from pot
1955092020: doesn't show hand 
*** SUMMARY ***
Total pot 38836 | Rake 0 
Board [9c Kh 6h 3d]
Seat 2: StyaRT10 (button) folded before Flop (didn't bet)
Seat 3: gugalondon (small blind) folded on the Turn
Seat 4: 1955092020 (big blind) collected (38836)
Seat 5: TURoff folded before Flop (didn't bet)
Seat 6: Allucardy_BR folded before Flop (didn't bet)
Seat 7: berna733 folded before Flop (didn't bet)
Seat 8: APurchart folded before Flop (didn't bet)
Seat 9: jucabala32 folded before Flop (didn't bet)





PokerStars Hand #177204717394: Tournament #2067822782, $1.00+$0.10 USD Hold'em No Limit - Level XXVI (1800/3600) - 2017/10/21 23:30:19 CUST [2017/10/21 15:30:19 ET]
Table '2067822782 1' 9-max Seat #3 is the button
Seat 2: StyaRT10 (79836 in chips) 
Seat 3: gugalondon (221826 in chips) 
Seat 4: 1955092020 (130669 in chips) 
Seat 5: TURoff (70728 in chips) 
Seat 6: Allucardy_BR (44309 in chips) 
Seat 7: berna733 (247603 in chips) 
Seat 8: APurchart (122859 in chips) 
Seat 9: jucabala32 (29574 in chips) 
StyaRT10: posts the ante 450
gugalondon: posts the ante 450
1955092020: posts the ante 450
TURoff: posts the ante 450
Allucardy_BR: posts the ante 450
berna733: posts the ante 450
APurchart: posts the ante 450
jucabala32: posts the ante 450
1955092020: posts small blind 1800
TURoff: posts big blind 3600
*** HOLE CARDS ***
Dealt to TURoff [5h 8c]
Allucardy_BR: folds 
berna733: folds 
APurchart: folds 
jucabala32: folds 
StyaRT10: folds 
gugalondon: raises 4320 to 7920
1955092020: calls 6120
TURoff: calls 4320
*** FLOP *** [7d Js Kh]
1955092020: checks 
TURoff: checks 
gugalondon: bets 15048
1955092020: folds 
TURoff: folds 
Uncalled bet (15048) returned to gugalondon
gugalondon collected 27360 from pot
*** SUMMARY ***
Total pot 27360 | Rake 0 
Board [7d Js Kh]
Seat 2: StyaRT10 folded before Flop (didn't bet)
Seat 3: gugalondon (button) collected (27360)
Seat 4: 1955092020 (small blind) folded on the Flop
Seat 5: TURoff (big blind) folded on the Flop
Seat 6: Allucardy_BR folded before Flop (didn't bet)
Seat 7: berna733 folded before Flop (didn't bet)
Seat 8: APurchart folded before Flop (didn't bet)
Seat 9: jucabala32 folded before Flop (didn't bet)





PokerStars Hand #177204769613: Tournament #2067822782, $1.00+$0.10 USD Hold'em No Limit - Level XXVI (1800/3600) - 2017/10/21 23:31:19 CUST [2017/10/21 15:31:19 ET]
Table '2067822782 1' 9-max Seat #4 is the button
Seat 2: StyaRT10 (79386 in chips) 
Seat 3: gugalondon (240816 in chips) 
Seat 4: 1955092020 (122299 in chips) 
Seat 5: TURoff (62358 in chips) 
Seat 6: Allucardy_BR (43859 in chips) 
Seat 7: berna733 (247153 in chips) 
Seat 8: APurchart (122409 in chips) 
Seat 9: jucabala32 (29124 in chips) 
StyaRT10: posts the ante 450
gugalondon: posts the ante 450
1955092020: posts the ante 450
TURoff: posts the ante 450
Allucardy_BR: posts the ante 450
berna733: posts the ante 450
APurchart: posts the ante 450
jucabala32: posts the ante 450
TURoff: posts small blind 1800
Allucardy_BR: posts big blind 3600
*** HOLE CARDS ***
Dealt to TURoff [7h 6h]
berna733: folds 
APurchart: folds 
jucabala32: folds 
StyaRT10: raises 7200 to 10800
gugalondon: folds 
1955092020: calls 10800
TURoff: folds 
Allucardy_BR: raises 32609 to 43409 and is all-in
StyaRT10: folds 
1955092020: calls 32609
*** FLOP *** [6s 8d 5c]
*** TURN *** [6s 8d 5c] [5h]
*** RIVER *** [6s 8d 5c 5h] [Qs]
*** SHOW DOWN ***
Allucardy_BR: shows [Ac Qh] (two pair, Queens and Fives)
1955092020: shows [Jd Ah] (a pair of Fives)
Allucardy_BR collected 103018 from pot
*** SUMMARY ***
Total pot 103018 | Rake 0 
Board [6s 8d 5c 5h Qs]
Seat 2: StyaRT10 folded before Flop
Seat 3: gugalondon folded before Flop (didn't bet)
Seat 4: 1955092020 (button) showed [Jd Ah] and lost with a pair of Fives
Seat 5: TURoff (small blind) folded before Flop
Seat 6: Allucardy_BR (big blind) showed [Ac Qh] and won (103018) with two pair, Queens and Fives
Seat 7: berna733 folded before Flop (didn't bet)
Seat 8: APurchart folded before Flop (didn't bet)
Seat 9: jucabala32 folded before Flop (didn't bet)





PokerStars Hand #177204810964: Tournament #2067822782, $1.00+$0.10 USD Hold'em No Limit - Level XXVI (1800/3600) - 2017/10/21 23:32:10 CUST [2017/10/21 15:32:10 ET]
Table '2067822782 1' 9-max Seat #5 is the button
Seat 2: StyaRT10 (68136 in chips) 
Seat 3: gugalondon (240366 in chips) 
Seat 4: 1955092020 (78440 in chips) 
Seat 5: TURoff (60108 in chips) 
Seat 6: Allucardy_BR (103018 in chips) 
Seat 7: berna733 (246703 in chips) 
Seat 8: APurchart (121959 in chips) 
Seat 9: jucabala32 (28674 in chips) 
StyaRT10: posts the ante 450
gugalondon: posts the ante 450
1955092020: posts the ante 450
TURoff: posts the ante 450
Allucardy_BR: posts the ante 450
berna733: posts the ante 450
APurchart: posts the ante 450
jucabala32: posts the ante 450
Allucardy_BR: posts small blind 1800
berna733: posts big blind 3600
*** HOLE CARDS ***
Dealt to TURoff [4s 8h]
APurchart: folds 
jucabala32: folds 
StyaRT10: folds 
gugalondon: raises 4320 to 7920
1955092020: folds 
TURoff: folds 
Allucardy_BR: folds 
berna733: folds 
Uncalled bet (4320) returned to gugalondon
gugalondon collected 12600 from pot
*** SUMMARY ***
Total pot 12600 | Rake 0 
Seat 2: StyaRT10 folded before Flop (didn't bet)
Seat 3: gugalondon collected (12600)
Seat 4: 1955092020 folded before Flop (didn't bet)
Seat 5: TURoff (button) folded before Flop (didn't bet)
Seat 6: Allucardy_BR (small blind) folded before Flop
Seat 7: berna733 (big blind) folded before Flop
Seat 8: APurchart folded before Flop (didn't bet)
Seat 9: jucabala32 folded before Flop (didn't bet)





PokerStars Hand #177204835241: Tournament #2067822782, $1.00+$0.10 USD Hold'em No Limit - Level XXVI (1800/3600) - 2017/10/21 23:32:40 CUST [2017/10/21 15:32:40 ET]
Table '2067822782 1' 9-max Seat #6 is the button
Seat 2: StyaRT10 (67686 in chips) 
Seat 3: gugalondon (248916 in chips) 
Seat 4: 1955092020 (77990 in chips) 
Seat 5: TURoff (59658 in chips) 
Seat 6: Allucardy_BR (100768 in chips) 
Seat 7: berna733 (242653 in chips) 
Seat 8: APurchart (121509 in chips) 
Seat 9: jucabala32 (28224 in chips) 
StyaRT10: posts the ante 450
gugalondon: posts the ante 450
1955092020: posts the ante 450
TURoff: posts the ante 450
Allucardy_BR: posts the ante 450
berna733: posts the ante 450
APurchart: posts the ante 450
jucabala32: posts the ante 450
berna733: posts small blind 1800
APurchart: posts big blind 3600
*** HOLE CARDS ***
Dealt to TURoff [5s 2d]
jucabala32: folds 
StyaRT10: folds 
gugalondon: raises 4320 to 7920
1955092020: calls 7920
TURoff: folds 
Allucardy_BR: folds 
berna733: folds 
APurchart: folds 
*** FLOP *** [5d 4h 9s]
gugalondon: bets 13662
1955092020: raises 55958 to 69620 and is all-in
gugalondon: calls 55958
*** TURN *** [5d 4h 9s] [7c]
*** RIVER *** [5d 4h 9s 7c] [Ad]
*** SHOW DOWN ***
gugalondon: shows [9c As] (two pair, Aces and Nines)
1955092020: shows [Td 7d] (a pair of Sevens)
gugalondon collected 164080 from pot
1955092020 finished the tournament in 57th place and received $4.84.
*** SUMMARY ***
Total pot 164080 | Rake 0 
Board [5d 4h 9s 7c Ad]
Seat 2: StyaRT10 folded before Flop (didn't bet)
Seat 3: gugalondon showed [9c As] and won (164080) with two pair, Aces and Nines
Seat 4: 1955092020 showed [Td 7d] and lost with a pair of Sevens
Seat 5: TURoff folded before Flop (didn't bet)
Seat 6: Allucardy_BR (button) folded before Flop (didn't bet)
Seat 7: berna733 (small blind) folded before Flop
Seat 8: APurchart (big blind) folded before Flop
Seat 9: jucabala32 folded before Flop (didn't bet)





PokerStars Hand #177204877531: Tournament #2067822782, $1.00+$0.10 USD Hold'em No Limit - Level XXVI (1800/3600) - 2017/10/21 23:33:33 CUST [2017/10/21 15:33:33 ET]
Table '2067822782 1' 9-max Seat #7 is the button
Seat 2: StyaRT10 (67236 in chips) 
Seat 3: gugalondon (335006 in chips) 
Seat 5: TURoff (59208 in chips) 
Seat 6: Allucardy_BR (100318 in chips) 
Seat 7: berna733 (240403 in chips) 
Seat 8: APurchart (117459 in chips) 
Seat 9: jucabala32 (27774 in chips) 
StyaRT10: posts the ante 450
gugalondon: posts the ante 450
TURoff: posts the ante 450
Allucardy_BR: posts the ante 450
berna733: posts the ante 450
APurchart: posts the ante 450
jucabala32: posts the ante 450
APurchart: posts small blind 1800
jucabala32: posts big blind 3600
*** HOLE CARDS ***
Dealt to TURoff [7c 5c]
StyaRT10: folds 
gugalondon: folds 
TURoff: folds 
Allucardy_BR: raises 3960 to 7560
berna733: folds 
APurchart: folds 
jucabala32: folds 
Uncalled bet (3960) returned to Allucardy_BR
Allucardy_BR collected 12150 from pot
Allucardy_BR: doesn't show hand 
*** SUMMARY ***
Total pot 12150 | Rake 0 
Seat 2: StyaRT10 folded before Flop (didn't bet)
Seat 3: gugalondon folded before Flop (didn't bet)
Seat 5: TURoff folded before Flop (didn't bet)
Seat 6: Allucardy_BR collected (12150)
Seat 7: berna733 (button) folded before Flop (didn't bet)
Seat 8: APurchart (small blind) folded before Flop
Seat 9: jucabala32 (big blind) folded before Flop





PokerStars Hand #177204902928: Tournament #2067822782, $1.00+$0.10 USD Hold'em No Limit - Level XXVII (2000/4000) - 2017/10/21 23:34:05 CUST [2017/10/21 15:34:05 ET]
Table '2067822782 1' 9-max Seat #8 is the button
Seat 1: iudicus (103490 in chips) 
Seat 2: StyaRT10 (66786 in chips) 
Seat 3: gugalondon (334556 in chips) 
Seat 4: AlexCorvin22 (125488 in chips) 
Seat 5: TURoff (58758 in chips) 
Seat 6: Allucardy_BR (108418 in chips) 
Seat 7: berna733 (239953 in chips) 
Seat 8: APurchart (115209 in chips) 
Seat 9: jucabala32 (23724 in chips) 
iudicus: posts the ante 500
StyaRT10: posts the ante 500
gugalondon: posts the ante 500
AlexCorvin22: posts the ante 500
TURoff: posts the ante 500
Allucardy_BR: posts the ante 500
berna733: posts the ante 500
APurchart: posts the ante 500
jucabala32: posts the ante 500
jucabala32: posts small blind 2000
iudicus: posts big blind 4000
*** HOLE CARDS ***
Dealt to TURoff [9c 3d]
StyaRT10: folds 
gugalondon: folds 
AlexCorvin22: raises 4800 to 8800
TURoff: folds 
Allucardy_BR: folds 
berna733: calls 8800
APurchart: folds 
jucabala32: folds 
iudicus: calls 4800
*** FLOP *** [7h 7d Ah]
iudicus: checks 
AlexCorvin22: bets 18000
berna733: calls 18000
iudicus: folds 
*** TURN *** [7h 7d Ah] [Jc]
AlexCorvin22: checks 
berna733: checks 
*** RIVER *** [7h 7d Ah Jc] [4d]
AlexCorvin22: checks 
berna733: checks 
*** SHOW DOWN ***
AlexCorvin22: shows [6c 6s] (two pair, Sevens and Sixes)
berna733: mucks hand 
AlexCorvin22 collected 68900 from pot
*** SUMMARY ***
Total pot 68900 | Rake 0 
Board [7h 7d Ah Jc 4d]
Seat 1: iudicus (big blind) folded on the Flop
Seat 2: StyaRT10 folded before Flop (didn't bet)
Seat 3: gugalondon folded before Flop (didn't bet)
Seat 4: AlexCorvin22 showed [6c 6s] and won (68900) with two pair, Sevens and Sixes
Seat 5: TURoff folded before Flop (didn't bet)
Seat 6: Allucardy_BR folded before Flop (didn't bet)
Seat 7: berna733 mucked [9h Th]
Seat 8: APurchart (button) folded before Flop (didn't bet)
Seat 9: jucabala32 (small blind) folded before Flop





PokerStars Hand #177204960368: Tournament #2067822782, $1.00+$0.10 USD Hold'em No Limit - Level XXVII (2000/4000) - 2017/10/21 23:35:16 CUST [2017/10/21 15:35:16 ET]
Table '2067822782 1' 9-max Seat #9 is the button
Seat 1: iudicus (94190 in chips) 
Seat 2: StyaRT10 (66286 in chips) 
Seat 3: gugalondon (334056 in chips) 
Seat 4: AlexCorvin22 (167088 in chips) 
Seat 5: TURoff (58258 in chips) 
Seat 6: Allucardy_BR (107918 in chips) 
Seat 7: berna733 (212653 in chips) 
Seat 8: APurchart (114709 in chips) 
Seat 9: jucabala32 (21224 in chips) 
iudicus: posts the ante 500
StyaRT10: posts the ante 500
gugalondon: posts the ante 500
AlexCorvin22: posts the ante 500
TURoff: posts the ante 500
Allucardy_BR: posts the ante 500
berna733: posts the ante 500
APurchart: posts the ante 500
jucabala32: posts the ante 500
iudicus: posts small blind 2000
StyaRT10: posts big blind 4000
*** HOLE CARDS ***
Dealt to TURoff [4d 5d]
gugalondon: folds 
AlexCorvin22: folds 
TURoff: folds 
Allucardy_BR: folds 
berna733: folds 
APurchart: raises 4000 to 8000
jucabala32: folds 
iudicus: folds 
StyaRT10: folds 
Uncalled bet (4000) returned to APurchart
APurchart collected 14500 from pot
APurchart: doesn't show hand 
*** SUMMARY ***
Total pot 14500 | Rake 0 
Seat 1: iudicus (small blind) folded before Flop
Seat 2: StyaRT10 (big blind) folded before Flop
Seat 3: gugalondon folded before Flop (didn't bet)
Seat 4: AlexCorvin22 folded before Flop (didn't bet)
Seat 5: TURoff folded before Flop (didn't bet)
Seat 6: Allucardy_BR folded before Flop (didn't bet)
Seat 7: berna733 folded before Flop (didn't bet)
Seat 8: APurchart collected (14500)
Seat 9: jucabala32 (button) folded before Flop (didn't bet)





PokerStars Hand #177204980749: Tournament #2067822782, $1.00+$0.10 USD Hold'em No Limit - Level XXVII (2000/4000) - 2017/10/21 23:35:42 CUST [2017/10/21 15:35:42 ET]
Table '2067822782 1' 9-max Seat #1 is the button
Seat 1: iudicus (91690 in chips) 
Seat 2: StyaRT10 (61786 in chips) 
Seat 3: gugalondon (333556 in chips) 
Seat 4: AlexCorvin22 (166588 in chips) 
Seat 5: TURoff (57758 in chips) 
Seat 6: Allucardy_BR (107418 in chips) 
Seat 7: berna733 (212153 in chips) 
Seat 8: APurchart (124709 in chips) 
Seat 9: jucabala32 (20724 in chips) 
iudicus: posts the ante 500
StyaRT10: posts the ante 500
gugalondon: posts the ante 500
AlexCorvin22: posts the ante 500
TURoff: posts the ante 500
Allucardy_BR: posts the ante 500
berna733: posts the ante 500
APurchart: posts the ante 500
jucabala32: posts the ante 500
StyaRT10: posts small blind 2000
gugalondon: posts big blind 4000
*** HOLE CARDS ***
Dealt to TURoff [As 7d]
AlexCorvin22: raises 4800 to 8800
TURoff: folds 
Allucardy_BR: folds 
berna733: folds 
APurchart: raises 20100 to 28900
jucabala32: folds 
iudicus: folds 
StyaRT10: folds 
gugalondon: folds 
AlexCorvin22: calls 20100
*** FLOP *** [3h Qh Tc]
AlexCorvin22: checks 
APurchart: bets 95309 and is all-in
AlexCorvin22: calls 95309
*** TURN *** [3h Qh Tc] [2s]
*** RIVER *** [3h Qh Tc 2s] [Jc]
*** SHOW DOWN ***
AlexCorvin22: shows [Ts Td] (three of a kind, Tens)
APurchart: shows [Ac Kc] (a straight, Ten to Ace)
APurchart collected 258918 from pot
*** SUMMARY ***
Total pot 258918 | Rake 0 
Board [3h Qh Tc 2s Jc]
Seat 1: iudicus (button) folded before Flop (didn't bet)
Seat 2: StyaRT10 (small blind) folded before Flop
Seat 3: gugalondon (big blind) folded before Flop
Seat 4: AlexCorvin22 showed [Ts Td] and lost with three of a kind, Tens
Seat 5: TURoff folded before Flop (didn't bet)
Seat 6: Allucardy_BR folded before Flop (didn't bet)
Seat 7: berna733 folded before Flop (didn't bet)
Seat 8: APurchart showed [Ac Kc] and won (258918) with a straight, Ten to Ace
Seat 9: jucabala32 folded before Flop (didn't bet)





PokerStars Hand #177205015870: Tournament #2067822782, $1.00+$0.10 USD Hold'em No Limit - Level XXVII (2000/4000) - 2017/10/21 23:36:27 CUST [2017/10/21 15:36:27 ET]
Table '2067822782 1' 9-max Seat #2 is the button
Seat 1: iudicus (91190 in chips) 
Seat 2: StyaRT10 (59286 in chips) 
Seat 3: gugalondon (329056 in chips) 
Seat 4: AlexCorvin22 (41879 in chips) 
Seat 5: TURoff (57258 in chips) 
Seat 6: Allucardy_BR (106918 in chips) 
Seat 7: berna733 (211653 in chips) 
Seat 8: APurchart (258918 in chips) 
Seat 9: jucabala32 (20224 in chips) 
iudicus: posts the ante 500
StyaRT10: posts the ante 500
gugalondon: posts the ante 500
AlexCorvin22: posts the ante 500
TURoff: posts the ante 500
Allucardy_BR: posts the ante 500
berna733: posts the ante 500
APurchart: posts the ante 500
jucabala32: posts the ante 500
gugalondon: posts small blind 2000
AlexCorvin22: posts big blind 4000
*** HOLE CARDS ***
Dealt to TURoff [7c 8s]
TURoff: folds 
Allucardy_BR: folds 
berna733: folds 
APurchart: folds 
jucabala32: folds 
iudicus: folds 
StyaRT10: folds 
gugalondon: folds 
Uncalled bet (2000) returned to AlexCorvin22
AlexCorvin22 collected 8500 from pot
*** SUMMARY ***
Total pot 8500 | Rake 0 
Seat 1: iudicus folded before Flop (didn't bet)
Seat 2: StyaRT10 (button) folded before Flop (didn't bet)
Seat 3: gugalondon (small blind) folded before Flop
Seat 4: AlexCorvin22 (big blind) collected (8500)
Seat 5: TURoff folded before Flop (didn't bet)
Seat 6: Allucardy_BR folded before Flop (didn't bet)
Seat 7: berna733 folded before Flop (didn't bet)
Seat 8: APurchart folded before Flop (didn't bet)
Seat 9: jucabala32 folded before Flop (didn't bet)





PokerStars Hand #177205031490: Tournament #2067822782, $1.00+$0.10 USD Hold'em No Limit - Level XXVII (2000/4000) - 2017/10/21 23:36:46 CUST [2017/10/21 15:36:46 ET]
Table '2067822782 1' 9-max Seat #3 is the button
Seat 1: iudicus (90690 in chips) 
Seat 2: StyaRT10 (58786 in chips) 
Seat 3: gugalondon (326556 in chips) 
Seat 4: AlexCorvin22 (47879 in chips) 
Seat 5: TURoff (56758 in chips) 
Seat 6: Allucardy_BR (106418 in chips) 
Seat 7: berna733 (211153 in chips) 
Seat 8: APurchart (258418 in chips) 
Seat 9: jucabala32 (19724 in chips) 
iudicus: posts the ante 500
StyaRT10: posts the ante 500
gugalondon: posts the ante 500
AlexCorvin22: posts the ante 500
TURoff: posts the ante 500
Allucardy_BR: posts the ante 500
berna733: posts the ante 500
APurchart: posts the ante 500
jucabala32: posts the ante 500
AlexCorvin22: posts small blind 2000
TURoff: posts big blind 4000
*** HOLE CARDS ***
Dealt to TURoff [Jh 3s]
Allucardy_BR: folds 
berna733: folds 
APurchart: folds 
jucabala32: raises 15224 to 19224 and is all-in
iudicus: folds 
StyaRT10: folds 
gugalondon: folds 
AlexCorvin22: raises 28155 to 47379 and is all-in
TURoff: folds 
Uncalled bet (28155) returned to AlexCorvin22
*** FLOP *** [2c 7h 5s]
*** TURN *** [2c 7h 5s] [Jc]
*** RIVER *** [2c 7h 5s Jc] [Tc]
*** SHOW DOWN ***
AlexCorvin22: shows [As Kh] (high card Ace)
jucabala32: shows [Ah Ts] (a pair of Tens)
jucabala32 collected 46948 from pot
*** SUMMARY ***
Total pot 46948 | Rake 0 
Board [2c 7h 5s Jc Tc]
Seat 1: iudicus folded before Flop (didn't bet)
Seat 2: StyaRT10 folded before Flop (didn't bet)
Seat 3: gugalondon (button) folded before Flop (didn't bet)
Seat 4: AlexCorvin22 (small blind) showed [As Kh] and lost with high card Ace
Seat 5: TURoff (big blind) folded before Flop
Seat 6: Allucardy_BR folded before Flop (didn't bet)
Seat 7: berna733 folded before Flop (didn't bet)
Seat 8: APurchart folded before Flop (didn't bet)
Seat 9: jucabala32 showed [Ah Ts] and won (46948) with a pair of Tens





PokerStars Hand #177205055233: Tournament #2067822782, $1.00+$0.10 USD Hold'em No Limit - Level XXVII (2000/4000) - 2017/10/21 23:37:16 CUST [2017/10/21 15:37:16 ET]
Table '2067822782 1' 9-max Seat #4 is the button
Seat 1: iudicus (90190 in chips) 
Seat 2: StyaRT10 (58286 in chips) 
Seat 3: gugalondon (326056 in chips) 
Seat 4: AlexCorvin22 (28155 in chips) 
Seat 5: TURoff (52258 in chips) 
Seat 6: Allucardy_BR (105918 in chips) 
Seat 7: berna733 (210653 in chips) 
Seat 8: APurchart (257918 in chips) 
Seat 9: jucabala32 (46948 in chips) 
iudicus: posts the ante 500
StyaRT10: posts the ante 500
gugalondon: posts the ante 500
AlexCorvin22: posts the ante 500
TURoff: posts the ante 500
Allucardy_BR: posts the ante 500
berna733: posts the ante 500
APurchart: posts the ante 500
jucabala32: posts the ante 500
TURoff: posts small blind 2000
Allucardy_BR: posts big blind 4000
*** HOLE CARDS ***
Dealt to TURoff [7d 6s]
berna733: folds 
APurchart: folds 
jucabala32: raises 42448 to 46448 and is all-in
iudicus: folds 
StyaRT10: folds 
gugalondon: folds 
AlexCorvin22: calls 27655 and is all-in
TURoff: folds 
Allucardy_BR: folds 
Uncalled bet (18793) returned to jucabala32
*** FLOP *** [4h Tc 9h]
*** TURN *** [4h Tc 9h] [8d]
*** RIVER *** [4h Tc 9h 8d] [Qd]
*** SHOW DOWN ***
jucabala32: shows [Ad 5d] (high card Ace)
AlexCorvin22: shows [2c Ac] (high card Ace)
jucabala32 collected 32905 from pot
AlexCorvin22 collected 32905 from pot
*** SUMMARY ***
Total pot 65810 | Rake 0 
Board [4h Tc 9h 8d Qd]
Seat 1: iudicus folded before Flop (didn't bet)
Seat 2: StyaRT10 folded before Flop (didn't bet)
Seat 3: gugalondon folded before Flop (didn't bet)
Seat 4: AlexCorvin22 (button) showed [2c Ac] and won (32905) with high card Ace
Seat 5: TURoff (small blind) folded before Flop
Seat 6: Allucardy_BR (big blind) folded before Flop
Seat 7: berna733 folded before Flop (didn't bet)
Seat 8: APurchart folded before Flop (didn't bet)
Seat 9: jucabala32 showed [Ad 5d] and won (32905) with high card Ace





PokerStars Hand #177205080025: Tournament #2067822782, $1.00+$0.10 USD Hold'em No Limit - Level XXVII (2000/4000) - 2017/10/21 23:37:47 CUST [2017/10/21 15:37:47 ET]
Table '2067822782 1' 9-max Seat #5 is the button
Seat 1: iudicus (89690 in chips) 
Seat 2: StyaRT10 (57786 in chips) 
Seat 3: gugalondon (325556 in chips) 
Seat 4: AlexCorvin22 (32905 in chips) 
Seat 5: TURoff (49758 in chips) 
Seat 6: Allucardy_BR (101418 in chips) 
Seat 7: berna733 (210153 in chips) 
Seat 8: APurchart (257418 in chips) 
Seat 9: jucabala32 (51698 in chips) 
iudicus: posts the ante 500
StyaRT10: posts the ante 500
gugalondon: posts the ante 500
AlexCorvin22: posts the ante 500
TURoff: posts the ante 500
Allucardy_BR: posts the ante 500
berna733: posts the ante 500
APurchart: posts the ante 500
jucabala32: posts the ante 500
Allucardy_BR: posts small blind 2000
berna733: posts big blind 4000
*** HOLE CARDS ***
Dealt to TURoff [Ac 5s]
APurchart: folds 
jucabala32: folds 
iudicus: folds 
StyaRT10: folds 
gugalondon: raises 6400 to 10400
AlexCorvin22: folds 
TURoff: folds 
Allucardy_BR: folds 
berna733: folds 
Uncalled bet (6400) returned to gugalondon
gugalondon collected 14500 from pot
*** SUMMARY ***
Total pot 14500 | Rake 0 
Seat 1: iudicus folded before Flop (didn't bet)
Seat 2: StyaRT10 folded before Flop (didn't bet)
Seat 3: gugalondon collected (14500)
Seat 4: AlexCorvin22 folded before Flop (didn't bet)
Seat 5: TURoff (button) folded before Flop (didn't bet)
Seat 6: Allucardy_BR (small blind) folded before Flop
Seat 7: berna733 (big blind) folded before Flop
Seat 8: APurchart folded before Flop (didn't bet)
Seat 9: jucabala32 folded before Flop (didn't bet)





PokerStars Hand #177205109706: Tournament #2067822782, $1.00+$0.10 USD Hold'em No Limit - Level XXVII (2000/4000) - 2017/10/21 23:38:24 CUST [2017/10/21 15:38:24 ET]
Table '2067822782 1' 9-max Seat #6 is the button
Seat 1: iudicus (89190 in chips) 
Seat 2: StyaRT10 (57286 in chips) 
Seat 3: gugalondon (335556 in chips) 
Seat 4: AlexCorvin22 (32405 in chips) 
Seat 5: TURoff (49258 in chips) 
Seat 6: Allucardy_BR (98918 in chips) 
Seat 7: berna733 (205653 in chips) 
Seat 8: APurchart (256918 in chips) 
Seat 9: jucabala32 (51198 in chips) 
iudicus: posts the ante 500
StyaRT10: posts the ante 500
gugalondon: posts the ante 500
AlexCorvin22: posts the ante 500
TURoff: posts the ante 500
Allucardy_BR: posts the ante 500
berna733: posts the ante 500
APurchart: posts the ante 500
jucabala32: posts the ante 500
berna733: posts small blind 2000
APurchart: posts big blind 4000
*** HOLE CARDS ***
Dealt to TURoff [8c 5d]
jucabala32: folds 
iudicus: raises 4600 to 8600
StyaRT10: folds 
gugalondon: folds 
AlexCorvin22: folds 
TURoff: folds 
Allucardy_BR: folds 
berna733: folds 
APurchart: folds 
Uncalled bet (4600) returned to iudicus
iudicus collected 14500 from pot
iudicus: doesn't show hand 
*** SUMMARY ***
Total pot 14500 | Rake 0 
Seat 1: iudicus collected (14500)
Seat 2: StyaRT10 folded before Flop (didn't bet)
Seat 3: gugalondon folded before Flop (didn't bet)
Seat 4: AlexCorvin22 folded before Flop (didn't bet)
Seat 5: TURoff folded before Flop (didn't bet)
Seat 6: Allucardy_BR (button) folded before Flop (didn't bet)
Seat 7: berna733 (small blind) folded before Flop
Seat 8: APurchart (big blind) folded before Flop
Seat 9: jucabala32 folded before Flop (didn't bet)





PokerStars Hand #177205137856: Tournament #2067822782, $1.00+$0.10 USD Hold'em No Limit - Level XXVII (2000/4000) - 2017/10/21 23:38:59 CUST [2017/10/21 15:38:59 ET]
Table '2067822782 1' 9-max Seat #7 is the button
Seat 1: iudicus (99190 in chips) 
Seat 2: StyaRT10 (56786 in chips) 
Seat 3: gugalondon (335056 in chips) 
Seat 4: AlexCorvin22 (31905 in chips) 
Seat 5: TURoff (48758 in chips) 
Seat 6: Allucardy_BR (98418 in chips) 
Seat 7: berna733 (203153 in chips) 
Seat 8: APurchart (252418 in chips) 
Seat 9: jucabala32 (50698 in chips) 
iudicus: posts the ante 500
StyaRT10: posts the ante 500
gugalondon: posts the ante 500
AlexCorvin22: posts the ante 500
TURoff: posts the ante 500
Allucardy_BR: posts the ante 500
berna733: posts the ante 500
APurchart: posts the ante 500
jucabala32: posts the ante 500
APurchart: posts small blind 2000
jucabala32: posts big blind 4000
*** HOLE CARDS ***
Dealt to TURoff [Ad 5h]
iudicus: folds 
StyaRT10: folds 
gugalondon: folds 
AlexCorvin22: folds 
TURoff: folds 
Allucardy_BR: raises 4400 to 8400
berna733: folds 
APurchart: raises 19200 to 27600
jucabala32: folds 
Allucardy_BR: folds [As]
Uncalled bet (19200) returned to APurchart
APurchart collected 25300 from pot
APurchart: doesn't show hand 
*** SUMMARY ***
Total pot 25300 | Rake 0 
Seat 1: iudicus folded before Flop (didn't bet)
Seat 2: StyaRT10 folded before Flop (didn't bet)
Seat 3: gugalondon folded before Flop (didn't bet)
Seat 4: AlexCorvin22 folded before Flop (didn't bet)
Seat 5: TURoff folded before Flop (didn't bet)
Seat 6: Allucardy_BR folded before Flop
Seat 7: berna733 (button) folded before Flop (didn't bet)
Seat 8: APurchart (small blind) collected (25300)
Seat 9: jucabala32 (big blind) folded before Flop





PokerStars Hand #177205181923: Tournament #2067822782, $1.00+$0.10 USD Hold'em No Limit - Level XXVII (2000/4000) - 2017/10/21 23:39:54 CUST [2017/10/21 15:39:54 ET]
Table '2067822782 1' 9-max Seat #8 is the button
Seat 1: iudicus (98690 in chips) 
Seat 2: StyaRT10 (56286 in chips) 
Seat 3: gugalondon (334556 in chips) 
Seat 4: AlexCorvin22 (31405 in chips) 
Seat 5: TURoff (48258 in chips) 
Seat 6: Allucardy_BR (89518 in chips) 
Seat 7: berna733 (202653 in chips) 
Seat 8: APurchart (268818 in chips) 
Seat 9: jucabala32 (46198 in chips) 
iudicus: posts the ante 500
StyaRT10: posts the ante 500
gugalondon: posts the ante 500
AlexCorvin22: posts the ante 500
TURoff: posts the ante 500
Allucardy_BR: posts the ante 500
berna733: posts the ante 500
APurchart: posts the ante 500
jucabala32: posts the ante 500
jucabala32: posts small blind 2000
iudicus: posts big blind 4000
*** HOLE CARDS ***
Dealt to TURoff [Td Jd]
StyaRT10: folds 
gugalondon: folds 
AlexCorvin22: raises 26905 to 30905 and is all-in
TURoff: folds 
Allucardy_BR: folds 
berna733: folds 
APurchart: folds 
jucabala32: folds 
iudicus: folds 
Uncalled bet (26905) returned to AlexCorvin22
AlexCorvin22 collected 14500 from pot
*** SUMMARY ***
Total pot 14500 | Rake 0 
Seat 1: iudicus (big blind) folded before Flop
Seat 2: StyaRT10 folded before Flop (didn't bet)
Seat 3: gugalondon folded before Flop (didn't bet)
Seat 4: AlexCorvin22 collected (14500)
Seat 5: TURoff folded before Flop (didn't bet)
Seat 6: Allucardy_BR folded before Flop (didn't bet)
Seat 7: berna733 folded before Flop (didn't bet)
Seat 8: APurchart (button) folded before Flop (didn't bet)
Seat 9: jucabala32 (small blind) folded before Flop





PokerStars Hand #177205201604: Tournament #2067822782, $1.00+$0.10 USD Hold'em No Limit - Level XXVII (2000/4000) - 2017/10/21 23:40:19 CUST [2017/10/21 15:40:19 ET]
Table '2067822782 1' 9-max Seat #9 is the button
Seat 1: iudicus (94190 in chips) 
Seat 2: StyaRT10 (55786 in chips) 
Seat 3: gugalondon (334056 in chips) 
Seat 4: AlexCorvin22 (41405 in chips) 
Seat 5: TURoff (47758 in chips) 
Seat 6: Allucardy_BR (89018 in chips) 
Seat 7: berna733 (202153 in chips) 
Seat 8: APurchart (268318 in chips) 
Seat 9: jucabala32 (43698 in chips) 
iudicus: posts the ante 500
StyaRT10: posts the ante 500
gugalondon: posts the ante 500
AlexCorvin22: posts the ante 500
TURoff: posts the ante 500
Allucardy_BR: posts the ante 500
berna733: posts the ante 500
APurchart: posts the ante 500
jucabala32: posts the ante 500
iudicus: posts small blind 2000
StyaRT10: posts big blind 4000
*** HOLE CARDS ***
Dealt to TURoff [9s 6s]
gugalondon: folds 
AlexCorvin22: folds 
TURoff: folds 
Allucardy_BR: folds 
berna733: folds 
APurchart: folds 
jucabala32: folds 
iudicus: calls 2000
StyaRT10: checks 
*** FLOP *** [Ts Jh Ah]
iudicus: bets 5875
StyaRT10: folds 
Uncalled bet (5875) returned to iudicus
iudicus collected 12500 from pot
iudicus: doesn't show hand 
*** SUMMARY ***
Total pot 12500 | Rake 0 
Board [Ts Jh Ah]
Seat 1: iudicus (small blind) collected (12500)
Seat 2: StyaRT10 (big blind) folded on the Flop
Seat 3: gugalondon folded before Flop (didn't bet)
Seat 4: AlexCorvin22 folded before Flop (didn't bet)
Seat 5: TURoff folded before Flop (didn't bet)
Seat 6: Allucardy_BR folded before Flop (didn't bet)
Seat 7: berna733 folded before Flop (didn't bet)
Seat 8: APurchart folded before Flop (didn't bet)
Seat 9: jucabala32 (button) folded before Flop (didn't bet)





PokerStars Hand #177205232612: Tournament #2067822782, $1.00+$0.10 USD Hold'em No Limit - Level XXVII (2000/4000) - 2017/10/21 23:40:58 CUST [2017/10/21 15:40:58 ET]
Table '2067822782 1' 9-max Seat #1 is the button
Seat 1: iudicus (102190 in chips) 
Seat 2: StyaRT10 (51286 in chips) 
Seat 3: gugalondon (333556 in chips) 
Seat 4: AlexCorvin22 (40905 in chips) 
Seat 5: TURoff (47258 in chips) 
Seat 6: Allucardy_BR (88518 in chips) 
Seat 7: berna733 (201653 in chips) 
Seat 8: APurchart (267818 in chips) 
Seat 9: jucabala32 (43198 in chips) 
iudicus: posts the ante 500
StyaRT10: posts the ante 500
gugalondon: posts the ante 500
AlexCorvin22: posts the ante 500
TURoff: posts the ante 500
Allucardy_BR: posts the ante 500
berna733: posts the ante 500
APurchart: posts the ante 500
jucabala32: posts the ante 500
StyaRT10: posts small blind 2000
gugalondon: posts big blind 4000
*** HOLE CARDS ***
Dealt to TURoff [7d 2d]
AlexCorvin22: folds 
TURoff: folds 
Allucardy_BR: raises 4400 to 8400
berna733: folds 
APurchart: calls 8400
jucabala32: folds 
iudicus: folds 
StyaRT10: folds 
gugalondon: folds 
*** FLOP *** [4d Ah 3c]
Allucardy_BR: bets 9555
APurchart: calls 9555
*** TURN *** [4d Ah 3c] [Js]
Allucardy_BR: checks 
APurchart: checks 
*** RIVER *** [4d Ah 3c Js] [4s]
Allucardy_BR: bets 16244
APurchart: raises 233119 to 249363 and is all-in
Allucardy_BR: folds 
Uncalled bet (233119) returned to APurchart
APurchart collected 78898 from pot
APurchart: doesn't show hand 
*** SUMMARY ***
Total pot 78898 | Rake 0 
Board [4d Ah 3c Js 4s]
Seat 1: iudicus (button) folded before Flop (didn't bet)
Seat 2: StyaRT10 (small blind) folded before Flop
Seat 3: gugalondon (big blind) folded before Flop
Seat 4: AlexCorvin22 folded before Flop (didn't bet)
Seat 5: TURoff folded before Flop (didn't bet)
Seat 6: Allucardy_BR folded on the River
Seat 7: berna733 folded before Flop (didn't bet)
Seat 8: APurchart collected (78898)
Seat 9: jucabala32 folded before Flop (didn't bet)





PokerStars Hand #177205293433: Tournament #2067822782, $1.00+$0.10 USD Hold'em No Limit - Level XXVII (2000/4000) - 2017/10/21 23:42:13 CUST [2017/10/21 15:42:13 ET]
Table '2067822782 1' 9-max Seat #2 is the button
Seat 1: iudicus (101690 in chips) 
Seat 2: StyaRT10 (48786 in chips) 
Seat 3: gugalondon (329056 in chips) 
Seat 4: AlexCorvin22 (40405 in chips) 
Seat 5: TURoff (46758 in chips) 
Seat 6: Allucardy_BR (53819 in chips) 
Seat 7: berna733 (201153 in chips) 
Seat 8: APurchart (312017 in chips) 
Seat 9: jucabala32 (42698 in chips) 
iudicus: posts the ante 500
StyaRT10: posts the ante 500
gugalondon: posts the ante 500
AlexCorvin22: posts the ante 500
TURoff: posts the ante 500
Allucardy_BR: posts the ante 500
berna733: posts the ante 500
APurchart: posts the ante 500
jucabala32: posts the ante 500
gugalondon: posts small blind 2000
AlexCorvin22: posts big blind 4000
*** HOLE CARDS ***
Dealt to TURoff [3c Ac]
TURoff: raises 42258 to 46258 and is all-in
Allucardy_BR: folds 
berna733: folds 
APurchart: folds 
jucabala32: calls 42198 and is all-in
iudicus: folds 
StyaRT10: folds 
gugalondon: folds 
AlexCorvin22: calls 35905 and is all-in
Uncalled bet (4060) returned to TURoff
*** FLOP *** [6h Qh 5h]
*** TURN *** [6h Qh 5h] [Kd]
*** RIVER *** [6h Qh 5h Kd] [Ts]
*** SHOW DOWN ***
TURoff: shows [3c Ac] (high card Ace)
jucabala32: shows [Th Tc] (three of a kind, Tens)
jucabala32 collected 4586 from side pot
AlexCorvin22: shows [Ah 4h] (a flush, Ace high)
AlexCorvin22 collected 126215 from main pot
*** SUMMARY ***
Total pot 130801 Main pot 126215. Side pot 4586. | Rake 0 
Board [6h Qh 5h Kd Ts]
Seat 1: iudicus folded before Flop (didn't bet)
Seat 2: StyaRT10 (button) folded before Flop (didn't bet)
Seat 3: gugalondon (small blind) folded before Flop
Seat 4: AlexCorvin22 (big blind) showed [Ah 4h] and won (126215) with a flush, Ace high
Seat 5: TURoff showed [3c Ac] and lost with high card Ace
Seat 6: Allucardy_BR folded before Flop (didn't bet)
Seat 7: berna733 folded before Flop (didn't bet)
Seat 8: APurchart folded before Flop (didn't bet)
Seat 9: jucabala32 showed [Th Tc] and won (4586) with three of a kind, Tens





PokerStars Hand #177205313724: Tournament #2067822782, $1.00+$0.10 USD Hold'em No Limit - Level XXVII (2000/4000) - 2017/10/21 23:42:39 CUST [2017/10/21 15:42:39 ET]
Table '2067822782 1' 9-max Seat #3 is the button
Seat 1: iudicus (101190 in chips) 
Seat 3: gugalondon (326556 in chips) 
Seat 4: AlexCorvin22 (126215 in chips) 
Seat 5: TURoff (4060 in chips) 
Seat 6: Allucardy_BR (53319 in chips) 
Seat 7: berna733 (200653 in chips) 
Seat 8: APurchart (311517 in chips) 
Seat 9: jucabala32 (4586 in chips) 
iudicus: posts the ante 500
gugalondon: posts the ante 500
AlexCorvin22: posts the ante 500
TURoff: posts the ante 500
Allucardy_BR: posts the ante 500
berna733: posts the ante 500
APurchart: posts the ante 500
jucabala32: posts the ante 500
AlexCorvin22: posts small blind 2000
TURoff: posts big blind 3560 and is all-in
*** HOLE CARDS ***
Dealt to TURoff [2d Ts]
Allucardy_BR: folds 
berna733: raises 5240 to 8800
APurchart: folds 
jucabala32: folds 
iudicus: folds 
gugalondon: folds 
AlexCorvin22: folds 
Uncalled bet (5240) returned to berna733
*** FLOP *** [3s 2s Td]
*** TURN *** [3s 2s Td] [9c]
*** RIVER *** [3s 2s Td 9c] [3d]
*** SHOW DOWN ***
TURoff: shows [2d Ts] (two pair, Tens and Threes)
berna733: shows [Ad Qd] (a pair of Threes)
TURoff collected 13120 from pot
*** SUMMARY ***
Total pot 13120 | Rake 0 
Board [3s 2s Td 9c 3d]
Seat 1: iudicus folded before Flop (didn't bet)
Seat 3: gugalondon (button) folded before Flop (didn't bet)
Seat 4: AlexCorvin22 (small blind) folded before Flop
Seat 5: TURoff (big blind) showed [2d Ts] and won (13120) with two pair, Tens and Threes
Seat 6: Allucardy_BR folded before Flop (didn't bet)
Seat 7: berna733 showed [Ad Qd] and lost with a pair of Threes
Seat 8: APurchart folded before Flop (didn't bet)
Seat 9: jucabala32 folded before Flop (didn't bet)





PokerStars Hand #177205338682: Tournament #2067822782, $1.00+$0.10 USD Hold'em No Limit - Level XXVII (2000/4000) - 2017/10/21 23:43:10 CUST [2017/10/21 15:43:10 ET]
Table '2067822782 1' 9-max Seat #4 is the button
Seat 1: iudicus (100690 in chips) 
Seat 3: gugalondon (326056 in chips) 
Seat 4: AlexCorvin22 (123715 in chips) 
Seat 5: TURoff (13120 in chips) 
Seat 6: Allucardy_BR (52819 in chips) 
Seat 7: berna733 (196593 in chips) 
Seat 8: APurchart (311017 in chips) 
Seat 9: jucabala32 (4086 in chips) 
iudicus: posts the ante 500
gugalondon: posts the ante 500
AlexCorvin22: posts the ante 500
TURoff: posts the ante 500
Allucardy_BR: posts the ante 500
berna733: posts the ante 500
APurchart: posts the ante 500
jucabala32: posts the ante 500
TURoff: posts small blind 2000
Allucardy_BR: posts big blind 4000
*** HOLE CARDS ***
Dealt to TURoff [5s 4s]
berna733: folds 
APurchart: raises 4000 to 8000
jucabala32: folds 
iudicus: folds 
gugalondon: folds 
AlexCorvin22: folds 
TURoff: raises 4620 to 12620 and is all-in
Allucardy_BR: raises 39699 to 52319 and is all-in
APurchart: calls 44319
*** FLOP *** [9d 4c Kh]
*** TURN *** [9d 4c Kh] [9s]
*** RIVER *** [9d 4c Kh 9s] [Td]
*** SHOW DOWN ***
Allucardy_BR: shows [7s 7h] (two pair, Nines and Sevens)
APurchart: shows [Ad Kc] (two pair, Kings and Nines)
APurchart collected 79398 from side pot
TURoff: shows [5s 4s] (two pair, Nines and Fours)
APurchart collected 41860 from main pot
Allucardy_BR finished the tournament in 47th place and received $4.84.
TURoff finished the tournament in 48th place and received $4.84.
*** SUMMARY ***
Total pot 121258 Main pot 41860. Side pot 79398. | Rake 0 
Board [9d 4c Kh 9s Td]
Seat 1: iudicus folded before Flop (didn't bet)
Seat 3: gugalondon folded before Flop (didn't bet)
Seat 4: AlexCorvin22 (button) folded before Flop (didn't bet)
Seat 5: TURoff (small blind) showed [5s 4s] and lost with two pair, Nines and Fours
Seat 6: Allucardy_BR (big blind) showed [7s 7h] and lost with two pair, Nines and Sevens
Seat 7: berna733 folded before Flop (didn't bet)
Seat 8: APurchart showed [Ad Kc] and won (121258) with two pair, Kings and Nines
Seat 9: jucabala32 folded before Flop (didn't bet)





