*********** # 1 **************
PokerStars Hand #176668455413: Tournament #2054568934, $20+$2 USD Hold'em No Limit - Level IX (150/300) - 2017/10/08 23:53:47 MSK [2017/10/08 16:53:47 ET]
Table '2054568934 506' 9-max Seat #2 is the button
Seat 1: jorgeg xd (10910 in chips)
Seat 2: 24b4tm4n24 (16442 in chips)
Seat 3: Arce B (20315 in chips)
Seat 4: BluffedLife (35687 in chips)
Seat 5: badbeteador (32312 in chips)
Seat 6: EZCoinFlip (22552 in chips)
Seat 7: hichnick777 (10000 in chips)
Seat 8: GrandmasterY (6755 in chips)
Seat 9: topzozi (8205 in chips)
jorgeg xd: posts the ante 30
24b4tm4n24: posts the ante 30
Arce B: posts the ante 30
BluffedLife: posts the ante 30
badbeteador: posts the ante 30
EZCoinFlip: posts the ante 30
hichnick777: posts the ante 30
GrandmasterY: posts the ante 30
topzozi: posts the ante 30
Arce B: posts small blind 150
BluffedLife: posts big blind 300
*** HOLE CARDS ***
Dealt to hichnick777 [9d Td]
badbeteador: folds
EZCoinFlip: folds
hichnick777: raises 450 to 750
GrandmasterY: folds
topzozi: folds
jorgeg xd: calls 750
24b4tm4n24: folds
Arce B: folds
BluffedLife: calls 450
*** FLOP *** [Kd 8d Ac]
BluffedLife: checks
hichnick777: bets 1350
jorgeg xd: calls 1350
BluffedLife: calls 1350
*** TURN *** [Kd 8d Ac] [3d]
BluffedLife: checks
hichnick777: bets 7870 and is all-in
jorgeg xd: folds
BluffedLife: folds
Uncalled bet (7870) returned to hichnick777
hichnick777 collected 6720 from pot
hichnick777: doesn't show hand
*** SUMMARY ***
Total pot 6720 | Rake 0
Board [Kd 8d Ac 3d]
Seat 1: jorgeg xd folded on the Turn
Seat 2: 24b4tm4n24 (button) folded before Flop (didn't bet)
Seat 3: Arce B (small blind) folded before Flop
Seat 4: BluffedLife (big blind) folded on the Turn
Seat 5: badbeteador folded before Flop (didn't bet)
Seat 6: EZCoinFlip folded before Flop (didn't bet)
Seat 7: hichnick777 collected (6720)
Seat 8: GrandmasterY folded before Flop (didn't bet)
Seat 9: topzozi folded before Flop (didn't bet)


*********** # 2 **************
PokerStars Hand #176668881602: Tournament #2054568934, $20+$2 USD Hold'em No Limit - Level IX (150/300) - 2017/10/09 0:03:30 MSK [2017/10/08 17:03:30 ET]
Table '2054568934 506' 9-max Seat #3 is the button
Seat 1: jorgeg xd (8780 in chips)
Seat 2: 24b4tm4n24 (16412 in chips)
Seat 3: Arce B (20135 in chips)
Seat 4: BluffedLife (33557 in chips)
Seat 5: ALLILS (10000 in chips)
Seat 6: EZCoinFlip (22522 in chips)
Seat 7: hichnick777 (14590 in chips)
Seat 8: GrandmasterY (6725 in chips)
Seat 9: topzozi (8175 in chips)
jorgeg xd: posts the ante 30
24b4tm4n24: posts the ante 30
Arce B: posts the ante 30
BluffedLife: posts the ante 30
ALLILS: posts the ante 30
EZCoinFlip: posts the ante 30
hichnick777: posts the ante 30
GrandmasterY: posts the ante 30
topzozi: posts the ante 30
BluffedLife: posts small blind 150
ALLILS: posts big blind 300
*** HOLE CARDS ***
Dealt to hichnick777 [4h Ah]
EZCoinFlip: folds
hichnick777: raises 450 to 750
GrandmasterY: folds
topzozi: folds
jorgeg xd: folds
24b4tm4n24: calls 750
Arce B: folds
BluffedLife: calls 600
ALLILS: calls 450
*** FLOP *** [9d 6s 3s]
BluffedLife: checks
ALLILS: checks
hichnick777: checks
24b4tm4n24: checks
*** TURN *** [9d 6s 3s] [Th]
BluffedLife: checks
ALLILS: checks
hichnick777: checks
24b4tm4n24: bets 1308
BluffedLife: folds
ALLILS: folds
hichnick777: folds
Uncalled bet (1308) returned to 24b4tm4n24
24b4tm4n24 collected 3270 from pot
*** SUMMARY ***
Total pot 3270 | Rake 0
Board [9d 6s 3s Th]
Seat 1: jorgeg xd folded before Flop (didn't bet)
Seat 2: 24b4tm4n24 collected (3270)
Seat 3: Arce B (button) folded before Flop (didn't bet)
Seat 4: BluffedLife (small blind) folded on the Turn
Seat 5: ALLILS (big blind) folded on the Turn
Seat 6: EZCoinFlip folded before Flop (didn't bet)
Seat 7: hichnick777 folded on the Turn
Seat 8: GrandmasterY folded before Flop (didn't bet)
Seat 9: topzozi folded before Flop (didn't bet)


*********** # 3 **************
PokerStars Hand #176668971879: Tournament #2054568934, $20+$2 USD Hold'em No Limit - Level X (200/400) - 2017/10/09 0:05:15 MSK [2017/10/08 17:05:15 ET]
Table '2054568934 506' 9-max Seat #4 is the button
Seat 1: jorgeg xd (8750 in chips)
Seat 2: 24b4tm4n24 (18902 in chips)
Seat 3: Arce B (20105 in chips)
Seat 4: BluffedLife (32777 in chips)
Seat 5: ALLILS (9220 in chips)
Seat 6: EZCoinFlip (22492 in chips)
Seat 7: hichnick777 (13810 in chips)
Seat 8: GrandmasterY (6695 in chips)
Seat 9: topzozi (8145 in chips)
jorgeg xd: posts the ante 40
24b4tm4n24: posts the ante 40
Arce B: posts the ante 40
BluffedLife: posts the ante 40
ALLILS: posts the ante 40
EZCoinFlip: posts the ante 40
hichnick777: posts the ante 40
GrandmasterY: posts the ante 40
topzozi: posts the ante 40
ALLILS: posts small blind 200
EZCoinFlip: posts big blind 400
*** HOLE CARDS ***
Dealt to hichnick777 [9s 5s]
hichnick777: folds
GrandmasterY: raises 400 to 800
topzozi: folds
jorgeg xd: folds
24b4tm4n24: folds
Arce B: folds
BluffedLife: folds
ALLILS: folds
EZCoinFlip: folds
Uncalled bet (400) returned to GrandmasterY
GrandmasterY collected 1360 from pot
GrandmasterY: doesn't show hand
*** SUMMARY ***
Total pot 1360 | Rake 0
Seat 1: jorgeg xd folded before Flop (didn't bet)
Seat 2: 24b4tm4n24 folded before Flop (didn't bet)
Seat 3: Arce B folded before Flop (didn't bet)
Seat 4: BluffedLife (button) folded before Flop (didn't bet)
Seat 5: ALLILS (small blind) folded before Flop
Seat 6: EZCoinFlip (big blind) folded before Flop
Seat 7: hichnick777 folded before Flop (didn't bet)
Seat 8: GrandmasterY collected (1360)
Seat 9: topzozi folded before Flop (didn't bet)


*********** # 4 **************
PokerStars Hand #176668997612: Tournament #2054568934, $20+$2 USD Hold'em No Limit - Level X (200/400) - 2017/10/09 0:05:35 MSK [2017/10/08 17:05:35 ET]
Table '2054568934 506' 9-max Seat #5 is the button
Seat 1: jorgeg xd (8710 in chips)
Seat 2: 24b4tm4n24 (18862 in chips)
Seat 3: Arce B (20065 in chips)
Seat 4: BluffedLife (32737 in chips)
Seat 5: ALLILS (8980 in chips)
Seat 6: EZCoinFlip (22052 in chips)
Seat 7: hichnick777 (13770 in chips)
Seat 8: GrandmasterY (7615 in chips)
Seat 9: topzozi (8105 in chips)
jorgeg xd: posts the ante 40
24b4tm4n24: posts the ante 40
Arce B: posts the ante 40
BluffedLife: posts the ante 40
ALLILS: posts the ante 40
EZCoinFlip: posts the ante 40
hichnick777: posts the ante 40
GrandmasterY: posts the ante 40
topzozi: posts the ante 40
EZCoinFlip: posts small blind 200
hichnick777: posts big blind 400
*** HOLE CARDS ***
Dealt to hichnick777 [5c Th]
GrandmasterY: folds
topzozi: folds
jorgeg xd: folds
24b4tm4n24: folds
Arce B: folds
BluffedLife: folds
ALLILS: raises 420 to 820
EZCoinFlip: folds
hichnick777: calls 420
*** FLOP *** [9d Qh 6s]
hichnick777: checks
ALLILS: bets 880
hichnick777: folds
Uncalled bet (880) returned to ALLILS
ALLILS collected 2200 from pot
*** SUMMARY ***
Total pot 2200 | Rake 0
Board [9d Qh 6s]
Seat 1: jorgeg xd folded before Flop (didn't bet)
Seat 2: 24b4tm4n24 folded before Flop (didn't bet)
Seat 3: Arce B folded before Flop (didn't bet)
Seat 4: BluffedLife folded before Flop (didn't bet)
Seat 5: ALLILS (button) collected (2200)
Seat 6: EZCoinFlip (small blind) folded before Flop
Seat 7: hichnick777 (big blind) folded on the Flop
Seat 8: GrandmasterY folded before Flop (didn't bet)
Seat 9: topzozi folded before Flop (didn't bet)


*********** # 5 **************
PokerStars Hand #176669036646: Tournament #2054568934, $20+$2 USD Hold'em No Limit - Level X (200/400) - 2017/10/09 0:06:20 MSK [2017/10/08 17:06:20 ET]
Table '2054568934 506' 9-max Seat #6 is the button
Seat 1: jorgeg xd (8670 in chips)
Seat 2: 24b4tm4n24 (18822 in chips)
Seat 3: Arce B (20025 in chips)
Seat 4: BluffedLife (32697 in chips)
Seat 5: ALLILS (10320 in chips)
Seat 6: EZCoinFlip (21812 in chips)
Seat 7: hichnick777 (12910 in chips)
Seat 8: GrandmasterY (7575 in chips)
Seat 9: topzozi (8065 in chips)
jorgeg xd: posts the ante 40
24b4tm4n24: posts the ante 40
Arce B: posts the ante 40
BluffedLife: posts the ante 40
ALLILS: posts the ante 40
EZCoinFlip: posts the ante 40
hichnick777: posts the ante 40
GrandmasterY: posts the ante 40
topzozi: posts the ante 40
hichnick777: posts small blind 200
GrandmasterY: posts big blind 400
*** HOLE CARDS ***
Dealt to hichnick777 [Kd 5c]
topzozi: folds
jorgeg xd: folds
24b4tm4n24: folds
Arce B: folds
BluffedLife: folds
ALLILS: folds
EZCoinFlip: raises 400 to 800
hichnick777: folds
GrandmasterY: folds
Uncalled bet (400) returned to EZCoinFlip
EZCoinFlip collected 1360 from pot
EZCoinFlip: doesn't show hand
*** SUMMARY ***
Total pot 1360 | Rake 0
Seat 1: jorgeg xd folded before Flop (didn't bet)
Seat 2: 24b4tm4n24 folded before Flop (didn't bet)
Seat 3: Arce B folded before Flop (didn't bet)
Seat 4: BluffedLife folded before Flop (didn't bet)
Seat 5: ALLILS folded before Flop (didn't bet)
Seat 6: EZCoinFlip (button) collected (1360)
Seat 7: hichnick777 (small blind) folded before Flop
Seat 8: GrandmasterY (big blind) folded before Flop
Seat 9: topzozi folded before Flop (didn't bet)


*********** # 6 **************
PokerStars Hand #176669067060: Tournament #2054568934, $20+$2 USD Hold'em No Limit - Level X (200/400) - 2017/10/09 0:06:55 MSK [2017/10/08 17:06:55 ET]
Table '2054568934 506' 9-max Seat #7 is the button
Seat 1: jorgeg xd (8630 in chips)
Seat 2: 24b4tm4n24 (18782 in chips)
Seat 3: Arce B (19985 in chips)
Seat 4: BluffedLife (32657 in chips)
Seat 5: ALLILS (10280 in chips)
Seat 6: EZCoinFlip (22732 in chips)
Seat 7: hichnick777 (12670 in chips)
Seat 8: GrandmasterY (7135 in chips)
Seat 9: topzozi (8025 in chips)
jorgeg xd: posts the ante 40
24b4tm4n24: posts the ante 40
Arce B: posts the ante 40
BluffedLife: posts the ante 40
ALLILS: posts the ante 40
EZCoinFlip: posts the ante 40
hichnick777: posts the ante 40
GrandmasterY: posts the ante 40
topzozi: posts the ante 40
GrandmasterY: posts small blind 200
topzozi: posts big blind 400
*** HOLE CARDS ***
Dealt to hichnick777 [8h 5d]
jorgeg xd: raises 480 to 880
24b4tm4n24: folds
Arce B: folds
BluffedLife: calls 880
ALLILS: folds
EZCoinFlip: folds
hichnick777: folds
GrandmasterY: folds
topzozi: calls 480
*** FLOP *** [Qh Th 8s]
topzozi: checks
jorgeg xd: bets 1440
BluffedLife: calls 1440
topzozi: calls 1440
*** TURN *** [Qh Th 8s] [4s]
topzozi: checks
jorgeg xd: bets 6270 and is all-in
BluffedLife: folds
topzozi: folds
Uncalled bet (6270) returned to jorgeg xd
jorgeg xd collected 7520 from pot
jorgeg xd: doesn't show hand
*** SUMMARY ***
Total pot 7520 | Rake 0
Board [Qh Th 8s 4s]
Seat 1: jorgeg xd collected (7520)
Seat 2: 24b4tm4n24 folded before Flop (didn't bet)
Seat 3: Arce B folded before Flop (didn't bet)
Seat 4: BluffedLife folded on the Turn
Seat 5: ALLILS folded before Flop (didn't bet)
Seat 6: EZCoinFlip folded before Flop (didn't bet)
Seat 7: hichnick777 (button) folded before Flop (didn't bet)
Seat 8: GrandmasterY (small blind) folded before Flop
Seat 9: topzozi (big blind) folded on the Turn


*********** # 7 **************
PokerStars Hand #176669159695: Tournament #2054568934, $20+$2 USD Hold'em No Limit - Level X (200/400) - 2017/10/09 0:08:41 MSK [2017/10/08 17:08:41 ET]
Table '2054568934 506' 9-max Seat #8 is the button
Seat 1: jorgeg xd (13790 in chips)
Seat 2: 24b4tm4n24 (18742 in chips)
Seat 3: Arce B (19945 in chips)
Seat 4: BluffedLife (30297 in chips)
Seat 5: ALLILS (10240 in chips)
Seat 6: EZCoinFlip (22692 in chips)
Seat 7: hichnick777 (12630 in chips)
Seat 8: GrandmasterY (6895 in chips)
Seat 9: topzozi (5665 in chips)
jorgeg xd: posts the ante 40
24b4tm4n24: posts the ante 40
Arce B: posts the ante 40
BluffedLife: posts the ante 40
ALLILS: posts the ante 40
EZCoinFlip: posts the ante 40
hichnick777: posts the ante 40
GrandmasterY: posts the ante 40
topzozi: posts the ante 40
topzozi: posts small blind 200
jorgeg xd: posts big blind 400
*** HOLE CARDS ***
Dealt to hichnick777 [8h Ad]
24b4tm4n24: folds
Arce B: folds
BluffedLife: folds
ALLILS: folds
EZCoinFlip: raises 400 to 800
hichnick777: folds
GrandmasterY: folds
topzozi: folds
jorgeg xd: folds
Uncalled bet (400) returned to EZCoinFlip
EZCoinFlip collected 1360 from pot
EZCoinFlip: doesn't show hand
*** SUMMARY ***
Total pot 1360 | Rake 0
Seat 1: jorgeg xd (big blind) folded before Flop
Seat 2: 24b4tm4n24 folded before Flop (didn't bet)
Seat 3: Arce B folded before Flop (didn't bet)
Seat 4: BluffedLife folded before Flop (didn't bet)
Seat 5: ALLILS folded before Flop (didn't bet)
Seat 6: EZCoinFlip collected (1360)
Seat 7: hichnick777 folded before Flop (didn't bet)
Seat 8: GrandmasterY (button) folded before Flop (didn't bet)
Seat 9: topzozi (small blind) folded before Flop


*********** # 8 **************
PokerStars Hand #176669193900: Tournament #2054568934, $20+$2 USD Hold'em No Limit - Level X (200/400) - 2017/10/09 0:09:20 MSK [2017/10/08 17:09:20 ET]
Table '2054568934 506' 9-max Seat #9 is the button
Seat 1: jorgeg xd (13350 in chips)
Seat 2: 24b4tm4n24 (18702 in chips)
Seat 3: Arce B (19905 in chips)
Seat 4: BluffedLife (30257 in chips)
Seat 5: ALLILS (10200 in chips)
Seat 6: EZCoinFlip (23612 in chips)
Seat 7: hichnick777 (12590 in chips)
Seat 8: GrandmasterY (6855 in chips)
Seat 9: topzozi (5425 in chips)
jorgeg xd: posts the ante 40
24b4tm4n24: posts the ante 40
Arce B: posts the ante 40
BluffedLife: posts the ante 40
ALLILS: posts the ante 40
EZCoinFlip: posts the ante 40
hichnick777: posts the ante 40
GrandmasterY: posts the ante 40
topzozi: posts the ante 40
jorgeg xd: posts small blind 200
24b4tm4n24: posts big blind 400
*** HOLE CARDS ***
Dealt to hichnick777 [Qc 8d]
Arce B: folds
BluffedLife: folds
ALLILS: folds
EZCoinFlip: raises 400 to 800
hichnick777: folds
GrandmasterY: folds
topzozi: calls 800
jorgeg xd: folds
24b4tm4n24: folds
*** FLOP *** [5c Tc 7c]
EZCoinFlip: checks
topzozi: bets 1200
EZCoinFlip: raises 7200 to 8400
topzozi: folds
Uncalled bet (7200) returned to EZCoinFlip
EZCoinFlip collected 4960 from pot
EZCoinFlip: doesn't show hand
*** SUMMARY ***
Total pot 4960 | Rake 0
Board [5c Tc 7c]
Seat 1: jorgeg xd (small blind) folded before Flop
Seat 2: 24b4tm4n24 (big blind) folded before Flop
Seat 3: Arce B folded before Flop (didn't bet)
Seat 4: BluffedLife folded before Flop (didn't bet)
Seat 5: ALLILS folded before Flop (didn't bet)
Seat 6: EZCoinFlip collected (4960)
Seat 7: hichnick777 folded before Flop (didn't bet)
Seat 8: GrandmasterY folded before Flop (didn't bet)
Seat 9: topzozi (button) folded on the Flop


*********** # 9 **************
PokerStars Hand #176669255933: Tournament #2054568934, $20+$2 USD Hold'em No Limit - Level X (200/400) - 2017/10/09 0:10:32 MSK [2017/10/08 17:10:32 ET]
Table '2054568934 506' 9-max Seat #1 is the button
Seat 1: jorgeg xd (13110 in chips)
Seat 2: 24b4tm4n24 (18262 in chips)
Seat 3: Arce B (19865 in chips)
Seat 4: BluffedLife (30217 in chips)
Seat 5: ALLILS (10160 in chips)
Seat 6: EZCoinFlip (26532 in chips)
Seat 7: hichnick777 (12550 in chips)
Seat 8: GrandmasterY (6815 in chips)
Seat 9: topzozi (3385 in chips)
jorgeg xd: posts the ante 40
24b4tm4n24: posts the ante 40
Arce B: posts the ante 40
BluffedLife: posts the ante 40
ALLILS: posts the ante 40
EZCoinFlip: posts the ante 40
hichnick777: posts the ante 40
GrandmasterY: posts the ante 40
topzozi: posts the ante 40
24b4tm4n24: posts small blind 200
Arce B: posts big blind 400
*** HOLE CARDS ***
Dealt to hichnick777 [Kh 5h]
BluffedLife: folds
ALLILS: raises 420 to 820
EZCoinFlip: folds
hichnick777: folds
GrandmasterY: folds
topzozi: folds
jorgeg xd: raises 12250 to 13070 and is all-in
24b4tm4n24: folds
Arce B: folds
ALLILS: calls 9300 and is all-in
Uncalled bet (2950) returned to jorgeg xd
*** FLOP *** [9d Qc Jh]
*** TURN *** [9d Qc Jh] [Ac]
*** RIVER *** [9d Qc Jh Ac] [6s]
*** SHOW DOWN ***
ALLILS: shows [Jc Jd] (three of a kind, Jacks)
jorgeg xd: shows [Ad Ks] (a pair of Aces)
ALLILS collected 21200 from pot
*** SUMMARY ***
Total pot 21200 | Rake 0
Board [9d Qc Jh Ac 6s]
Seat 1: jorgeg xd (button) showed [Ad Ks] and lost with a pair of Aces
Seat 2: 24b4tm4n24 (small blind) folded before Flop
Seat 3: Arce B (big blind) folded before Flop
Seat 4: BluffedLife folded before Flop (didn't bet)
Seat 5: ALLILS showed [Jc Jd] and won (21200) with three of a kind, Jacks
Seat 6: EZCoinFlip folded before Flop (didn't bet)
Seat 7: hichnick777 folded before Flop (didn't bet)
Seat 8: GrandmasterY folded before Flop (didn't bet)
Seat 9: topzozi folded before Flop (didn't bet)


*********** # 10 **************
PokerStars Hand #176669284628: Tournament #2054568934, $20+$2 USD Hold'em No Limit - Level X (200/400) - 2017/10/09 0:11:05 MSK [2017/10/08 17:11:05 ET]
Table '2054568934 506' 9-max Seat #2 is the button
Seat 1: jorgeg xd (2950 in chips)
Seat 2: 24b4tm4n24 (18022 in chips)
Seat 3: Arce B (19425 in chips)
Seat 4: BluffedLife (30177 in chips)
Seat 5: ALLILS (21200 in chips)
Seat 6: EZCoinFlip (26492 in chips)
Seat 7: hichnick777 (12510 in chips)
Seat 8: GrandmasterY (6775 in chips)
Seat 9: topzozi (3345 in chips)
jorgeg xd: posts the ante 40
24b4tm4n24: posts the ante 40
Arce B: posts the ante 40
BluffedLife: posts the ante 40
ALLILS: posts the ante 40
EZCoinFlip: posts the ante 40
hichnick777: posts the ante 40
GrandmasterY: posts the ante 40
topzozi: posts the ante 40
Arce B: posts small blind 200
BluffedLife: posts big blind 400
*** HOLE CARDS ***
Dealt to hichnick777 [Td Kc]
ALLILS: raises 420 to 820
EZCoinFlip: calls 820
hichnick777: folds
GrandmasterY: folds
topzozi: folds
jorgeg xd: folds
24b4tm4n24: folds
Arce B: folds
BluffedLife: raises 3580 to 4400
ALLILS: folds
EZCoinFlip: folds
Uncalled bet (3580) returned to BluffedLife
BluffedLife collected 3020 from pot
BluffedLife: doesn't show hand
*** SUMMARY ***
Total pot 3020 | Rake 0
Seat 1: jorgeg xd folded before Flop (didn't bet)
Seat 2: 24b4tm4n24 (button) folded before Flop (didn't bet)
Seat 3: Arce B (small blind) folded before Flop
Seat 4: BluffedLife (big blind) collected (3020)
Seat 5: ALLILS folded before Flop
Seat 6: EZCoinFlip folded before Flop
Seat 7: hichnick777 folded before Flop (didn't bet)
Seat 8: GrandmasterY folded before Flop (didn't bet)
Seat 9: topzozi folded before Flop (didn't bet)


*********** # 11 **************
PokerStars Hand #176669344552: Tournament #2054568934, $20+$2 USD Hold'em No Limit - Level X (200/400) - 2017/10/09 0:12:14 MSK [2017/10/08 17:12:14 ET]
Table '2054568934 506' 9-max Seat #3 is the button
Seat 1: jorgeg xd (2910 in chips)
Seat 2: 24b4tm4n24 (17982 in chips)
Seat 3: Arce B (19185 in chips)
Seat 4: BluffedLife (32337 in chips)
Seat 5: ALLILS (20340 in chips)
Seat 6: EZCoinFlip (25632 in chips)
Seat 7: hichnick777 (12470 in chips)
Seat 8: GrandmasterY (6735 in chips)
Seat 9: topzozi (3305 in chips)
jorgeg xd: posts the ante 40
24b4tm4n24: posts the ante 40
Arce B: posts the ante 40
BluffedLife: posts the ante 40
ALLILS: posts the ante 40
EZCoinFlip: posts the ante 40
hichnick777: posts the ante 40
GrandmasterY: posts the ante 40
topzozi: posts the ante 40
BluffedLife: posts small blind 200
ALLILS: posts big blind 400
*** HOLE CARDS ***
Dealt to hichnick777 [Tc 7d]
EZCoinFlip: folds
hichnick777: folds
GrandmasterY: folds
topzozi: folds
jorgeg xd is disconnected
jorgeg xd is connected
jorgeg xd: folds
24b4tm4n24: folds
Arce B: folds
BluffedLife: folds
Uncalled bet (200) returned to ALLILS
ALLILS collected 760 from pot
*** SUMMARY ***
Total pot 760 | Rake 0
Seat 1: jorgeg xd folded before Flop (didn't bet)
Seat 2: 24b4tm4n24 folded before Flop (didn't bet)
Seat 3: Arce B (button) folded before Flop (didn't bet)
Seat 4: BluffedLife (small blind) folded before Flop
Seat 5: ALLILS (big blind) collected (760)
Seat 6: EZCoinFlip folded before Flop (didn't bet)
Seat 7: hichnick777 folded before Flop (didn't bet)
Seat 8: GrandmasterY folded before Flop (didn't bet)
Seat 9: topzozi folded before Flop (didn't bet)


*********** # 12 **************
PokerStars Hand #176669372084: Tournament #2054568934, $20+$2 USD Hold'em No Limit - Level X (200/400) - 2017/10/09 0:12:46 MSK [2017/10/08 17:12:46 ET]
Table '2054568934 506' 9-max Seat #4 is the button
Seat 1: jorgeg xd (2870 in chips)
Seat 2: 24b4tm4n24 (17942 in chips)
Seat 3: Arce B (19145 in chips)
Seat 4: BluffedLife (32097 in chips)
Seat 5: ALLILS (20860 in chips)
Seat 6: EZCoinFlip (25592 in chips)
Seat 7: hichnick777 (12430 in chips)
Seat 8: GrandmasterY (6695 in chips)
Seat 9: topzozi (3265 in chips)
jorgeg xd: posts the ante 40
24b4tm4n24: posts the ante 40
Arce B: posts the ante 40
BluffedLife: posts the ante 40
ALLILS: posts the ante 40
EZCoinFlip: posts the ante 40
hichnick777: posts the ante 40
GrandmasterY: posts the ante 40
topzozi: posts the ante 40
ALLILS: posts small blind 200
EZCoinFlip: posts big blind 400
*** HOLE CARDS ***
Dealt to hichnick777 [Kh 3h]
hichnick777: folds
GrandmasterY: folds
topzozi: folds
jorgeg xd: raises 2430 to 2830 and is all-in
24b4tm4n24: folds
Arce B: folds
BluffedLife: raises 2430 to 5260
ALLILS: folds
EZCoinFlip: folds
Uncalled bet (2430) returned to BluffedLife
*** FLOP *** [4h 8c 2h]
*** TURN *** [4h 8c 2h] [2d]
*** RIVER *** [4h 8c 2h 2d] [5h]
*** SHOW DOWN ***
jorgeg xd: shows [8d Ac] (two pair, Eights and Deuces)
BluffedLife: shows [Qd As] (a pair of Deuces)
jorgeg xd collected 6620 from pot
*** SUMMARY ***
Total pot 6620 | Rake 0
Board [4h 8c 2h 2d 5h]
Seat 1: jorgeg xd showed [8d Ac] and won (6620) with two pair, Eights and Deuces
Seat 2: 24b4tm4n24 folded before Flop (didn't bet)
Seat 3: Arce B folded before Flop (didn't bet)
Seat 4: BluffedLife (button) showed [Qd As] and lost with a pair of Deuces
Seat 5: ALLILS (small blind) folded before Flop
Seat 6: EZCoinFlip (big blind) folded before Flop
Seat 7: hichnick777 folded before Flop (didn't bet)
Seat 8: GrandmasterY folded before Flop (didn't bet)
Seat 9: topzozi folded before Flop (didn't bet)


*********** # 13 **************
PokerStars Hand #176669424001: Tournament #2054568934, $20+$2 USD Hold'em No Limit - Level X (200/400) - 2017/10/09 0:13:47 MSK [2017/10/08 17:13:47 ET]
Table '2054568934 506' 9-max Seat #5 is the button
Seat 1: jorgeg xd (6620 in chips)
Seat 2: 24b4tm4n24 (17902 in chips)
Seat 3: Arce B (19105 in chips)
Seat 4: BluffedLife (29227 in chips)
Seat 5: ALLILS (20620 in chips)
Seat 6: EZCoinFlip (25152 in chips)
Seat 7: hichnick777 (12390 in chips)
Seat 8: GrandmasterY (6655 in chips)
Seat 9: topzozi (3225 in chips)
jorgeg xd: posts the ante 40
24b4tm4n24: posts the ante 40
Arce B: posts the ante 40
BluffedLife: posts the ante 40
ALLILS: posts the ante 40
EZCoinFlip: posts the ante 40
hichnick777: posts the ante 40
GrandmasterY: posts the ante 40
topzozi: posts the ante 40
EZCoinFlip: posts small blind 200
hichnick777: posts big blind 400
*** HOLE CARDS ***
Dealt to hichnick777 [Ts 9d]
GrandmasterY: folds
topzozi: folds
jorgeg xd: folds
24b4tm4n24: raises 428 to 828
Arce B: folds
BluffedLife: folds
ALLILS: folds
EZCoinFlip: folds
hichnick777: calls 428
*** FLOP *** [5h Qh 6c]
hichnick777: checks
24b4tm4n24: bets 1086
hichnick777: folds
Uncalled bet (1086) returned to 24b4tm4n24
24b4tm4n24 collected 2216 from pot
*** SUMMARY ***
Total pot 2216 | Rake 0
Board [5h Qh 6c]
Seat 1: jorgeg xd folded before Flop (didn't bet)
Seat 2: 24b4tm4n24 collected (2216)
Seat 3: Arce B folded before Flop (didn't bet)
Seat 4: BluffedLife folded before Flop (didn't bet)
Seat 5: ALLILS (button) folded before Flop (didn't bet)
Seat 6: EZCoinFlip (small blind) folded before Flop
Seat 7: hichnick777 (big blind) folded on the Flop
Seat 8: GrandmasterY folded before Flop (didn't bet)
Seat 9: topzozi folded before Flop (didn't bet)


*********** # 14 **************
PokerStars Hand #176669464984: Tournament #2054568934, $20+$2 USD Hold'em No Limit - Level X (200/400) - 2017/10/09 0:14:35 MSK [2017/10/08 17:14:35 ET]
Table '2054568934 506' 9-max Seat #6 is the button
Seat 1: jorgeg xd (6580 in chips)
Seat 2: 24b4tm4n24 (19250 in chips)
Seat 3: Arce B (19065 in chips)
Seat 4: BluffedLife (29187 in chips)
Seat 5: ALLILS (20580 in chips)
Seat 6: EZCoinFlip (24912 in chips)
Seat 7: hichnick777 (11522 in chips)
Seat 8: GrandmasterY (6615 in chips)
Seat 9: topzozi (3185 in chips)
jorgeg xd: posts the ante 40
24b4tm4n24: posts the ante 40
Arce B: posts the ante 40
BluffedLife: posts the ante 40
ALLILS: posts the ante 40
EZCoinFlip: posts the ante 40
hichnick777: posts the ante 40
GrandmasterY: posts the ante 40
topzozi: posts the ante 40
hichnick777: posts small blind 200
GrandmasterY: posts big blind 400
*** HOLE CARDS ***
Dealt to hichnick777 [3c 9h]
topzozi: folds
jorgeg xd: folds
24b4tm4n24: folds
Arce B: raises 450 to 850
BluffedLife: folds
ALLILS: folds
EZCoinFlip: folds
hichnick777: folds
GrandmasterY: calls 450
*** FLOP *** [Qh 8d 4h]
GrandmasterY: checks
Arce B: bets 994
GrandmasterY: calls 994
*** TURN *** [Qh 8d 4h] [4s]
GrandmasterY: checks
Arce B: bets 17181 and is all-in
GrandmasterY: calls 4731 and is all-in
Uncalled bet (12450) returned to Arce B
*** RIVER *** [Qh 8d 4h 4s] [6c]
*** SHOW DOWN ***
GrandmasterY: shows [8h 5h] (two pair, Eights and Fours)
Arce B: shows [Qs Kc] (two pair, Queens and Fours)
Arce B collected 13710 from pot
GrandmasterY finished the tournament in 5413th place
*** SUMMARY ***
Total pot 13710 | Rake 0
Board [Qh 8d 4h 4s 6c]
Seat 1: jorgeg xd folded before Flop (didn't bet)
Seat 2: 24b4tm4n24 folded before Flop (didn't bet)
Seat 3: Arce B showed [Qs Kc] and won (13710) with two pair, Queens and Fours
Seat 4: BluffedLife folded before Flop (didn't bet)
Seat 5: ALLILS folded before Flop (didn't bet)
Seat 6: EZCoinFlip (button) folded before Flop (didn't bet)
Seat 7: hichnick777 (small blind) folded before Flop
Seat 8: GrandmasterY (big blind) showed [8h 5h] and lost with two pair, Eights and Fours
Seat 9: topzozi folded before Flop (didn't bet)


*********** # 15 **************
PokerStars Hand #176669550208: Tournament #2054568934, $20+$2 USD Hold'em No Limit - Level X (200/400) - 2017/10/09 0:16:14 MSK [2017/10/08 17:16:14 ET]
Table '2054568934 506' 9-max Seat #7 is the button
Seat 1: jorgeg xd (6540 in chips)
Seat 2: 24b4tm4n24 (19210 in chips)
Seat 3: Arce B (26160 in chips)
Seat 4: BluffedLife (29147 in chips)
Seat 5: ALLILS (20540 in chips)
Seat 6: EZCoinFlip (24872 in chips)
Seat 7: hichnick777 (11282 in chips)
Seat 8: Jarja25 (10000 in chips) out of hand (moved from another table into small blind)
Seat 9: topzozi (3145 in chips)
jorgeg xd: posts the ante 40
24b4tm4n24: posts the ante 40
Arce B: posts the ante 40
BluffedLife: posts the ante 40
ALLILS: posts the ante 40
EZCoinFlip: posts the ante 40
hichnick777: posts the ante 40
topzozi: posts the ante 40
topzozi: posts small blind 200
jorgeg xd: posts big blind 400
*** HOLE CARDS ***
Dealt to hichnick777 [Ah Qs]
24b4tm4n24: folds
Arce B: folds
BluffedLife: folds
ALLILS: folds
EZCoinFlip: folds
hichnick777: raises 432 to 832
topzozi: folds
jorgeg xd: folds
Uncalled bet (432) returned to hichnick777
hichnick777 collected 1320 from pot
hichnick777: doesn't show hand
*** SUMMARY ***
Total pot 1320 | Rake 0
Seat 1: jorgeg xd (big blind) folded before Flop
Seat 2: 24b4tm4n24 folded before Flop (didn't bet)
Seat 3: Arce B folded before Flop (didn't bet)
Seat 4: BluffedLife folded before Flop (didn't bet)
Seat 5: ALLILS folded before Flop (didn't bet)
Seat 6: EZCoinFlip folded before Flop (didn't bet)
Seat 7: hichnick777 (button) collected (1320)
Seat 9: topzozi (small blind) folded before Flop


*********** # 16 **************
PokerStars Hand #176669587218: Tournament #2054568934, $20+$2 USD Hold'em No Limit - Level XI (250/500) - 2017/10/09 0:16:58 MSK [2017/10/08 17:16:58 ET]
Table '2054568934 506' 9-max Seat #9 is the button
Seat 1: jorgeg xd (6100 in chips)
Seat 2: 24b4tm4n24 (19170 in chips)
Seat 3: Arce B (26120 in chips)
Seat 4: BluffedLife (29107 in chips)
Seat 5: ALLILS (20500 in chips)
Seat 6: EZCoinFlip (24832 in chips)
Seat 7: hichnick777 (12162 in chips)
Seat 8: Jarja25 (10000 in chips)
Seat 9: topzozi (2905 in chips)
jorgeg xd: posts the ante 50
24b4tm4n24: posts the ante 50
Arce B: posts the ante 50
BluffedLife: posts the ante 50
ALLILS: posts the ante 50
EZCoinFlip: posts the ante 50
hichnick777: posts the ante 50
Jarja25: posts the ante 50
topzozi: posts the ante 50
jorgeg xd: posts small blind 250
24b4tm4n24: posts big blind 500
*** HOLE CARDS ***
Dealt to hichnick777 [5h 2h]
Arce B: folds
BluffedLife: folds
ALLILS: raises 525 to 1025
EZCoinFlip: folds
hichnick777: folds
Jarja25: folds
topzozi: folds
jorgeg xd: calls 775
24b4tm4n24: folds
*** FLOP *** [4c Kh Qh]
jorgeg xd: checks
ALLILS: bets 990
jorgeg xd: raises 4035 to 5025 and is all-in
ALLILS: calls 4035
*** TURN *** [4c Kh Qh] [Qs]
*** RIVER *** [4c Kh Qh Qs] [3s]
*** SHOW DOWN ***
jorgeg xd: shows [Jc Kc] (two pair, Kings and Queens)
ALLILS: shows [4h 4s] (a full house, Fours full of Queens)
ALLILS collected 13050 from pot
jorgeg xd finished the tournament in 5315th place
*** SUMMARY ***
Total pot 13050 | Rake 0
Board [4c Kh Qh Qs 3s]
Seat 1: jorgeg xd (small blind) showed [Jc Kc] and lost with two pair, Kings and Queens
Seat 2: 24b4tm4n24 (big blind) folded before Flop
Seat 3: Arce B folded before Flop (didn't bet)
Seat 4: BluffedLife folded before Flop (didn't bet)
Seat 5: ALLILS showed [4h 4s] and won (13050) with a full house, Fours full of Queens
Seat 6: EZCoinFlip folded before Flop (didn't bet)
Seat 7: hichnick777 folded before Flop (didn't bet)
Seat 8: Jarja25 folded before Flop (didn't bet)
Seat 9: topzozi (button) folded before Flop (didn't bet)


*********** # 17 **************
PokerStars Hand #176669632564: Tournament #2054568934, $20+$2 USD Hold'em No Limit - Level XI (250/500) - 2017/10/09 0:17:52 MSK [2017/10/08 17:17:52 ET]
Table '2054568934 506' 9-max Seat #2 is the button
Seat 1: Gaetanopre (10000 in chips)
Seat 2: 24b4tm4n24 (18620 in chips)
Seat 3: Arce B (26070 in chips)
Seat 4: BluffedLife (29057 in chips)
Seat 5: ALLILS (27450 in chips)
Seat 6: EZCoinFlip (24782 in chips)
Seat 7: hichnick777 (12112 in chips)
Seat 8: Jarja25 (9950 in chips)
Seat 9: topzozi (2855 in chips)
Gaetanopre: posts the ante 50
24b4tm4n24: posts the ante 50
Arce B: posts the ante 50
BluffedLife: posts the ante 50
ALLILS: posts the ante 50
EZCoinFlip: posts the ante 50
hichnick777: posts the ante 50
Jarja25: posts the ante 50
topzozi: posts the ante 50
Arce B: posts small blind 250
BluffedLife: posts big blind 500
*** HOLE CARDS ***
Dealt to hichnick777 [Jd Kd]
ALLILS: folds
EZCoinFlip: folds
hichnick777: raises 625 to 1125
Jarja25: folds
topzozi: folds
Gaetanopre: calls 1125
24b4tm4n24: folds
Arce B: folds
BluffedLife: folds
*** FLOP *** [2h 6h 8h]
hichnick777: checks
Gaetanopre: bets 2500
hichnick777: folds
Uncalled bet (2500) returned to Gaetanopre
Gaetanopre collected 3450 from pot
Gaetanopre: doesn't show hand
*** SUMMARY ***
Total pot 3450 | Rake 0
Board [2h 6h 8h]
Seat 1: Gaetanopre collected (3450)
Seat 2: 24b4tm4n24 (button) folded before Flop (didn't bet)
Seat 3: Arce B (small blind) folded before Flop
Seat 4: BluffedLife (big blind) folded before Flop
Seat 5: ALLILS folded before Flop (didn't bet)
Seat 6: EZCoinFlip folded before Flop (didn't bet)
Seat 7: hichnick777 folded on the Flop
Seat 8: Jarja25 folded before Flop (didn't bet)
Seat 9: topzozi folded before Flop (didn't bet)


*********** # 18 **************
PokerStars Hand #176669681529: Tournament #2054568934, $20+$2 USD Hold'em No Limit - Level XI (250/500) - 2017/10/09 0:18:50 MSK [2017/10/08 17:18:50 ET]
Table '2054568934 506' 9-max Seat #3 is the button
Seat 1: Gaetanopre (12275 in chips)
Seat 2: 24b4tm4n24 (18570 in chips)
Seat 3: Arce B (25770 in chips)
Seat 4: BluffedLife (28507 in chips)
Seat 5: ALLILS (27400 in chips)
Seat 6: EZCoinFlip (24732 in chips)
Seat 7: hichnick777 (10937 in chips)
Seat 8: Jarja25 (9900 in chips)
Seat 9: topzozi (2805 in chips)
Gaetanopre: posts the ante 50
24b4tm4n24: posts the ante 50
Arce B: posts the ante 50
BluffedLife: posts the ante 50
ALLILS: posts the ante 50
EZCoinFlip: posts the ante 50
hichnick777: posts the ante 50
Jarja25: posts the ante 50
topzozi: posts the ante 50
BluffedLife: posts small blind 250
ALLILS: posts big blind 500
*** HOLE CARDS ***
Dealt to hichnick777 [3d 9s]
EZCoinFlip: folds
hichnick777: folds
Jarja25: folds
topzozi: folds
Gaetanopre: raises 1000 to 1500
24b4tm4n24: folds
Arce B: folds
BluffedLife: folds
ALLILS: folds
Uncalled bet (1000) returned to Gaetanopre
Gaetanopre collected 1700 from pot
Gaetanopre: doesn't show hand
*** SUMMARY ***
Total pot 1700 | Rake 0
Seat 1: Gaetanopre collected (1700)
Seat 2: 24b4tm4n24 folded before Flop (didn't bet)
Seat 3: Arce B (button) folded before Flop (didn't bet)
Seat 4: BluffedLife (small blind) folded before Flop
Seat 5: ALLILS (big blind) folded before Flop
Seat 6: EZCoinFlip folded before Flop (didn't bet)
Seat 7: hichnick777 folded before Flop (didn't bet)
Seat 8: Jarja25 folded before Flop (didn't bet)
Seat 9: topzozi folded before Flop (didn't bet)


*********** # 19 **************
PokerStars Hand #176669700625: Tournament #2054568934, $20+$2 USD Hold'em No Limit - Level XI (250/500) - 2017/10/09 0:19:12 MSK [2017/10/08 17:19:12 ET]
Table '2054568934 506' 9-max Seat #4 is the button
Seat 1: Gaetanopre (13425 in chips)
Seat 2: 24b4tm4n24 (18520 in chips)
Seat 3: Arce B (25720 in chips)
Seat 4: BluffedLife (28207 in chips)
Seat 5: ALLILS (26850 in chips)
Seat 6: EZCoinFlip (24682 in chips)
Seat 7: hichnick777 (10887 in chips)
Seat 8: Jarja25 (9850 in chips)
Seat 9: topzozi (2755 in chips)
Gaetanopre: posts the ante 50
24b4tm4n24: posts the ante 50
Arce B: posts the ante 50
BluffedLife: posts the ante 50
ALLILS: posts the ante 50
EZCoinFlip: posts the ante 50
hichnick777: posts the ante 50
Jarja25: posts the ante 50
topzozi: posts the ante 50
ALLILS: posts small blind 250
EZCoinFlip: posts big blind 500
*** HOLE CARDS ***
Dealt to hichnick777 [6s Kh]
hichnick777: folds
Jarja25: folds
topzozi: folds
Gaetanopre: raises 1000 to 1500
24b4tm4n24: folds
Arce B: folds
BluffedLife: folds
ALLILS: folds
EZCoinFlip: folds
Uncalled bet (1000) returned to Gaetanopre
Gaetanopre collected 1700 from pot
Gaetanopre: doesn't show hand
*** SUMMARY ***
Total pot 1700 | Rake 0
Seat 1: Gaetanopre collected (1700)
Seat 2: 24b4tm4n24 folded before Flop (didn't bet)
Seat 3: Arce B folded before Flop (didn't bet)
Seat 4: BluffedLife (button) folded before Flop (didn't bet)
Seat 5: ALLILS (small blind) folded before Flop
Seat 6: EZCoinFlip (big blind) folded before Flop
Seat 7: hichnick777 folded before Flop (didn't bet)
Seat 8: Jarja25 folded before Flop (didn't bet)
Seat 9: topzozi folded before Flop (didn't bet)


*********** # 20 **************
PokerStars Hand #176669719774: Tournament #2054568934, $20+$2 USD Hold'em No Limit - Level XI (250/500) - 2017/10/09 0:19:35 MSK [2017/10/08 17:19:35 ET]
Table '2054568934 506' 9-max Seat #5 is the button
Seat 1: Gaetanopre (14575 in chips)
Seat 2: 24b4tm4n24 (18470 in chips)
Seat 3: Arce B (25670 in chips)
Seat 4: BluffedLife (28157 in chips)
Seat 5: ALLILS (26550 in chips)
Seat 6: EZCoinFlip (24132 in chips)
Seat 7: hichnick777 (10837 in chips)
Seat 8: Jarja25 (9800 in chips)
Seat 9: topzozi (2705 in chips)
Gaetanopre: posts the ante 50
24b4tm4n24: posts the ante 50
Arce B: posts the ante 50
BluffedLife: posts the ante 50
ALLILS: posts the ante 50
EZCoinFlip: posts the ante 50
hichnick777: posts the ante 50
Jarja25: posts the ante 50
topzozi: posts the ante 50
EZCoinFlip: posts small blind 250
hichnick777: posts big blind 500
*** HOLE CARDS ***
Dealt to hichnick777 [3d 8c]
Jarja25: folds
topzozi: raises 2155 to 2655 and is all-in
Gaetanopre: calls 2655
24b4tm4n24: folds
Arce B: folds
BluffedLife: folds
ALLILS: folds
EZCoinFlip: folds
hichnick777: folds
*** FLOP *** [Qd 2s 4h]
*** TURN *** [Qd 2s 4h] [9h]
*** RIVER *** [Qd 2s 4h 9h] [7c]
*** SHOW DOWN ***
topzozi: shows [Th Ah] (high card Ace)
Gaetanopre: shows [7d Kd] (a pair of Sevens)
Gaetanopre collected 6510 from pot
topzozi finished the tournament in 5132nd place
*** SUMMARY ***
Total pot 6510 | Rake 0
Board [Qd 2s 4h 9h 7c]
Seat 1: Gaetanopre showed [7d Kd] and won (6510) with a pair of Sevens
Seat 2: 24b4tm4n24 folded before Flop (didn't bet)
Seat 3: Arce B folded before Flop (didn't bet)
Seat 4: BluffedLife folded before Flop (didn't bet)
Seat 5: ALLILS (button) folded before Flop (didn't bet)
Seat 6: EZCoinFlip (small blind) folded before Flop
Seat 7: hichnick777 (big blind) folded before Flop
Seat 8: Jarja25 folded before Flop (didn't bet)
Seat 9: topzozi showed [Th Ah] and lost with high card Ace


*********** # 21 **************
PokerStars Hand #176669758677: Tournament #2054568934, $20+$2 USD Hold'em No Limit - Level XI (250/500) - 2017/10/09 0:20:21 MSK [2017/10/08 17:20:21 ET]
Table '2054568934 506' 9-max Seat #6 is the button
Seat 1: Gaetanopre (18380 in chips)
Seat 2: 24b4tm4n24 (18420 in chips)
Seat 3: Arce B (25620 in chips)
Seat 4: BluffedLife (28107 in chips)
Seat 5: ALLILS (26500 in chips)
Seat 6: EZCoinFlip (23832 in chips)
Seat 7: hichnick777 (10287 in chips)
Seat 8: Jarja25 (9750 in chips)
Gaetanopre: posts the ante 50
24b4tm4n24: posts the ante 50
Arce B: posts the ante 50
BluffedLife: posts the ante 50
ALLILS: posts the ante 50
EZCoinFlip: posts the ante 50
hichnick777: posts the ante 50
Jarja25: posts the ante 50
hichnick777: posts small blind 250
Jarja25: posts big blind 500
*** HOLE CARDS ***
Dealt to hichnick777 [5h Qd]
Gaetanopre: folds
24b4tm4n24: folds
Arce B: folds
BluffedLife: folds
ALLILS: raises 525 to 1025
EZCoinFlip: folds
hichnick777: folds
Jarja25: calls 525
*** FLOP *** [Ah 3d 7s]
Jarja25: checks
ALLILS: checks
*** TURN *** [Ah 3d 7s] [2d]
Jarja25: bets 1000
ALLILS: calls 1000
*** RIVER *** [Ah 3d 7s 2d] [4d]
Jarja25: checks
ALLILS: bets 1491
Jarja25: raises 1491 to 2982
ALLILS: calls 1491
*** SHOW DOWN ***
Jarja25: shows [Kd 8d] (a flush, King high)
ALLILS: mucks hand
Jarja25 collected 10664 from pot
*** SUMMARY ***
Total pot 10664 | Rake 0
Board [Ah 3d 7s 2d 4d]
Seat 1: Gaetanopre folded before Flop (didn't bet)
Seat 2: 24b4tm4n24 folded before Flop (didn't bet)
Seat 3: Arce B folded before Flop (didn't bet)
Seat 4: BluffedLife folded before Flop (didn't bet)
Seat 5: ALLILS mucked [Tc As]
Seat 6: EZCoinFlip (button) folded before Flop (didn't bet)
Seat 7: hichnick777 (small blind) folded before Flop
Seat 8: Jarja25 (big blind) showed [Kd 8d] and won (10664) with a flush, King high


*********** # 22 **************
PokerStars Hand #176669827079: Tournament #2054568934, $20+$2 USD Hold'em No Limit - Level XI (250/500) - 2017/10/09 0:21:41 MSK [2017/10/08 17:21:41 ET]
Table '2054568934 506' 9-max Seat #7 is the button
Seat 1: Gaetanopre (18330 in chips)
Seat 2: 24b4tm4n24 (18370 in chips)
Seat 3: Arce B (25570 in chips)
Seat 4: BluffedLife (28057 in chips)
Seat 5: ALLILS (21443 in chips)
Seat 6: EZCoinFlip (23782 in chips)
Seat 7: hichnick777 (9987 in chips)
Seat 8: Jarja25 (15357 in chips)
Seat 9: Lassis1993 (10000 in chips)
Gaetanopre: posts the ante 50
24b4tm4n24: posts the ante 50
Arce B: posts the ante 50
BluffedLife: posts the ante 50
ALLILS: posts the ante 50
EZCoinFlip: posts the ante 50
hichnick777: posts the ante 50
Jarja25: posts the ante 50
Lassis1993: posts the ante 50
Jarja25: posts small blind 250
Lassis1993: posts big blind 500
*** HOLE CARDS ***
Dealt to hichnick777 [7h 2h]
Gaetanopre: folds
24b4tm4n24: folds
Arce B: folds
BluffedLife: folds
ALLILS: folds
EZCoinFlip: raises 500 to 1000
hichnick777: folds
Jarja25: folds
Lassis1993: folds
Uncalled bet (500) returned to EZCoinFlip
EZCoinFlip collected 1700 from pot
EZCoinFlip: doesn't show hand
*** SUMMARY ***
Total pot 1700 | Rake 0
Seat 1: Gaetanopre folded before Flop (didn't bet)
Seat 2: 24b4tm4n24 folded before Flop (didn't bet)
Seat 3: Arce B folded before Flop (didn't bet)
Seat 4: BluffedLife folded before Flop (didn't bet)
Seat 5: ALLILS folded before Flop (didn't bet)
Seat 6: EZCoinFlip collected (1700)
Seat 7: hichnick777 (button) folded before Flop (didn't bet)
Seat 8: Jarja25 (small blind) folded before Flop
Seat 9: Lassis1993 (big blind) folded before Flop


*********** # 23 **************
PokerStars Hand #176669856942: Tournament #2054568934, $20+$2 USD Hold'em No Limit - Level XI (250/500) - 2017/10/09 0:22:16 MSK [2017/10/08 17:22:16 ET]
Table '2054568934 506' 9-max Seat #8 is the button
Seat 1: Gaetanopre (18280 in chips)
Seat 2: 24b4tm4n24 (18320 in chips)
Seat 3: Arce B (25520 in chips)
Seat 4: BluffedLife (28007 in chips)
Seat 5: ALLILS (21393 in chips)
Seat 6: EZCoinFlip (24932 in chips)
Seat 7: hichnick777 (9937 in chips)
Seat 8: Jarja25 (15057 in chips)
Seat 9: Lassis1993 (9450 in chips)
Gaetanopre: posts the ante 50
24b4tm4n24: posts the ante 50
Arce B: posts the ante 50
BluffedLife: posts the ante 50
ALLILS: posts the ante 50
EZCoinFlip: posts the ante 50
hichnick777: posts the ante 50
Jarja25: posts the ante 50
Lassis1993: posts the ante 50
Lassis1993: posts small blind 250
Gaetanopre: posts big blind 500
*** HOLE CARDS ***
Dealt to hichnick777 [2c Ah]
24b4tm4n24: folds
Arce B: folds
BluffedLife: folds
ALLILS: folds
EZCoinFlip: raises 500 to 1000
hichnick777: folds
Jarja25: folds
Lassis1993: folds
Gaetanopre: calls 500
*** FLOP *** [Qd Kh Ad]
Gaetanopre: checks
EZCoinFlip: checks
*** TURN *** [Qd Kh Ad] [As]
Gaetanopre: checks
EZCoinFlip: bets 1000
Gaetanopre: folds
Uncalled bet (1000) returned to EZCoinFlip
EZCoinFlip collected 2700 from pot
EZCoinFlip: doesn't show hand
*** SUMMARY ***
Total pot 2700 | Rake 0
Board [Qd Kh Ad As]
Seat 1: Gaetanopre (big blind) folded on the Turn
Seat 2: 24b4tm4n24 folded before Flop (didn't bet)
Seat 3: Arce B folded before Flop (didn't bet)
Seat 4: BluffedLife folded before Flop (didn't bet)
Seat 5: ALLILS folded before Flop (didn't bet)
Seat 6: EZCoinFlip collected (2700)
Seat 7: hichnick777 folded before Flop (didn't bet)
Seat 8: Jarja25 (button) folded before Flop (didn't bet)
Seat 9: Lassis1993 (small blind) folded before Flop


*********** # 24 **************
PokerStars Hand #176669926503: Tournament #2054568934, $20+$2 USD Hold'em No Limit - Level XI (250/500) - 2017/10/09 0:23:39 MSK [2017/10/08 17:23:39 ET]
Table '2054568934 506' 9-max Seat #9 is the button
Seat 1: Gaetanopre (17230 in chips)
Seat 2: 24b4tm4n24 (18270 in chips)
Seat 3: Arce B (25470 in chips)
Seat 4: BluffedLife (27957 in chips)
Seat 5: ALLILS (21343 in chips)
Seat 6: EZCoinFlip (26582 in chips)
Seat 7: hichnick777 (9887 in chips)
Seat 8: Jarja25 (15007 in chips)
Seat 9: Lassis1993 (9150 in chips)
Gaetanopre: posts the ante 50
24b4tm4n24: posts the ante 50
Arce B: posts the ante 50
BluffedLife: posts the ante 50
ALLILS: posts the ante 50
EZCoinFlip: posts the ante 50
hichnick777: posts the ante 50
Jarja25: posts the ante 50
Lassis1993: posts the ante 50
Gaetanopre: posts small blind 250
24b4tm4n24: posts big blind 500
*** HOLE CARDS ***
Dealt to hichnick777 [Ah 7d]
Arce B: folds
BluffedLife: folds
ALLILS: folds
EZCoinFlip: folds
hichnick777: folds
Jarja25: folds
Lassis1993: folds
Gaetanopre: raises 500 to 1000
24b4tm4n24: folds
Uncalled bet (500) returned to Gaetanopre
Gaetanopre collected 1450 from pot
Gaetanopre: doesn't show hand
*** SUMMARY ***
Total pot 1450 | Rake 0
Seat 1: Gaetanopre (small blind) collected (1450)
Seat 2: 24b4tm4n24 (big blind) folded before Flop
Seat 3: Arce B folded before Flop (didn't bet)
Seat 4: BluffedLife folded before Flop (didn't bet)
Seat 5: ALLILS folded before Flop (didn't bet)
Seat 6: EZCoinFlip folded before Flop (didn't bet)
Seat 7: hichnick777 folded before Flop (didn't bet)
Seat 8: Jarja25 folded before Flop (didn't bet)
Seat 9: Lassis1993 (button) folded before Flop (didn't bet)


*********** # 25 **************
PokerStars Hand #176669958695: Tournament #2054568934, $20+$2 USD Hold'em No Limit - Level XI (250/500) - 2017/10/09 0:24:18 MSK [2017/10/08 17:24:18 ET]
Table '2054568934 506' 9-max Seat #1 is the button
Seat 1: Gaetanopre (18130 in chips)
Seat 2: 24b4tm4n24 (17720 in chips)
Seat 3: Arce B (25420 in chips)
Seat 4: BluffedLife (27907 in chips)
Seat 5: ALLILS (21293 in chips)
Seat 6: EZCoinFlip (26532 in chips)
Seat 7: hichnick777 (9837 in chips)
Seat 8: Jarja25 (14957 in chips)
Seat 9: Lassis1993 (9100 in chips)
Gaetanopre: posts the ante 50
24b4tm4n24: posts the ante 50
Arce B: posts the ante 50
BluffedLife: posts the ante 50
ALLILS: posts the ante 50
EZCoinFlip: posts the ante 50
hichnick777: posts the ante 50
Jarja25: posts the ante 50
Lassis1993: posts the ante 50
24b4tm4n24: posts small blind 250
Arce B: posts big blind 500
*** HOLE CARDS ***
Dealt to hichnick777 [2h 3h]
BluffedLife: folds
ALLILS: folds
EZCoinFlip: folds
hichnick777: folds
Jarja25: folds
Lassis1993: raises 750 to 1250
Gaetanopre: calls 1250
24b4tm4n24: folds
Arce B: calls 750
*** FLOP *** [Kd 7s 3c]
Arce B: checks
Lassis1993: checks
Gaetanopre: bets 1500
Arce B: folds
Lassis1993: folds
Uncalled bet (1500) returned to Gaetanopre
Gaetanopre collected 4450 from pot
Gaetanopre: doesn't show hand
*** SUMMARY ***
Total pot 4450 | Rake 0
Board [Kd 7s 3c]
Seat 1: Gaetanopre (button) collected (4450)
Seat 2: 24b4tm4n24 (small blind) folded before Flop
Seat 3: Arce B (big blind) folded on the Flop
Seat 4: BluffedLife folded before Flop (didn't bet)
Seat 5: ALLILS folded before Flop (didn't bet)
Seat 6: EZCoinFlip folded before Flop (didn't bet)
Seat 7: hichnick777 folded before Flop (didn't bet)
Seat 8: Jarja25 folded before Flop (didn't bet)
Seat 9: Lassis1993 folded on the Flop


*********** # 26 **************
PokerStars Hand #176670015044: Tournament #2054568934, $20+$2 USD Hold'em No Limit - Level XI (250/500) - 2017/10/09 0:25:26 MSK [2017/10/08 17:25:26 ET]
Table '2054568934 506' 9-max Seat #2 is the button
Seat 1: Gaetanopre (21280 in chips)
Seat 2: 24b4tm4n24 (17420 in chips)
Seat 3: Arce B (24120 in chips)
Seat 4: BluffedLife (27857 in chips)
Seat 5: ALLILS (21243 in chips)
Seat 6: EZCoinFlip (26482 in chips)
Seat 7: hichnick777 (9787 in chips)
Seat 8: Jarja25 (14907 in chips)
Seat 9: Lassis1993 (7800 in chips)
Gaetanopre: posts the ante 50
24b4tm4n24: posts the ante 50
Arce B: posts the ante 50
BluffedLife: posts the ante 50
ALLILS: posts the ante 50
EZCoinFlip: posts the ante 50
hichnick777: posts the ante 50
Jarja25: posts the ante 50
Lassis1993: posts the ante 50
Arce B: posts small blind 250
BluffedLife: posts big blind 500
*** HOLE CARDS ***
Dealt to hichnick777 [4h 3d]
ALLILS: folds
EZCoinFlip: folds
hichnick777: folds
Jarja25: folds
Lassis1993: folds
Gaetanopre: raises 500 to 1000
24b4tm4n24: folds
Arce B: raises 1910 to 2910
BluffedLife: folds
Gaetanopre: calls 1910
*** FLOP *** [7d 8d Kh]
Arce B: checks
Gaetanopre: checks
*** TURN *** [7d 8d Kh] [As]
Arce B: bets 2979
Gaetanopre: calls 2979
*** RIVER *** [7d 8d Kh As] [2h]
Arce B: checks
Gaetanopre: bets 10500
Arce B: calls 10500
*** SHOW DOWN ***
Gaetanopre: shows [2d Ah] (two pair, Aces and Deuces)
Arce B: mucks hand
Gaetanopre collected 33728 from pot
*** SUMMARY ***
Total pot 33728 | Rake 0
Board [7d 8d Kh As 2h]
Seat 1: Gaetanopre showed [2d Ah] and won (33728) with two pair, Aces and Deuces
Seat 2: 24b4tm4n24 (button) folded before Flop (didn't bet)
Seat 3: Arce B (small blind) mucked [Ad Jh]
Seat 4: BluffedLife (big blind) folded before Flop
Seat 5: ALLILS folded before Flop (didn't bet)
Seat 6: EZCoinFlip folded before Flop (didn't bet)
Seat 7: hichnick777 folded before Flop (didn't bet)
Seat 8: Jarja25 folded before Flop (didn't bet)
Seat 9: Lassis1993 folded before Flop (didn't bet)


*********** # 27 **************
PokerStars Hand #176670080481: Tournament #2054568934, $20+$2 USD Hold'em No Limit - Level XI (250/500) - 2017/10/09 0:26:45 MSK [2017/10/08 17:26:45 ET]
Table '2054568934 506' 9-max Seat #3 is the button
Seat 1: Gaetanopre (38569 in chips)
Seat 2: 24b4tm4n24 (17370 in chips)
Seat 3: Arce B (7681 in chips)
Seat 4: BluffedLife (27307 in chips)
Seat 5: ALLILS (21193 in chips)
Seat 6: EZCoinFlip (26432 in chips)
Seat 7: hichnick777 (9737 in chips)
Seat 8: Jarja25 (14857 in chips)
Seat 9: Lassis1993 (7750 in chips)
Gaetanopre: posts the ante 50
24b4tm4n24: posts the ante 50
Arce B: posts the ante 50
BluffedLife: posts the ante 50
ALLILS: posts the ante 50
EZCoinFlip: posts the ante 50
hichnick777: posts the ante 50
Jarja25: posts the ante 50
Lassis1993: posts the ante 50
BluffedLife: posts small blind 250
ALLILS: posts big blind 500
*** HOLE CARDS ***
Dealt to hichnick777 [Qd 9c]
EZCoinFlip: raises 500 to 1000
hichnick777: folds
Jarja25: folds
Lassis1993: folds
Gaetanopre: folds
24b4tm4n24: folds
Arce B: folds
BluffedLife: folds
ALLILS: folds
Uncalled bet (500) returned to EZCoinFlip
EZCoinFlip collected 1700 from pot
EZCoinFlip: doesn't show hand
*** SUMMARY ***
Total pot 1700 | Rake 0
Seat 1: Gaetanopre folded before Flop (didn't bet)
Seat 2: 24b4tm4n24 folded before Flop (didn't bet)
Seat 3: Arce B (button) folded before Flop (didn't bet)
Seat 4: BluffedLife (small blind) folded before Flop
Seat 5: ALLILS (big blind) folded before Flop
Seat 6: EZCoinFlip collected (1700)
Seat 7: hichnick777 folded before Flop (didn't bet)
Seat 8: Jarja25 folded before Flop (didn't bet)
Seat 9: Lassis1993 folded before Flop (didn't bet)


*********** # 28 **************
PokerStars Hand #176670108063: Tournament #2054568934, $20+$2 USD Hold'em No Limit - Level XI (250/500) - 2017/10/09 0:27:19 MSK [2017/10/08 17:27:19 ET]
Table '2054568934 506' 9-max Seat #4 is the button
Seat 1: Gaetanopre (38519 in chips)
Seat 2: 24b4tm4n24 (17320 in chips)
Seat 3: Arce B (7631 in chips)
Seat 4: BluffedLife (27007 in chips)
Seat 5: ALLILS (20643 in chips)
Seat 6: EZCoinFlip (27582 in chips)
Seat 7: hichnick777 (9687 in chips)
Seat 8: Jarja25 (14807 in chips)
Seat 9: Lassis1993 (7700 in chips)
Gaetanopre: posts the ante 50
24b4tm4n24: posts the ante 50
Arce B: posts the ante 50
BluffedLife: posts the ante 50
ALLILS: posts the ante 50
EZCoinFlip: posts the ante 50
hichnick777: posts the ante 50
Jarja25: posts the ante 50
Lassis1993: posts the ante 50
ALLILS: posts small blind 250
EZCoinFlip: posts big blind 500
*** HOLE CARDS ***
Dealt to hichnick777 [4d 7d]
hichnick777: folds
Jarja25: calls 500
Lassis1993: folds
Gaetanopre: folds
24b4tm4n24: folds
Arce B: folds
BluffedLife: folds
ALLILS: calls 250
EZCoinFlip: raises 1000 to 1500
Jarja25: calls 1000
ALLILS: calls 1000
*** FLOP *** [Jc Ts 5s]
ALLILS: checks
EZCoinFlip: bets 1436
Jarja25: folds
ALLILS: folds
Uncalled bet (1436) returned to EZCoinFlip
EZCoinFlip collected 4950 from pot
EZCoinFlip: doesn't show hand
*** SUMMARY ***
Total pot 4950 | Rake 0
Board [Jc Ts 5s]
Seat 1: Gaetanopre folded before Flop (didn't bet)
Seat 2: 24b4tm4n24 folded before Flop (didn't bet)
Seat 3: Arce B folded before Flop (didn't bet)
Seat 4: BluffedLife (button) folded before Flop (didn't bet)
Seat 5: ALLILS (small blind) folded on the Flop
Seat 6: EZCoinFlip (big blind) collected (4950)
Seat 7: hichnick777 folded before Flop (didn't bet)
Seat 8: Jarja25 folded on the Flop
Seat 9: Lassis1993 folded before Flop (didn't bet)


*********** # 29 **************
PokerStars Hand #176670170942: Tournament #2054568934, $20+$2 USD Hold'em No Limit - Level XII (300/600) - 2017/10/09 0:28:35 MSK [2017/10/08 17:28:35 ET]
Table '2054568934 506' 9-max Seat #5 is the button
Seat 1: Gaetanopre (38469 in chips)
Seat 2: 24b4tm4n24 (17270 in chips)
Seat 3: Arce B (7581 in chips)
Seat 4: BluffedLife (26957 in chips)
Seat 5: ALLILS (19093 in chips)
Seat 6: EZCoinFlip (30982 in chips)
Seat 7: hichnick777 (9637 in chips)
Seat 8: Jarja25 (13257 in chips)
Seat 9: Lassis1993 (7650 in chips)
Gaetanopre: posts the ante 60
24b4tm4n24: posts the ante 60
Arce B: posts the ante 60
BluffedLife: posts the ante 60
ALLILS: posts the ante 60
EZCoinFlip: posts the ante 60
hichnick777: posts the ante 60
Jarja25: posts the ante 60
Lassis1993: posts the ante 60
EZCoinFlip: posts small blind 300
hichnick777: posts big blind 600
*** HOLE CARDS ***
Dealt to hichnick777 [Kd 4c]
Jarja25: folds
Lassis1993: folds
Gaetanopre: folds
24b4tm4n24: raises 642 to 1242
Arce B: folds
BluffedLife: folds
ALLILS: folds
EZCoinFlip: folds
hichnick777: folds
Uncalled bet (642) returned to 24b4tm4n24
24b4tm4n24 collected 2040 from pot
*** SUMMARY ***
Total pot 2040 | Rake 0
Seat 1: Gaetanopre folded before Flop (didn't bet)
Seat 2: 24b4tm4n24 collected (2040)
Seat 3: Arce B folded before Flop (didn't bet)
Seat 4: BluffedLife folded before Flop (didn't bet)
Seat 5: ALLILS (button) folded before Flop (didn't bet)
Seat 6: EZCoinFlip (small blind) folded before Flop
Seat 7: hichnick777 (big blind) folded before Flop
Seat 8: Jarja25 folded before Flop (didn't bet)
Seat 9: Lassis1993 folded before Flop (didn't bet)


*********** # 30 **************
PokerStars Hand #176670225327: Tournament #2054568934, $20+$2 USD Hold'em No Limit - Level XII (300/600) - 2017/10/09 0:29:40 MSK [2017/10/08 17:29:40 ET]
Table '2054568934 506' 9-max Seat #6 is the button
Seat 1: Gaetanopre (38409 in chips)
Seat 2: 24b4tm4n24 (18650 in chips)
Seat 3: Arce B (7521 in chips)
Seat 4: BluffedLife (26897 in chips)
Seat 5: ALLILS (19033 in chips)
Seat 6: EZCoinFlip (30622 in chips)
Seat 7: hichnick777 (8977 in chips)
Seat 8: Jarja25 (13197 in chips)
Seat 9: Lassis1993 (7590 in chips)
Gaetanopre: posts the ante 60
24b4tm4n24: posts the ante 60
Arce B: posts the ante 60
BluffedLife: posts the ante 60
ALLILS: posts the ante 60
EZCoinFlip: posts the ante 60
hichnick777: posts the ante 60
Jarja25: posts the ante 60
Lassis1993: posts the ante 60
hichnick777: posts small blind 300
Jarja25: posts big blind 600
*** HOLE CARDS ***
Dealt to hichnick777 [5s Kh]
Lassis1993: folds
Gaetanopre: raises 600 to 1200
24b4tm4n24: folds
Arce B: folds
BluffedLife: raises 2400 to 3600
ALLILS: folds
EZCoinFlip: folds
hichnick777: folds
Jarja25: folds
Gaetanopre: calls 2400
*** FLOP *** [Qh 6h 7d]
Gaetanopre: checks
BluffedLife: bets 2592
Gaetanopre: calls 2592
*** TURN *** [Qh 6h 7d] [Kd]
Gaetanopre: checks
BluffedLife: bets 6000
Gaetanopre: calls 6000
*** RIVER *** [Qh 6h 7d Kd] [6c]
Gaetanopre: bets 15600
BluffedLife: calls 14645 and is all-in
Uncalled bet (955) returned to Gaetanopre
*** SHOW DOWN ***
Gaetanopre: shows [6d Ac] (three of a kind, Sixes)
BluffedLife: shows [Jd Ad] (a pair of Sixes)
Gaetanopre collected 55114 from pot
BluffedLife finished the tournament in 4401st place
*** SUMMARY ***
Total pot 55114 | Rake 0
Board [Qh 6h 7d Kd 6c]
Seat 1: Gaetanopre showed [6d Ac] and won (55114) with three of a kind, Sixes
Seat 2: 24b4tm4n24 folded before Flop (didn't bet)
Seat 3: Arce B folded before Flop (didn't bet)
Seat 4: BluffedLife showed [Jd Ad] and lost with a pair of Sixes
Seat 5: ALLILS folded before Flop (didn't bet)
Seat 6: EZCoinFlip (button) folded before Flop (didn't bet)
Seat 7: hichnick777 (small blind) folded before Flop
Seat 8: Jarja25 (big blind) folded before Flop
Seat 9: Lassis1993 folded before Flop (didn't bet)


*********** # 31 **************
PokerStars Hand #176670299737: Tournament #2054568934, $20+$2 USD Hold'em No Limit - Level XII (300/600) - 2017/10/09 0:31:11 MSK [2017/10/08 17:31:11 ET]
Table '2054568934 506' 9-max Seat #7 is the button
Seat 1: Gaetanopre (66626 in chips)
Seat 2: 24b4tm4n24 (18590 in chips)
Seat 3: Arce B (7461 in chips)
Seat 5: ALLILS (18973 in chips)
Seat 6: EZCoinFlip (30562 in chips)
Seat 7: hichnick777 (8617 in chips)
Seat 8: Jarja25 (12537 in chips)
Seat 9: Lassis1993 (7530 in chips)
Gaetanopre: posts the ante 60
24b4tm4n24: posts the ante 60
Arce B: posts the ante 60
ALLILS: posts the ante 60
EZCoinFlip: posts the ante 60
hichnick777: posts the ante 60
Jarja25: posts the ante 60
Lassis1993: posts the ante 60
Jarja25: posts small blind 300
Lassis1993: posts big blind 600
*** HOLE CARDS ***
Dealt to hichnick777 [2h Qc]
Gaetanopre: raises 1800 to 2400
24b4tm4n24: folds
Arce B: folds
ALLILS: folds
EZCoinFlip: folds
hichnick777: folds
Jarja25: calls 2100
Lassis1993: folds
*** FLOP *** [3s 4d 8h]
Jarja25: bets 10077 and is all-in
Gaetanopre: folds
Uncalled bet (10077) returned to Jarja25
Jarja25 collected 5880 from pot
*** SUMMARY ***
Total pot 5880 | Rake 0
Board [3s 4d 8h]
Seat 1: Gaetanopre folded on the Flop
Seat 2: 24b4tm4n24 folded before Flop (didn't bet)
Seat 3: Arce B folded before Flop (didn't bet)
Seat 5: ALLILS folded before Flop (didn't bet)
Seat 6: EZCoinFlip folded before Flop (didn't bet)
Seat 7: hichnick777 (button) folded before Flop (didn't bet)
Seat 8: Jarja25 (small blind) collected (5880)
Seat 9: Lassis1993 (big blind) folded before Flop


*********** # 32 **************
PokerStars Hand #176670328460: Tournament #2054568934, $20+$2 USD Hold'em No Limit - Level XII (300/600) - 2017/10/09 0:31:47 MSK [2017/10/08 17:31:47 ET]
Table '2054568934 506' 9-max Seat #8 is the button
Seat 1: Gaetanopre (64166 in chips)
Seat 2: 24b4tm4n24 (18530 in chips)
Seat 3: Arce B (7401 in chips)
Seat 4: RaphaCosta (18764 in chips)
Seat 5: ALLILS (18913 in chips)
Seat 6: EZCoinFlip (30502 in chips)
Seat 7: hichnick777 (8557 in chips)
Seat 8: Jarja25 (15957 in chips)
Seat 9: Lassis1993 (6870 in chips)
Gaetanopre: posts the ante 60
24b4tm4n24: posts the ante 60
Arce B: posts the ante 60
RaphaCosta: posts the ante 60
ALLILS: posts the ante 60
EZCoinFlip: posts the ante 60
hichnick777: posts the ante 60
Jarja25: posts the ante 60
Lassis1993: posts the ante 60
Lassis1993: posts small blind 300
Gaetanopre: posts big blind 600
*** HOLE CARDS ***
Dealt to hichnick777 [6h 8h]
24b4tm4n24: raises 642 to 1242
Arce B: folds
RaphaCosta: folds
ALLILS: folds
EZCoinFlip: folds
hichnick777: folds
Jarja25: folds
Lassis1993: folds
Gaetanopre: calls 642
*** FLOP *** [2d Ad 7s]
Gaetanopre: checks
24b4tm4n24: bets 1030
Gaetanopre: folds
Uncalled bet (1030) returned to 24b4tm4n24
24b4tm4n24 collected 3324 from pot
*** SUMMARY ***
Total pot 3324 | Rake 0
Board [2d Ad 7s]
Seat 1: Gaetanopre (big blind) folded on the Flop
Seat 2: 24b4tm4n24 collected (3324)
Seat 3: Arce B folded before Flop (didn't bet)
Seat 4: RaphaCosta folded before Flop (didn't bet)
Seat 5: ALLILS folded before Flop (didn't bet)
Seat 6: EZCoinFlip folded before Flop (didn't bet)
Seat 7: hichnick777 folded before Flop (didn't bet)
Seat 8: Jarja25 (button) folded before Flop (didn't bet)
Seat 9: Lassis1993 (small blind) folded before Flop


*********** # 33 **************
PokerStars Hand #176670349691: Tournament #2054568934, $20+$2 USD Hold'em No Limit - Level XII (300/600) - 2017/10/09 0:32:12 MSK [2017/10/08 17:32:12 ET]
Table '2054568934 506' 9-max Seat #9 is the button
Seat 1: Gaetanopre (62864 in chips)
Seat 2: 24b4tm4n24 (20552 in chips)
Seat 3: Arce B (7341 in chips)
Seat 4: RaphaCosta (18704 in chips)
Seat 5: ALLILS (18853 in chips)
Seat 6: EZCoinFlip (30442 in chips)
Seat 7: hichnick777 (8497 in chips)
Seat 8: Jarja25 (15897 in chips)
Seat 9: Lassis1993 (6510 in chips)
Gaetanopre: posts the ante 60
24b4tm4n24: posts the ante 60
Arce B: posts the ante 60
RaphaCosta: posts the ante 60
ALLILS: posts the ante 60
EZCoinFlip: posts the ante 60
hichnick777: posts the ante 60
Jarja25: posts the ante 60
Lassis1993: posts the ante 60
Gaetanopre: posts small blind 300
24b4tm4n24: posts big blind 600
*** HOLE CARDS ***
Dealt to hichnick777 [Td 6h]
Arce B: raises 6681 to 7281 and is all-in
RaphaCosta: folds
ALLILS: folds
EZCoinFlip: folds
hichnick777: folds
Jarja25: folds
Lassis1993: folds
Gaetanopre: calls 6981
24b4tm4n24: folds
*** FLOP *** [Qc Kc 5d]
*** TURN *** [Qc Kc 5d] [4h]
*** RIVER *** [Qc Kc 5d 4h] [8s]
*** SHOW DOWN ***
Gaetanopre: shows [6s 7s] (a straight, Four to Eight)
Arce B: shows [Jd Js] (a pair of Jacks)
Gaetanopre collected 15702 from pot
Arce B finished the tournament in 4285th place
*** SUMMARY ***
Total pot 15702 | Rake 0
Board [Qc Kc 5d 4h 8s]
Seat 1: Gaetanopre (small blind) showed [6s 7s] and won (15702) with a straight, Four to Eight
Seat 2: 24b4tm4n24 (big blind) folded before Flop
Seat 3: Arce B showed [Jd Js] and lost with a pair of Jacks
Seat 4: RaphaCosta folded before Flop (didn't bet)
Seat 5: ALLILS folded before Flop (didn't bet)
Seat 6: EZCoinFlip folded before Flop (didn't bet)
Seat 7: hichnick777 folded before Flop (didn't bet)
Seat 8: Jarja25 folded before Flop (didn't bet)
Seat 9: Lassis1993 (button) folded before Flop (didn't bet)


*********** # 34 **************
PokerStars Hand #176670382141: Tournament #2054568934, $20+$2 USD Hold'em No Limit - Level XII (300/600) - 2017/10/09 0:32:52 MSK [2017/10/08 17:32:52 ET]
Table '2054568934 506' 9-max Seat #1 is the button
Seat 1: Gaetanopre (71225 in chips)
Seat 2: 24b4tm4n24 (19892 in chips)
Seat 4: RaphaCosta (18644 in chips)
Seat 5: ALLILS (18793 in chips)
Seat 6: EZCoinFlip (30382 in chips)
Seat 7: hichnick777 (8437 in chips)
Seat 8: Jarja25 (15837 in chips)
Seat 9: Lassis1993 (6450 in chips)
Gaetanopre: posts the ante 60
24b4tm4n24: posts the ante 60
RaphaCosta: posts the ante 60
ALLILS: posts the ante 60
EZCoinFlip: posts the ante 60
hichnick777: posts the ante 60
Jarja25: posts the ante 60
Lassis1993: posts the ante 60
24b4tm4n24: posts small blind 300
RaphaCosta: posts big blind 600
*** HOLE CARDS ***
Dealt to hichnick777 [7s Jd]
ALLILS: folds
EZCoinFlip: folds
hichnick777: folds
Jarja25: raises 1800 to 2400
Lassis1993: folds
Gaetanopre: calls 2400
24b4tm4n24: folds
RaphaCosta: folds
*** FLOP *** [Qc 6d 4s]
Jarja25: bets 13377 and is all-in
Gaetanopre: folds
Uncalled bet (13377) returned to Jarja25
Jarja25 collected 6180 from pot
*** SUMMARY ***
Total pot 6180 | Rake 0
Board [Qc 6d 4s]
Seat 1: Gaetanopre (button) folded on the Flop
Seat 2: 24b4tm4n24 (small blind) folded before Flop
Seat 4: RaphaCosta (big blind) folded before Flop
Seat 5: ALLILS folded before Flop (didn't bet)
Seat 6: EZCoinFlip folded before Flop (didn't bet)
Seat 7: hichnick777 folded before Flop (didn't bet)
Seat 8: Jarja25 collected (6180)
Seat 9: Lassis1993 folded before Flop (didn't bet)


*********** # 35 **************
PokerStars Hand #176670417037: Tournament #2054568934, $20+$2 USD Hold'em No Limit - Level XII (300/600) - 2017/10/09 0:33:35 MSK [2017/10/08 17:33:35 ET]
Table '2054568934 506' 9-max Seat #2 is the button
Seat 1: Gaetanopre (68765 in chips)
Seat 2: 24b4tm4n24 (19532 in chips)
Seat 3: Santocx (27446 in chips) out of hand (moved from another table into small blind)
Seat 4: RaphaCosta (17984 in chips)
Seat 5: ALLILS (18733 in chips)
Seat 6: EZCoinFlip (30322 in chips)
Seat 7: hichnick777 (8377 in chips)
Seat 8: Jarja25 (19557 in chips)
Seat 9: Lassis1993 (6390 in chips)
Gaetanopre: posts the ante 60
24b4tm4n24: posts the ante 60
RaphaCosta: posts the ante 60
ALLILS: posts the ante 60
EZCoinFlip: posts the ante 60
hichnick777: posts the ante 60
Jarja25: posts the ante 60
Lassis1993: posts the ante 60
RaphaCosta: posts small blind 300
ALLILS: posts big blind 600
*** HOLE CARDS ***
Dealt to hichnick777 [8s 7h]
EZCoinFlip: folds
hichnick777: folds
Jarja25: folds
Lassis1993: raises 5730 to 6330 and is all-in
Gaetanopre: calls 6330
24b4tm4n24: folds
RaphaCosta: folds
ALLILS: folds
*** FLOP *** [Ac 4d 2c]
*** TURN *** [Ac 4d 2c] [Qs]
*** RIVER *** [Ac 4d 2c Qs] [Kd]
*** SHOW DOWN ***
Lassis1993: shows [Ad 3d] (a pair of Aces)
Gaetanopre: shows [Ts Ks] (a pair of Kings)
Lassis1993 collected 14040 from pot
*** SUMMARY ***
Total pot 14040 | Rake 0
Board [Ac 4d 2c Qs Kd]
Seat 1: Gaetanopre showed [Ts Ks] and lost with a pair of Kings
Seat 2: 24b4tm4n24 (button) folded before Flop (didn't bet)
Seat 4: RaphaCosta (small blind) folded before Flop
Seat 5: ALLILS (big blind) folded before Flop
Seat 6: EZCoinFlip folded before Flop (didn't bet)
Seat 7: hichnick777 folded before Flop (didn't bet)
Seat 8: Jarja25 folded before Flop (didn't bet)
Seat 9: Lassis1993 showed [Ad 3d] and won (14040) with a pair of Aces


*********** # 36 **************
PokerStars Hand #176670449088: Tournament #2054568934, $20+$2 USD Hold'em No Limit - Level XII (300/600) - 2017/10/09 0:34:15 MSK [2017/10/08 17:34:15 ET]
Table '2054568934 506' 9-max Seat #4 is the button
Seat 1: Gaetanopre (62375 in chips)
Seat 2: 24b4tm4n24 (19472 in chips)
Seat 3: Santocx (27446 in chips)
Seat 4: RaphaCosta (17624 in chips)
Seat 5: ALLILS (18073 in chips)
Seat 6: EZCoinFlip (30262 in chips)
Seat 7: hichnick777 (8317 in chips)
Seat 8: Jarja25 (19497 in chips)
Seat 9: Lassis1993 (14040 in chips)
Gaetanopre: posts the ante 60
24b4tm4n24: posts the ante 60
Santocx: posts the ante 60
RaphaCosta: posts the ante 60
ALLILS: posts the ante 60
EZCoinFlip: posts the ante 60
hichnick777: posts the ante 60
Jarja25: posts the ante 60
Lassis1993: posts the ante 60
ALLILS: posts small blind 300
EZCoinFlip: posts big blind 600
*** HOLE CARDS ***
Dealt to hichnick777 [Jc Ts]
hichnick777: folds
Jarja25: folds
Lassis1993: folds
Gaetanopre: folds
24b4tm4n24: raises 642 to 1242
Santocx: folds
RaphaCosta: calls 1242
ALLILS: folds
EZCoinFlip: raises 2668 to 3910
24b4tm4n24: folds
RaphaCosta: raises 13654 to 17564 and is all-in
EZCoinFlip: calls 13654
*** FLOP *** [8s Ks 9d]
*** TURN *** [8s Ks 9d] [3d]
*** RIVER *** [8s Ks 9d 3d] [9c]
*** SHOW DOWN ***
EZCoinFlip: shows [Kh As] (two pair, Kings and Nines)
RaphaCosta: shows [4s 4d] (two pair, Nines and Fours)
EZCoinFlip collected 37210 from pot
RaphaCosta finished the tournament in 4145th place
*** SUMMARY ***
Total pot 37210 | Rake 0
Board [8s Ks 9d 3d 9c]
Seat 1: Gaetanopre folded before Flop (didn't bet)
Seat 2: 24b4tm4n24 folded before Flop
Seat 3: Santocx folded before Flop (didn't bet)
Seat 4: RaphaCosta (button) showed [4s 4d] and lost with two pair, Nines and Fours
Seat 5: ALLILS (small blind) folded before Flop
Seat 6: EZCoinFlip (big blind) showed [Kh As] and won (37210) with two pair, Kings and Nines
Seat 7: hichnick777 folded before Flop (didn't bet)
Seat 8: Jarja25 folded before Flop (didn't bet)
Seat 9: Lassis1993 folded before Flop (didn't bet)


*********** # 37 **************
PokerStars Hand #176670497099: Tournament #2054568934, $20+$2 USD Hold'em No Limit - Level XII (300/600) - 2017/10/09 0:35:15 MSK [2017/10/08 17:35:15 ET]
Table '2054568934 506' 9-max Seat #5 is the button
Seat 1: Gaetanopre (62315 in chips)
Seat 2: 24b4tm4n24 (18170 in chips)
Seat 3: Santocx (27386 in chips)
Seat 5: ALLILS (17713 in chips)
Seat 6: EZCoinFlip (49848 in chips)
Seat 7: hichnick777 (8257 in chips)
Seat 8: Jarja25 (19437 in chips)
Seat 9: Lassis1993 (13980 in chips)
Gaetanopre: posts the ante 60
24b4tm4n24: posts the ante 60
Santocx: posts the ante 60
ALLILS: posts the ante 60
EZCoinFlip: posts the ante 60
hichnick777: posts the ante 60
Jarja25: posts the ante 60
Lassis1993: posts the ante 60
EZCoinFlip: posts small blind 300
hichnick777: posts big blind 600
*** HOLE CARDS ***
Dealt to hichnick777 [2d Ac]
Jarja25: folds
Lassis1993: folds
Gaetanopre: folds
24b4tm4n24: folds
Santocx: raises 672 to 1272
ALLILS: folds
EZCoinFlip: folds
hichnick777: calls 672
*** FLOP *** [9h 3s 7s]
hichnick777: checks
Santocx: checks
*** TURN *** [9h 3s 7s] [7d]
hichnick777: checks
Santocx: bets 1222
hichnick777: calls 1222
*** RIVER *** [9h 3s 7s 7d] [2s]
hichnick777: checks
Santocx: checks
*** SHOW DOWN ***
hichnick777: shows [2d Ac] (two pair, Sevens and Deuces)
Santocx: mucks hand
hichnick777 collected 5768 from pot
*** SUMMARY ***
Total pot 5768 | Rake 0
Board [9h 3s 7s 7d 2s]
Seat 1: Gaetanopre folded before Flop (didn't bet)
Seat 2: 24b4tm4n24 folded before Flop (didn't bet)
Seat 3: Santocx mucked [Ah Tc]
Seat 5: ALLILS (button) folded before Flop (didn't bet)
Seat 6: EZCoinFlip (small blind) folded before Flop
Seat 7: hichnick777 (big blind) showed [2d Ac] and won (5768) with two pair, Sevens and Deuces
Seat 8: Jarja25 folded before Flop (didn't bet)
Seat 9: Lassis1993 folded before Flop (didn't bet)


*********** # 38 **************
PokerStars Hand #176670576647: Tournament #2054568934, $20+$2 USD Hold'em No Limit - Level XII (300/600) - 2017/10/09 0:36:54 MSK [2017/10/08 17:36:54 ET]
Table '2054568934 506' 9-max Seat #6 is the button
Seat 1: Gaetanopre (62255 in chips)
Seat 2: 24b4tm4n24 (18110 in chips)
Seat 3: Santocx (24832 in chips)
Seat 4: pokerkid0798 (10000 in chips)
Seat 5: ALLILS (17653 in chips)
Seat 6: EZCoinFlip (49488 in chips)
Seat 7: hichnick777 (11471 in chips)
Seat 8: Jarja25 (19377 in chips)
Seat 9: Lassis1993 (13920 in chips)
Gaetanopre: posts the ante 60
24b4tm4n24: posts the ante 60
Santocx: posts the ante 60
pokerkid0798: posts the ante 60
ALLILS: posts the ante 60
EZCoinFlip: posts the ante 60
hichnick777: posts the ante 60
Jarja25: posts the ante 60
Lassis1993: posts the ante 60
hichnick777: posts small blind 300
Jarja25: posts big blind 600
*** HOLE CARDS ***
Dealt to hichnick777 [Qd Ts]
Lassis1993: raises 600 to 1200
Gaetanopre: calls 1200
24b4tm4n24: folds
Santocx: folds
pokerkid0798: folds
ALLILS: folds
EZCoinFlip: folds
hichnick777: folds
Jarja25: calls 600
*** FLOP *** [8h 5d 9c]
Jarja25: checks
Lassis1993: checks
Gaetanopre: bets 1200
Jarja25: calls 1200
Lassis1993: folds
*** TURN *** [8h 5d 9c] [4h]
Jarja25: checks
Gaetanopre: bets 1200
Jarja25: calls 1200
*** RIVER *** [8h 5d 9c 4h] [4c]
Jarja25: checks
Gaetanopre: bets 14400
Jarja25: folds
Uncalled bet (14400) returned to Gaetanopre
Gaetanopre collected 9240 from pot
Gaetanopre: doesn't show hand
*** SUMMARY ***
Total pot 9240 | Rake 0
Board [8h 5d 9c 4h 4c]
Seat 1: Gaetanopre collected (9240)
Seat 2: 24b4tm4n24 folded before Flop (didn't bet)
Seat 3: Santocx folded before Flop (didn't bet)
Seat 4: pokerkid0798 folded before Flop (didn't bet)
Seat 5: ALLILS folded before Flop (didn't bet)
Seat 6: EZCoinFlip (button) folded before Flop (didn't bet)
Seat 7: hichnick777 (small blind) folded before Flop
Seat 8: Jarja25 (big blind) folded on the River
Seat 9: Lassis1993 folded on the Flop


*********** # 39 **************
PokerStars Hand #176670648193: Tournament #2054568934, $20+$2 USD Hold'em No Limit - Level XII (300/600) - 2017/10/09 0:38:24 MSK [2017/10/08 17:38:24 ET]
Table '2054568934 506' 9-max Seat #7 is the button
Seat 1: Gaetanopre (67835 in chips)
Seat 2: 24b4tm4n24 (18050 in chips)
Seat 3: Santocx (24772 in chips)
Seat 4: pokerkid0798 (9940 in chips)
Seat 5: ALLILS (17593 in chips)
Seat 6: EZCoinFlip (49428 in chips)
Seat 7: hichnick777 (11111 in chips)
Seat 8: Jarja25 (15717 in chips)
Seat 9: Lassis1993 (12660 in chips)
Gaetanopre: posts the ante 60
24b4tm4n24: posts the ante 60
Santocx: posts the ante 60
pokerkid0798: posts the ante 60
ALLILS: posts the ante 60
EZCoinFlip: posts the ante 60
hichnick777: posts the ante 60
Jarja25: posts the ante 60
Lassis1993: posts the ante 60
Jarja25: posts small blind 300
Lassis1993: posts big blind 600
*** HOLE CARDS ***
Dealt to hichnick777 [5d 9d]
Gaetanopre: raises 600 to 1200
24b4tm4n24: folds
Santocx: calls 1200
pokerkid0798: folds
ALLILS: raises 16333 to 17533 and is all-in
EZCoinFlip: folds
hichnick777: folds
Jarja25: folds
Lassis1993: folds
Gaetanopre: folds
Santocx: folds
Uncalled bet (16333) returned to ALLILS
ALLILS collected 5040 from pot
*** SUMMARY ***
Total pot 5040 | Rake 0
Seat 1: Gaetanopre folded before Flop
Seat 2: 24b4tm4n24 folded before Flop (didn't bet)
Seat 3: Santocx folded before Flop
Seat 4: pokerkid0798 folded before Flop (didn't bet)
Seat 5: ALLILS collected (5040)
Seat 6: EZCoinFlip folded before Flop (didn't bet)
Seat 7: hichnick777 (button) folded before Flop (didn't bet)
Seat 8: Jarja25 (small blind) folded before Flop
Seat 9: Lassis1993 (big blind) folded before Flop


*********** # 40 **************
PokerStars Hand #176670692747: Tournament #2054568934, $20+$2 USD Hold'em No Limit - Level XII (300/600) - 2017/10/09 0:39:20 MSK [2017/10/08 17:39:20 ET]
Table '2054568934 506' 9-max Seat #8 is the button
Seat 1: Gaetanopre (66575 in chips)
Seat 2: 24b4tm4n24 (17990 in chips)
Seat 3: Santocx (23512 in chips)
Seat 4: pokerkid0798 (9880 in chips)
Seat 5: ALLILS (21373 in chips)
Seat 6: EZCoinFlip (49368 in chips)
Seat 7: hichnick777 (11051 in chips)
Seat 8: Jarja25 (15357 in chips)
Seat 9: Lassis1993 (12000 in chips)
Gaetanopre: posts the ante 60
24b4tm4n24: posts the ante 60
Santocx: posts the ante 60
pokerkid0798: posts the ante 60
ALLILS: posts the ante 60
EZCoinFlip: posts the ante 60
hichnick777: posts the ante 60
Jarja25: posts the ante 60
Lassis1993: posts the ante 60
Lassis1993: posts small blind 300
Gaetanopre: posts big blind 600
*** HOLE CARDS ***
Dealt to hichnick777 [3d 8s]
24b4tm4n24: folds
Santocx: folds
pokerkid0798: folds
ALLILS: raises 630 to 1230
EZCoinFlip: folds
hichnick777: folds
Jarja25: folds
Lassis1993: calls 930
Gaetanopre: calls 630
*** FLOP *** [3c 7h Ts]
Lassis1993: checks
Gaetanopre: bets 2400
ALLILS: folds
Lassis1993: folds
Uncalled bet (2400) returned to Gaetanopre
Gaetanopre collected 4230 from pot
Gaetanopre: doesn't show hand
*** SUMMARY ***
Total pot 4230 | Rake 0
Board [3c 7h Ts]
Seat 1: Gaetanopre (big blind) collected (4230)
Seat 2: 24b4tm4n24 folded before Flop (didn't bet)
Seat 3: Santocx folded before Flop (didn't bet)
Seat 4: pokerkid0798 folded before Flop (didn't bet)
Seat 5: ALLILS folded on the Flop
Seat 6: EZCoinFlip folded before Flop (didn't bet)
Seat 7: hichnick777 folded before Flop (didn't bet)
Seat 8: Jarja25 (button) folded before Flop (didn't bet)
Seat 9: Lassis1993 (small blind) folded on the Flop


*********** # 41 **************
PokerStars Hand #176670745427: Tournament #2054568934, $20+$2 USD Hold'em No Limit - Level XIII (400/800) - 2017/10/09 0:40:26 MSK [2017/10/08 17:40:26 ET]
Table '2054568934 506' 9-max Seat #9 is the button
Seat 1: Gaetanopre (69515 in chips)
Seat 2: 24b4tm4n24 (17930 in chips)
Seat 3: Santocx (23452 in chips)
Seat 4: pokerkid0798 (9820 in chips)
Seat 5: ALLILS (20083 in chips)
Seat 6: EZCoinFlip (49308 in chips)
Seat 7: hichnick777 (10991 in chips)
Seat 8: Jarja25 (15297 in chips)
Seat 9: Lassis1993 (10710 in chips)
Gaetanopre: posts the ante 80
24b4tm4n24: posts the ante 80
Santocx: posts the ante 80
pokerkid0798: posts the ante 80
ALLILS: posts the ante 80
EZCoinFlip: posts the ante 80
hichnick777: posts the ante 80
Jarja25: posts the ante 80
Lassis1993: posts the ante 80
Gaetanopre: posts small blind 400
24b4tm4n24: posts big blind 800
*** HOLE CARDS ***
Dealt to hichnick777 [Kc Jh]
Santocx: folds
pokerkid0798: folds
ALLILS: folds
EZCoinFlip: raises 800 to 1600
hichnick777: folds
Jarja25: folds
Lassis1993: folds
Gaetanopre: folds
24b4tm4n24: folds
Uncalled bet (800) returned to EZCoinFlip
EZCoinFlip collected 2720 from pot
EZCoinFlip: doesn't show hand
*** SUMMARY ***
Total pot 2720 | Rake 0
Seat 1: Gaetanopre (small blind) folded before Flop
Seat 2: 24b4tm4n24 (big blind) folded before Flop
Seat 3: Santocx folded before Flop (didn't bet)
Seat 4: pokerkid0798 folded before Flop (didn't bet)
Seat 5: ALLILS folded before Flop (didn't bet)
Seat 6: EZCoinFlip collected (2720)
Seat 7: hichnick777 folded before Flop (didn't bet)
Seat 8: Jarja25 folded before Flop (didn't bet)
Seat 9: Lassis1993 (button) folded before Flop (didn't bet)


*********** # 42 **************
PokerStars Hand #176670814423: Tournament #2054568934, $20+$2 USD Hold'em No Limit - Level XIII (400/800) - 2017/10/09 0:41:54 MSK [2017/10/08 17:41:54 ET]
Table '2054568934 506' 9-max Seat #1 is the button
Seat 1: Gaetanopre (69035 in chips)
Seat 2: 24b4tm4n24 (17050 in chips)
Seat 3: Santocx (23372 in chips)
Seat 4: pokerkid0798 (9740 in chips)
Seat 5: ALLILS (20003 in chips)
Seat 6: EZCoinFlip (51148 in chips)
Seat 7: hichnick777 (10911 in chips)
Seat 8: Jarja25 (15217 in chips)
Seat 9: Lassis1993 (10630 in chips)
Gaetanopre: posts the ante 80
24b4tm4n24: posts the ante 80
Santocx: posts the ante 80
pokerkid0798: posts the ante 80
ALLILS: posts the ante 80
EZCoinFlip: posts the ante 80
hichnick777: posts the ante 80
Jarja25: posts the ante 80
Lassis1993: posts the ante 80
24b4tm4n24: posts small blind 400
Santocx: posts big blind 800
*** HOLE CARDS ***
Dealt to hichnick777 [Tc 8c]
pokerkid0798: folds
ALLILS: folds
EZCoinFlip: raises 800 to 1600
hichnick777: folds
Jarja25: folds
Lassis1993: folds
Gaetanopre: calls 1600
24b4tm4n24: folds
Santocx: calls 800
*** FLOP *** [6s Jd 6h]
Santocx: checks
EZCoinFlip: bets 1717
Gaetanopre: raises 1717 to 3434
Santocx: folds
EZCoinFlip: calls 1717
*** TURN *** [6s Jd 6h] [9s]
EZCoinFlip: checks
Gaetanopre: bets 3200
EZCoinFlip: calls 3200
*** RIVER *** [6s Jd 6h 9s] [3c]
EZCoinFlip: checks
Gaetanopre: checks
*** SHOW DOWN ***
EZCoinFlip: shows [Ah Jh] (two pair, Jacks and Sixes)
Gaetanopre: mucks hand
EZCoinFlip collected 19188 from pot
*** SUMMARY ***
Total pot 19188 | Rake 0
Board [6s Jd 6h 9s 3c]
Seat 1: Gaetanopre (button) mucked [Jc 4c]
Seat 2: 24b4tm4n24 (small blind) folded before Flop
Seat 3: Santocx (big blind) folded on the Flop
Seat 4: pokerkid0798 folded before Flop (didn't bet)
Seat 5: ALLILS folded before Flop (didn't bet)
Seat 6: EZCoinFlip showed [Ah Jh] and won (19188) with two pair, Jacks and Sixes
Seat 7: hichnick777 folded before Flop (didn't bet)
Seat 8: Jarja25 folded before Flop (didn't bet)
Seat 9: Lassis1993 folded before Flop (didn't bet)


*********** # 43 **************
PokerStars Hand #176670864447: Tournament #2054568934, $20+$2 USD Hold'em No Limit - Level XIII (400/800) - 2017/10/09 0:42:59 MSK [2017/10/08 17:42:59 ET]
Table '2054568934 506' 9-max Seat #2 is the button
Seat 1: Gaetanopre (60721 in chips)
Seat 2: 24b4tm4n24 (16570 in chips)
Seat 3: Santocx (21692 in chips)
Seat 4: pokerkid0798 (9660 in chips)
Seat 5: ALLILS (19923 in chips)
Seat 6: EZCoinFlip (62022 in chips)
Seat 7: hichnick777 (10831 in chips)
Seat 8: Jarja25 (15137 in chips)
Seat 9: Lassis1993 (10550 in chips)
Gaetanopre: posts the ante 80
24b4tm4n24: posts the ante 80
Santocx: posts the ante 80
pokerkid0798: posts the ante 80
ALLILS: posts the ante 80
EZCoinFlip: posts the ante 80
hichnick777: posts the ante 80
Jarja25: posts the ante 80
Lassis1993: posts the ante 80
Santocx: posts small blind 400
pokerkid0798: posts big blind 800
*** HOLE CARDS ***
Dealt to hichnick777 [2h 4d]
ALLILS: folds
EZCoinFlip: folds
hichnick777: folds
Jarja25: calls 800
Lassis1993: folds
Gaetanopre: raises 800 to 1600
24b4tm4n24: raises 14890 to 16490 and is all-in
Santocx: folds
pokerkid0798: folds
Jarja25: folds
Gaetanopre: folds
Uncalled bet (14890) returned to 24b4tm4n24
24b4tm4n24 collected 5920 from pot
*** SUMMARY ***
Total pot 5920 | Rake 0
Seat 1: Gaetanopre folded before Flop
Seat 2: 24b4tm4n24 (button) collected (5920)
Seat 3: Santocx (small blind) folded before Flop
Seat 4: pokerkid0798 (big blind) folded before Flop
Seat 5: ALLILS folded before Flop (didn't bet)
Seat 6: EZCoinFlip folded before Flop (didn't bet)
Seat 7: hichnick777 folded before Flop (didn't bet)
Seat 8: Jarja25 folded before Flop
Seat 9: Lassis1993 folded before Flop (didn't bet)


*********** # 44 **************
PokerStars Hand #176670907819: Tournament #2054568934, $20+$2 USD Hold'em No Limit - Level XIII (400/800) - 2017/10/09 0:43:48 MSK [2017/10/08 17:43:48 ET]
Table '2054568934 506' 9-max Seat #3 is the button
Seat 1: Gaetanopre (59041 in chips)
Seat 2: 24b4tm4n24 (20810 in chips)
Seat 3: Santocx (21212 in chips)
Seat 4: pokerkid0798 (8780 in chips)
Seat 5: ALLILS (19843 in chips)
Seat 6: EZCoinFlip (61942 in chips)
Seat 7: hichnick777 (10751 in chips)
Seat 8: Jarja25 (14257 in chips)
Seat 9: Lassis1993 (10470 in chips)
Gaetanopre: posts the ante 80
24b4tm4n24: posts the ante 80
Santocx: posts the ante 80
pokerkid0798: posts the ante 80
ALLILS: posts the ante 80
EZCoinFlip: posts the ante 80
hichnick777: posts the ante 80
Jarja25: posts the ante 80
Lassis1993: posts the ante 80
pokerkid0798: posts small blind 400
ALLILS: posts big blind 800
*** HOLE CARDS ***
Dealt to hichnick777 [4d 4s]
EZCoinFlip: folds
hichnick777: raises 1000 to 1800
Jarja25: folds
Lassis1993: folds
Gaetanopre: raises 22200 to 24000
24b4tm4n24: folds
Santocx: folds
pokerkid0798: folds
ALLILS: folds
hichnick777: folds
Uncalled bet (22200) returned to Gaetanopre
Gaetanopre collected 5520 from pot
Gaetanopre: doesn't show hand
*** SUMMARY ***
Total pot 5520 | Rake 0
Seat 1: Gaetanopre collected (5520)
Seat 2: 24b4tm4n24 folded before Flop (didn't bet)
Seat 3: Santocx (button) folded before Flop (didn't bet)
Seat 4: pokerkid0798 (small blind) folded before Flop
Seat 5: ALLILS (big blind) folded before Flop
Seat 6: EZCoinFlip folded before Flop (didn't bet)
Seat 7: hichnick777 folded before Flop
Seat 8: Jarja25 folded before Flop (didn't bet)
Seat 9: Lassis1993 folded before Flop (didn't bet)


*********** # 45 **************
PokerStars Hand #176670928348: Tournament #2054568934, $20+$2 USD Hold'em No Limit - Level XIII (400/800) - 2017/10/09 0:44:15 MSK [2017/10/08 17:44:15 ET]
Table '2054568934 506' 9-max Seat #4 is the button
Seat 1: Gaetanopre (62681 in chips)
Seat 2: 24b4tm4n24 (20730 in chips)
Seat 3: Santocx (21132 in chips)
Seat 4: pokerkid0798 (8300 in chips)
Seat 5: ALLILS (18963 in chips)
Seat 6: EZCoinFlip (61862 in chips)
Seat 7: hichnick777 (8871 in chips)
Seat 8: Jarja25 (14177 in chips)
Seat 9: Lassis1993 (10390 in chips)
Gaetanopre: posts the ante 80
24b4tm4n24: posts the ante 80
Santocx: posts the ante 80
pokerkid0798: posts the ante 80
ALLILS: posts the ante 80
EZCoinFlip: posts the ante 80
hichnick777: posts the ante 80
Jarja25: posts the ante 80
Lassis1993: posts the ante 80
ALLILS: posts small blind 400
EZCoinFlip: posts big blind 800
*** HOLE CARDS ***
Dealt to hichnick777 [Td Kc]
hichnick777: folds
Jarja25: folds
Lassis1993: folds
Gaetanopre: folds
24b4tm4n24: folds
Santocx: folds
pokerkid0798: folds
ALLILS: folds
Uncalled bet (400) returned to EZCoinFlip
EZCoinFlip collected 1520 from pot
EZCoinFlip: doesn't show hand
*** SUMMARY ***
Total pot 1520 | Rake 0
Seat 1: Gaetanopre folded before Flop (didn't bet)
Seat 2: 24b4tm4n24 folded before Flop (didn't bet)
Seat 3: Santocx folded before Flop (didn't bet)
Seat 4: pokerkid0798 (button) folded before Flop (didn't bet)
Seat 5: ALLILS (small blind) folded before Flop
Seat 6: EZCoinFlip (big blind) collected (1520)
Seat 7: hichnick777 folded before Flop (didn't bet)
Seat 8: Jarja25 folded before Flop (didn't bet)
Seat 9: Lassis1993 folded before Flop (didn't bet)


*********** # 46 **************
PokerStars Hand #176670942713: Tournament #2054568934, $20+$2 USD Hold'em No Limit - Level XIII (400/800) - 2017/10/09 0:44:34 MSK [2017/10/08 17:44:34 ET]
Table '2054568934 506' 9-max Seat #5 is the button
Seat 1: Gaetanopre (62601 in chips)
Seat 2: 24b4tm4n24 (20650 in chips)
Seat 3: Santocx (21052 in chips)
Seat 4: pokerkid0798 (8220 in chips)
Seat 5: ALLILS (18483 in chips)
Seat 6: EZCoinFlip (62902 in chips)
Seat 7: hichnick777 (8791 in chips)
Seat 8: Jarja25 (14097 in chips)
Seat 9: Lassis1993 (10310 in chips)
Gaetanopre: posts the ante 80
24b4tm4n24: posts the ante 80
Santocx: posts the ante 80
pokerkid0798: posts the ante 80
ALLILS: posts the ante 80
EZCoinFlip: posts the ante 80
hichnick777: posts the ante 80
Jarja25: posts the ante 80
Lassis1993: posts the ante 80
EZCoinFlip: posts small blind 400
hichnick777: posts big blind 800
*** HOLE CARDS ***
Dealt to hichnick777 [5d 9c]
Jarja25: folds
Lassis1993: raises 9430 to 10230 and is all-in
Gaetanopre: folds
24b4tm4n24: folds
Santocx: folds
pokerkid0798: folds
ALLILS: folds
EZCoinFlip: raises 52592 to 62822 and is all-in
hichnick777: folds
Uncalled bet (52592) returned to EZCoinFlip
*** FLOP *** [Jh Tc Ah]
*** TURN *** [Jh Tc Ah] [5s]
*** RIVER *** [Jh Tc Ah 5s] [2c]
*** SHOW DOWN ***
EZCoinFlip: shows [Qh Ad] (a pair of Aces)
Lassis1993: shows [9d 9s] (a pair of Nines)
EZCoinFlip collected 21980 from pot
Lassis1993 finished the tournament in 3568th place
*** SUMMARY ***
Total pot 21980 | Rake 0
Board [Jh Tc Ah 5s 2c]
Seat 1: Gaetanopre folded before Flop (didn't bet)
Seat 2: 24b4tm4n24 folded before Flop (didn't bet)
Seat 3: Santocx folded before Flop (didn't bet)
Seat 4: pokerkid0798 folded before Flop (didn't bet)
Seat 5: ALLILS (button) folded before Flop (didn't bet)
Seat 6: EZCoinFlip (small blind) showed [Qh Ad] and won (21980) with a pair of Aces
Seat 7: hichnick777 (big blind) folded before Flop
Seat 8: Jarja25 folded before Flop (didn't bet)
Seat 9: Lassis1993 showed [9d 9s] and lost with a pair of Nines


*********** # 47 **************
PokerStars Hand #176670975931: Tournament #2054568934, $20+$2 USD Hold'em No Limit - Level XIII (400/800) - 2017/10/09 0:45:17 MSK [2017/10/08 17:45:17 ET]
Table '2054568934 506' 9-max Seat #6 is the button
Seat 1: Gaetanopre (62521 in chips)
Seat 2: 24b4tm4n24 (20570 in chips)
Seat 3: Santocx (20972 in chips)
Seat 4: pokerkid0798 (8140 in chips)
Seat 5: ALLILS (18403 in chips)
Seat 6: EZCoinFlip (74572 in chips)
Seat 7: hichnick777 (7911 in chips)
Seat 8: Jarja25 (14017 in chips)
Gaetanopre: posts the ante 80
24b4tm4n24: posts the ante 80
Santocx: posts the ante 80
pokerkid0798: posts the ante 80
ALLILS: posts the ante 80
EZCoinFlip: posts the ante 80
hichnick777: posts the ante 80
Jarja25: posts the ante 80
hichnick777: posts small blind 400
Jarja25: posts big blind 800
*** HOLE CARDS ***
Dealt to hichnick777 [Qd Qs]
Gaetanopre: raises 800 to 1600
24b4tm4n24: raises 18890 to 20490 and is all-in
Santocx: folds
pokerkid0798: calls 8060 and is all-in
ALLILS: folds
EZCoinFlip: folds
hichnick777: calls 7431 and is all-in
Jarja25: folds
Gaetanopre: folds
Uncalled bet (12430) returned to 24b4tm4n24
*** FLOP *** [Jh 4c 6s]
*** TURN *** [Jh 4c 6s] [6d]
*** RIVER *** [Jh 4c 6s 6d] [8c]
*** SHOW DOWN ***
24b4tm4n24: shows [As Qh] (a pair of Sixes)
pokerkid0798: shows [Kh Ac] (a pair of Sixes - Ace+King kicker)
pokerkid0798 collected 458 from side pot
hichnick777: shows [Qd Qs] (two pair, Queens and Sixes)
hichnick777 collected 26533 from main pot
*** SUMMARY ***
Total pot 26991 Main pot 26533. Side pot 458. | Rake 0
Board [Jh 4c 6s 6d 8c]
Seat 1: Gaetanopre folded before Flop
Seat 2: 24b4tm4n24 showed [As Qh] and lost with a pair of Sixes
Seat 3: Santocx folded before Flop (didn't bet)
Seat 4: pokerkid0798 showed [Kh Ac] and won (458) with a pair of Sixes
Seat 5: ALLILS folded before Flop (didn't bet)
Seat 6: EZCoinFlip (button) folded before Flop (didn't bet)
Seat 7: hichnick777 (small blind) showed [Qd Qs] and won (26533) with two pair, Queens and Sixes
Seat 8: Jarja25 (big blind) folded before Flop


*********** # 48 **************
PokerStars Hand #176671005932: Tournament #2054568934, $20+$2 USD Hold'em No Limit - Level XIII (400/800) - 2017/10/09 0:45:56 MSK [2017/10/08 17:45:56 ET]
Table '2054568934 506' 9-max Seat #7 is the button
Seat 1: Gaetanopre (60841 in chips)
Seat 2: 24b4tm4n24 (12430 in chips)
Seat 3: Santocx (20892 in chips)
Seat 4: pokerkid0798 (458 in chips)
Seat 5: ALLILS (18323 in chips)
Seat 6: EZCoinFlip (74492 in chips)
Seat 7: hichnick777 (26533 in chips)
Seat 8: Jarja25 (13137 in chips)
Seat 9: ALIEN999710 (18834 in chips)
Gaetanopre: posts the ante 80
24b4tm4n24: posts the ante 80
Santocx: posts the ante 80
pokerkid0798: posts the ante 80
ALLILS: posts the ante 80
EZCoinFlip: posts the ante 80
hichnick777: posts the ante 80
Jarja25: posts the ante 80
ALIEN999710: posts the ante 80
Jarja25: posts small blind 400
ALIEN999710: posts big blind 800
*** HOLE CARDS ***
Dealt to hichnick777 [9h 7d]
Gaetanopre: raises 1600 to 2400
24b4tm4n24: folds
Santocx: folds
pokerkid0798: calls 378 and is all-in
ALLILS: raises 15843 to 18243 and is all-in
EZCoinFlip: folds
hichnick777: folds
Jarja25: folds
ALIEN999710: folds
Gaetanopre: calls 15843
*** FLOP *** [9c 8s 6c]
*** TURN *** [9c 8s 6c] [7s]
*** RIVER *** [9c 8s 6c 7s] [4c]
*** SHOW DOWN ***
Gaetanopre: shows [8d Ad] (a pair of Eights)
ALLILS: shows [Qd Qh] (a pair of Queens)
ALLILS collected 36174 from side pot
pokerkid0798: shows [7h 2d] (a pair of Sevens)
ALLILS collected 2610 from main pot
pokerkid0798 finished the tournament in 3495th place
*** SUMMARY ***
Total pot 38784 Main pot 2610. Side pot 36174. | Rake 0
Board [9c 8s 6c 7s 4c]
Seat 1: Gaetanopre showed [8d Ad] and lost with a pair of Eights
Seat 2: 24b4tm4n24 folded before Flop (didn't bet)
Seat 3: Santocx folded before Flop (didn't bet)
Seat 4: pokerkid0798 showed [7h 2d] and lost with a pair of Sevens
Seat 5: ALLILS showed [Qd Qh] and won (38784) with a pair of Queens
Seat 6: EZCoinFlip folded before Flop (didn't bet)
Seat 7: hichnick777 (button) folded before Flop (didn't bet)
Seat 8: Jarja25 (small blind) folded before Flop
Seat 9: ALIEN999710 (big blind) folded before Flop


*********** # 49 **************
PokerStars Hand #176671037916: Tournament #2054568934, $20+$2 USD Hold'em No Limit - Level XIII (400/800) - 2017/10/09 0:46:37 MSK [2017/10/08 17:46:37 ET]
Table '2054568934 506' 9-max Seat #8 is the button
Seat 1: Gaetanopre (42518 in chips)
Seat 2: 24b4tm4n24 (12350 in chips)
Seat 3: Santocx (20812 in chips)
Seat 5: ALLILS (38784 in chips)
Seat 6: EZCoinFlip (74412 in chips)
Seat 7: hichnick777 (26453 in chips)
Seat 8: Jarja25 (12657 in chips)
Seat 9: ALIEN999710 (17954 in chips)
Gaetanopre: posts the ante 80
24b4tm4n24: posts the ante 80
Santocx: posts the ante 80
ALLILS: posts the ante 80
EZCoinFlip: posts the ante 80
hichnick777: posts the ante 80
Jarja25: posts the ante 80
ALIEN999710: posts the ante 80
ALIEN999710: posts small blind 400
Gaetanopre: posts big blind 800
*** HOLE CARDS ***
Dealt to hichnick777 [8s 7s]
24b4tm4n24: folds
Santocx: folds
ALLILS said, "<3"
ALLILS: folds
EZCoinFlip: folds
hichnick777: raises 864 to 1664
Jarja25: folds
ALIEN999710: folds
Gaetanopre: folds
Uncalled bet (864) returned to hichnick777
hichnick777 collected 2640 from pot
hichnick777: doesn't show hand
*** SUMMARY ***
Total pot 2640 | Rake 0
Seat 1: Gaetanopre (big blind) folded before Flop
Seat 2: 24b4tm4n24 folded before Flop (didn't bet)
Seat 3: Santocx folded before Flop (didn't bet)
Seat 5: ALLILS folded before Flop (didn't bet)
Seat 6: EZCoinFlip folded before Flop (didn't bet)
Seat 7: hichnick777 collected (2640)
Seat 8: Jarja25 (button) folded before Flop (didn't bet)
Seat 9: ALIEN999710 (small blind) folded before Flop


*********** # 50 **************
PokerStars Hand #176671058439: Tournament #2054568934, $20+$2 USD Hold'em No Limit - Level XIII (400/800) - 2017/10/09 0:47:04 MSK [2017/10/08 17:47:04 ET]
Table '2054568934 506' 9-max Seat #9 is the button
Seat 1: Gaetanopre (41638 in chips)
Seat 2: 24b4tm4n24 (12270 in chips)
Seat 3: Santocx (20732 in chips)
Seat 4: pocketdoves1 (37921 in chips)
Seat 5: ALLILS (38704 in chips)
Seat 6: EZCoinFlip (74332 in chips)
Seat 7: hichnick777 (28213 in chips)
Seat 8: Jarja25 (12577 in chips)
Seat 9: ALIEN999710 (17474 in chips)
Gaetanopre: posts the ante 80
24b4tm4n24: posts the ante 80
Santocx: posts the ante 80
pocketdoves1: posts the ante 80
ALLILS: posts the ante 80
EZCoinFlip: posts the ante 80
hichnick777: posts the ante 80
Jarja25: posts the ante 80
ALIEN999710: posts the ante 80
Gaetanopre: posts small blind 400
24b4tm4n24: posts big blind 800
*** HOLE CARDS ***
Dealt to hichnick777 [3d 9c]
pocketdoves1 said, "nh"
Santocx: folds
pocketdoves1: folds
ALLILS: folds
EZCoinFlip: folds
hichnick777: folds
Jarja25: raises 11697 to 12497 and is all-in
ALIEN999710: folds
Gaetanopre: folds
24b4tm4n24: folds
Uncalled bet (11697) returned to Jarja25
ALLILS said, "tks"
Jarja25 collected 2720 from pot
*** SUMMARY ***
Total pot 2720 | Rake 0
Seat 1: Gaetanopre (small blind) folded before Flop
Seat 2: 24b4tm4n24 (big blind) folded before Flop
Seat 3: Santocx folded before Flop (didn't bet)
Seat 4: pocketdoves1 folded before Flop (didn't bet)
Seat 5: ALLILS folded before Flop (didn't bet)
Seat 6: EZCoinFlip folded before Flop (didn't bet)
Seat 7: hichnick777 folded before Flop (didn't bet)
Seat 8: Jarja25 collected (2720)
Seat 9: ALIEN999710 (button) folded before Flop (didn't bet)


*********** # 51 **************
PokerStars Hand #176671072445: Tournament #2054568934, $20+$2 USD Hold'em No Limit - Level XIII (400/800) - 2017/10/09 0:47:22 MSK [2017/10/08 17:47:22 ET]
Table '2054568934 506' 9-max Seat #1 is the button
Seat 1: Gaetanopre (41158 in chips)
Seat 2: 24b4tm4n24 (11390 in chips)
Seat 3: Santocx (20652 in chips)
Seat 4: pocketdoves1 (37841 in chips)
Seat 5: ALLILS (38624 in chips)
Seat 6: EZCoinFlip (74252 in chips)
Seat 7: hichnick777 (28133 in chips)
Seat 8: Jarja25 (14417 in chips)
Seat 9: ALIEN999710 (17394 in chips)
Gaetanopre: posts the ante 80
24b4tm4n24: posts the ante 80
Santocx: posts the ante 80
pocketdoves1: posts the ante 80
ALLILS: posts the ante 80
EZCoinFlip: posts the ante 80
hichnick777: posts the ante 80
Jarja25: posts the ante 80
ALIEN999710: posts the ante 80
24b4tm4n24: posts small blind 400
Santocx: posts big blind 800
*** HOLE CARDS ***
Dealt to hichnick777 [Ad 4d]
pocketdoves1: calls 800
ALLILS: folds
EZCoinFlip: folds
hichnick777: folds
Jarja25: folds
ALIEN999710: folds
Gaetanopre: calls 800
24b4tm4n24: raises 10510 to 11310 and is all-in
Santocx: folds
pocketdoves1: folds
Gaetanopre: calls 10510
*** FLOP *** [8c 5h 5d]
*** TURN *** [8c 5h 5d] [Jd]
*** RIVER *** [8c 5h 5d Jd] [7c]
*** SHOW DOWN ***
24b4tm4n24: shows [2d 2h] (two pair, Fives and Deuces)
Gaetanopre: shows [3h As] (a pair of Fives)
24b4tm4n24 collected 24940 from pot
*** SUMMARY ***
Total pot 24940 | Rake 0
Board [8c 5h 5d Jd 7c]
Seat 1: Gaetanopre (button) showed [3h As] and lost with a pair of Fives
Seat 2: 24b4tm4n24 (small blind) showed [2d 2h] and won (24940) with two pair, Fives and Deuces
Seat 3: Santocx (big blind) folded before Flop
Seat 4: pocketdoves1 folded before Flop
Seat 5: ALLILS folded before Flop (didn't bet)
Seat 6: EZCoinFlip folded before Flop (didn't bet)
Seat 7: hichnick777 folded before Flop (didn't bet)
Seat 8: Jarja25 folded before Flop (didn't bet)
Seat 9: ALIEN999710 folded before Flop (didn't bet)


*********** # 52 **************
PokerStars Hand #176671110547: Tournament #2054568934, $20+$2 USD Hold'em No Limit - Level XIII (400/800) - 2017/10/09 0:48:12 MSK [2017/10/08 17:48:12 ET]
Table '2054568934 506' 9-max Seat #2 is the button
Seat 1: Gaetanopre (29768 in chips)
Seat 2: 24b4tm4n24 (24940 in chips)
Seat 3: Santocx (19772 in chips)
Seat 4: pocketdoves1 (36961 in chips)
Seat 5: ALLILS (38544 in chips)
Seat 6: EZCoinFlip (74172 in chips)
Seat 7: hichnick777 (28053 in chips)
Seat 8: Jarja25 (14337 in chips)
Seat 9: ALIEN999710 (17314 in chips)
Gaetanopre: posts the ante 80
24b4tm4n24: posts the ante 80
Santocx: posts the ante 80
pocketdoves1: posts the ante 80
ALLILS: posts the ante 80
EZCoinFlip: posts the ante 80
hichnick777: posts the ante 80
Jarja25: posts the ante 80
ALIEN999710: posts the ante 80
Santocx: posts small blind 400
pocketdoves1: posts big blind 800
*** HOLE CARDS ***
Dealt to hichnick777 [Tc 6h]
ALLILS: raises 840 to 1640
EZCoinFlip: folds
hichnick777: folds
Jarja25: folds
ALIEN999710: folds
Gaetanopre: calls 1640
24b4tm4n24: folds
Santocx: calls 1240
pocketdoves1: calls 840
*** FLOP *** [6d 8c 3h]
Santocx: checks
pocketdoves1: checks
ALLILS: checks
Gaetanopre: checks
*** TURN *** [6d 8c 3h] [Th]
Santocx: checks
pocketdoves1: bets 2400
ALLILS: folds
Gaetanopre: calls 2400
Santocx: folds
*** RIVER *** [6d 8c 3h Th] [2c]
pocketdoves1: bets 4800
Gaetanopre: folds
Uncalled bet (4800) returned to pocketdoves1
pocketdoves1 collected 12080 from pot
*** SUMMARY ***
Total pot 12080 | Rake 0
Board [6d 8c 3h Th 2c]
Seat 1: Gaetanopre folded on the River
Seat 2: 24b4tm4n24 (button) folded before Flop (didn't bet)
Seat 3: Santocx (small blind) folded on the Turn
Seat 4: pocketdoves1 (big blind) collected (12080)
Seat 5: ALLILS folded on the Turn
Seat 6: EZCoinFlip folded before Flop (didn't bet)
Seat 7: hichnick777 folded before Flop (didn't bet)
Seat 8: Jarja25 folded before Flop (didn't bet)
Seat 9: ALIEN999710 folded before Flop (didn't bet)


*********** # 53 **************
PokerStars Hand #176671152582: Tournament #2054568934, $20+$2 USD Hold'em No Limit - Level XIII (400/800) - 2017/10/09 0:49:08 MSK [2017/10/08 17:49:08 ET]
Table '2054568934 506' 9-max Seat #3 is the button
Seat 1: Gaetanopre (25648 in chips)
Seat 2: 24b4tm4n24 (24860 in chips)
Seat 3: Santocx (18052 in chips)
Seat 4: pocketdoves1 (44921 in chips)
Seat 5: ALLILS (36824 in chips)
Seat 6: EZCoinFlip (74092 in chips)
Seat 7: hichnick777 (27973 in chips)
Seat 8: Jarja25 (14257 in chips)
Seat 9: ALIEN999710 (17234 in chips)
Gaetanopre: posts the ante 80
24b4tm4n24: posts the ante 80
Santocx: posts the ante 80
pocketdoves1: posts the ante 80
ALLILS: posts the ante 80
EZCoinFlip: posts the ante 80
hichnick777: posts the ante 80
Jarja25: posts the ante 80
ALIEN999710: posts the ante 80
pocketdoves1: posts small blind 400
ALLILS: posts big blind 800
*** HOLE CARDS ***
Dealt to hichnick777 [Ah As]
EZCoinFlip: folds
hichnick777: raises 1000 to 1800
Jarja25: folds
ALIEN999710: folds
Gaetanopre: folds
24b4tm4n24: folds
Santocx: folds
pocketdoves1: folds
ALLILS: raises 3145 to 4945
hichnick777: raises 22948 to 27893 and is all-in
ALLILS: calls 22948
*** FLOP *** [6h 7c Kh]
*** TURN *** [6h 7c Kh] [2h]
*** RIVER *** [6h 7c Kh 2h] [Qs]
*** SHOW DOWN ***
ALLILS: shows [Ad Ac] (a pair of Aces)
hichnick777: shows [Ah As] (a pair of Aces)
ALLILS collected 28453 from pot
hichnick777 collected 28453 from pot
*** SUMMARY ***
Total pot 56906 | Rake 0
Board [6h 7c Kh 2h Qs]
Seat 1: Gaetanopre folded before Flop (didn't bet)
Seat 2: 24b4tm4n24 folded before Flop (didn't bet)
Seat 3: Santocx (button) folded before Flop (didn't bet)
Seat 4: pocketdoves1 (small blind) folded before Flop
Seat 5: ALLILS (big blind) showed [Ad Ac] and won (28453) with a pair of Aces
Seat 6: EZCoinFlip folded before Flop (didn't bet)
Seat 7: hichnick777 showed [Ah As] and won (28453) with a pair of Aces
Seat 8: Jarja25 folded before Flop (didn't bet)
Seat 9: ALIEN999710 folded before Flop (didn't bet)


*********** # 54 **************
PokerStars Hand #176671196408: Tournament #2054568934, $20+$2 USD Hold'em No Limit - Level XIII (400/800) - 2017/10/09 0:50:06 MSK [2017/10/08 17:50:06 ET]
Table '2054568934 506' 9-max Seat #4 is the button
Seat 1: Gaetanopre (25568 in chips)
Seat 2: 24b4tm4n24 (24780 in chips)
Seat 3: Santocx (17972 in chips)
Seat 4: pocketdoves1 (44441 in chips)
Seat 5: ALLILS (37304 in chips)
Seat 6: EZCoinFlip (74012 in chips)
Seat 7: hichnick777 (28453 in chips)
Seat 8: Jarja25 (14177 in chips)
Seat 9: ALIEN999710 (17154 in chips)
Gaetanopre: posts the ante 80
24b4tm4n24: posts the ante 80
Santocx: posts the ante 80
pocketdoves1: posts the ante 80
ALLILS: posts the ante 80
EZCoinFlip: posts the ante 80
hichnick777: posts the ante 80
Jarja25: posts the ante 80
ALIEN999710: posts the ante 80
ALLILS: posts small blind 400
EZCoinFlip: posts big blind 800
*** HOLE CARDS ***
Dealt to hichnick777 [6c 8h]
hichnick777: folds
Jarja25: folds
ALIEN999710: folds
ALLILS said, "afaid of hearts"
Gaetanopre: folds
24b4tm4n24: raises 856 to 1656
Santocx: folds
pocketdoves1: folds
ALLILS: folds
EZCoinFlip: calls 856
*** FLOP *** [Th Td 4h]
EZCoinFlip: checks
24b4tm4n24: bets 1373
EZCoinFlip: raises 2082 to 3455
24b4tm4n24: calls 2082
*** TURN *** [Th Td 4h] [2c]
EZCoinFlip: bets 3289
24b4tm4n24: raises 16300 to 19589 and is all-in
EZCoinFlip: calls 16300
*** RIVER *** [Th Td 4h 2c] [5s]
*** SHOW DOWN ***
EZCoinFlip: shows [4c 4s] (a full house, Fours full of Tens)
24b4tm4n24: shows [Ad Tc] (three of a kind, Tens)
EZCoinFlip collected 50520 from pot
24b4tm4n24 finished the tournament in 3236th place
*** SUMMARY ***
Total pot 50520 | Rake 0
Board [Th Td 4h 2c 5s]
Seat 1: Gaetanopre folded before Flop (didn't bet)
Seat 2: 24b4tm4n24 showed [Ad Tc] and lost with three of a kind, Tens
Seat 3: Santocx folded before Flop (didn't bet)
Seat 4: pocketdoves1 (button) folded before Flop (didn't bet)
Seat 5: ALLILS (small blind) folded before Flop
Seat 6: EZCoinFlip (big blind) showed [4c 4s] and won (50520) with a full house, Fours full of Tens
Seat 7: hichnick777 folded before Flop (didn't bet)
Seat 8: Jarja25 folded before Flop (didn't bet)
Seat 9: ALIEN999710 folded before Flop (didn't bet)


*********** # 55 **************
PokerStars Hand #176671260075: Tournament #2054568934, $20+$2 USD Hold'em No Limit - Level XIII (400/800) - 2017/10/09 0:51:30 MSK [2017/10/08 17:51:30 ET]
Table '2054568934 506' 9-max Seat #5 is the button
Seat 1: Gaetanopre (25488 in chips)
Seat 3: Santocx (17892 in chips)
Seat 4: pocketdoves1 (44361 in chips)
Seat 5: ALLILS (36824 in chips)
Seat 6: EZCoinFlip (99752 in chips)
Seat 7: hichnick777 (28373 in chips)
Seat 8: Jarja25 (14097 in chips)
Seat 9: ALIEN999710 (17074 in chips)
Gaetanopre: posts the ante 80
Santocx: posts the ante 80
pocketdoves1: posts the ante 80
ALLILS: posts the ante 80
EZCoinFlip: posts the ante 80
hichnick777: posts the ante 80
Jarja25: posts the ante 80
ALIEN999710: posts the ante 80
EZCoinFlip: posts small blind 400
hichnick777: posts big blind 800
*** HOLE CARDS ***
Dealt to hichnick777 [7d 8h]
Jarja25: folds
ALIEN999710: folds
Gaetanopre: calls 800
Santocx: folds
pocketdoves1: raises 1600 to 2400
ALLILS: calls 2400
EZCoinFlip: folds
hichnick777: folds
Gaetanopre: calls 1600
*** FLOP *** [4s 5c 6c]
Gaetanopre: checks
pocketdoves1: bets 4800
ALLILS: calls 4800
Gaetanopre: raises 18208 to 23008 and is all-in
pocketdoves1: calls 18208
ALLILS: raises 11336 to 34344 and is all-in
pocketdoves1: calls 11336
*** TURN *** [4s 5c 6c] [4h]
*** RIVER *** [4s 5c 6c 4h] [4d]
*** SHOW DOWN ***
pocketdoves1: shows [Jc Qc] (three of a kind, Fours)
ALLILS: shows [6s 6d] (a full house, Sixes full of Fours)
ALLILS collected 22672 from side pot
Gaetanopre: shows [7c 9s] (three of a kind, Fours)
ALLILS collected 78064 from main pot
Gaetanopre finished the tournament in 3164th place
*** SUMMARY ***
Total pot 100736 Main pot 78064. Side pot 22672. | Rake 0
Board [4s 5c 6c 4h 4d]
Seat 1: Gaetanopre showed [7c 9s] and lost with three of a kind, Fours
Seat 3: Santocx folded before Flop (didn't bet)
Seat 4: pocketdoves1 showed [Jc Qc] and lost with three of a kind, Fours
Seat 5: ALLILS (button) showed [6s 6d] and won (100736) with a full house, Sixes full of Fours
Seat 6: EZCoinFlip (small blind) folded before Flop
Seat 7: hichnick777 (big blind) folded before Flop
Seat 8: Jarja25 folded before Flop (didn't bet)
Seat 9: ALIEN999710 folded before Flop (didn't bet)


*********** # 56 **************
PokerStars Hand #176671325945: Tournament #2054568934, $20+$2 USD Hold'em No Limit - Level XIV (500/1000) - 2017/10/09 0:52:59 MSK [2017/10/08 17:52:59 ET]
Table '2054568934 506' 9-max Seat #6 is the button
Seat 2: Paha Zhulik (10000 in chips)
Seat 3: Santocx (17812 in chips)
Seat 4: pocketdoves1 (7537 in chips)
Seat 5: ALLILS (100736 in chips)
Seat 6: EZCoinFlip (99272 in chips)
Seat 7: hichnick777 (27493 in chips)
Seat 8: Jarja25 (14017 in chips)
Seat 9: ALIEN999710 (16994 in chips)
Paha Zhulik: posts the ante 100
Santocx: posts the ante 100
pocketdoves1: posts the ante 100
ALLILS: posts the ante 100
EZCoinFlip: posts the ante 100
hichnick777: posts the ante 100
Jarja25: posts the ante 100
ALIEN999710: posts the ante 100
hichnick777: posts small blind 500
Jarja25: posts big blind 1000
*** HOLE CARDS ***
Dealt to hichnick777 [4h Tc]
ALIEN999710: folds
ALLILS said, "<3"
Paha Zhulik: folds
Santocx: folds
pocketdoves1: folds
ALLILS: folds
EZCoinFlip: raises 1500 to 2500
hichnick777: folds
Jarja25: calls 1500
*** FLOP *** [8h 4d Ah]
Jarja25: checks
EZCoinFlip: bets 1827
Jarja25: calls 1827
*** TURN *** [8h 4d Ah] [Jh]
Jarja25: checks
EZCoinFlip: checks
*** RIVER *** [8h 4d Ah Jh] [Ts]
Jarja25: bets 9590 and is all-in
EZCoinFlip: folds
Uncalled bet (9590) returned to Jarja25
Jarja25 collected 9954 from pot
*** SUMMARY ***
Total pot 9954 | Rake 0
Board [8h 4d Ah Jh Ts]
Seat 2: Paha Zhulik folded before Flop (didn't bet)
Seat 3: Santocx folded before Flop (didn't bet)
Seat 4: pocketdoves1 folded before Flop (didn't bet)
Seat 5: ALLILS folded before Flop (didn't bet)
Seat 6: EZCoinFlip (button) folded on the River
Seat 7: hichnick777 (small blind) folded before Flop
Seat 8: Jarja25 (big blind) collected (9954)
Seat 9: ALIEN999710 folded before Flop (didn't bet)


*********** # 57 **************
PokerStars Hand #176671365544: Tournament #2054568934, $20+$2 USD Hold'em No Limit - Level XIV (500/1000) - 2017/10/09 0:53:52 MSK [2017/10/08 17:53:52 ET]
Table '2054568934 506' 9-max Seat #7 is the button
Seat 1: sovrakas (13738 in chips)
Seat 2: Paha Zhulik (9900 in chips)
Seat 3: Santocx (17712 in chips)
Seat 4: pocketdoves1 (7437 in chips)
Seat 5: ALLILS (100636 in chips)
Seat 6: EZCoinFlip (94845 in chips)
Seat 7: hichnick777 (26893 in chips)
Seat 8: Jarja25 (19544 in chips)
Seat 9: ALIEN999710 (16894 in chips)
sovrakas: posts the ante 100
Paha Zhulik: posts the ante 100
Santocx: posts the ante 100
pocketdoves1: posts the ante 100
ALLILS: posts the ante 100
EZCoinFlip: posts the ante 100
hichnick777: posts the ante 100
Jarja25: posts the ante 100
ALIEN999710: posts the ante 100
Jarja25: posts small blind 500
ALIEN999710: posts big blind 1000
*** HOLE CARDS ***
Dealt to hichnick777 [4h 5s]
sovrakas: raises 2000 to 3000
Paha Zhulik: folds
Santocx: folds
pocketdoves1: folds
ALLILS: folds
EZCoinFlip: folds
hichnick777: folds
Jarja25: folds
ALIEN999710: folds
Uncalled bet (2000) returned to sovrakas
sovrakas collected 3400 from pot
sovrakas: doesn't show hand
*** SUMMARY ***
Total pot 3400 | Rake 0
Seat 1: sovrakas collected (3400)
Seat 2: Paha Zhulik folded before Flop (didn't bet)
Seat 3: Santocx folded before Flop (didn't bet)
Seat 4: pocketdoves1 folded before Flop (didn't bet)
Seat 5: ALLILS folded before Flop (didn't bet)
Seat 6: EZCoinFlip folded before Flop (didn't bet)
Seat 7: hichnick777 (button) folded before Flop (didn't bet)
Seat 8: Jarja25 (small blind) folded before Flop
Seat 9: ALIEN999710 (big blind) folded before Flop


*********** # 58 **************
PokerStars Hand #176671392628: Tournament #2054568934, $20+$2 USD Hold'em No Limit - Level XIV (500/1000) - 2017/10/09 0:54:29 MSK [2017/10/08 17:54:29 ET]
Table '2054568934 506' 9-max Seat #8 is the button
Seat 1: sovrakas (16038 in chips)
Seat 2: Paha Zhulik (9800 in chips)
Seat 3: Santocx (17612 in chips)
Seat 4: pocketdoves1 (7337 in chips)
Seat 5: ALLILS (100536 in chips)
Seat 6: EZCoinFlip (94745 in chips)
Seat 7: hichnick777 (26793 in chips)
Seat 8: Jarja25 (18944 in chips)
Seat 9: ALIEN999710 (15794 in chips)
sovrakas: posts the ante 100
Paha Zhulik: posts the ante 100
Santocx: posts the ante 100
pocketdoves1: posts the ante 100
ALLILS: posts the ante 100
EZCoinFlip: posts the ante 100
hichnick777: posts the ante 100
Jarja25: posts the ante 100
ALIEN999710: posts the ante 100
ALIEN999710: posts small blind 500
sovrakas: posts big blind 1000
*** HOLE CARDS ***
Dealt to hichnick777 [3c Jc]
Paha Zhulik: folds
Santocx: folds
pocketdoves1: folds
ALLILS: folds
EZCoinFlip: raises 1000 to 2000
hichnick777: folds
Jarja25: folds
ALIEN999710: raises 5900 to 7900
sovrakas: folds
EZCoinFlip: folds
Uncalled bet (5900) returned to ALIEN999710
ALIEN999710 collected 5900 from pot
*** SUMMARY ***
Total pot 5900 | Rake 0
Seat 1: sovrakas (big blind) folded before Flop
Seat 2: Paha Zhulik folded before Flop (didn't bet)
Seat 3: Santocx folded before Flop (didn't bet)
Seat 4: pocketdoves1 folded before Flop (didn't bet)
Seat 5: ALLILS folded before Flop (didn't bet)
Seat 6: EZCoinFlip folded before Flop
Seat 7: hichnick777 folded before Flop (didn't bet)
Seat 8: Jarja25 (button) folded before Flop (didn't bet)
Seat 9: ALIEN999710 (small blind) collected (5900)


*********** # 59 **************
PokerStars Hand #176671671209: Tournament #2054568934, $20+$2 USD Hold'em No Limit - Level XIV (500/1000) - 2017/10/09 1:02:04 MSK [2017/10/08 18:02:04 ET]
Table '2054568934 506' 9-max Seat #9 is the button
Seat 1: sovrakas (14938 in chips)
Seat 2: Paha Zhulik (9700 in chips)
Seat 3: Santocx (17512 in chips)
Seat 4: pocketdoves1 (7237 in chips)
Seat 5: ALLILS (100436 in chips)
Seat 6: EZCoinFlip (92645 in chips)
Seat 7: hichnick777 (26693 in chips)
Seat 8: Jarja25 (18844 in chips)
Seat 9: ALIEN999710 (19594 in chips)
sovrakas: posts the ante 100
Paha Zhulik: posts the ante 100
Santocx: posts the ante 100
pocketdoves1: posts the ante 100
ALLILS: posts the ante 100
EZCoinFlip: posts the ante 100
hichnick777: posts the ante 100
Jarja25: posts the ante 100
ALIEN999710: posts the ante 100
sovrakas: posts small blind 500
Paha Zhulik: posts big blind 1000
*** HOLE CARDS ***
Dealt to hichnick777 [3d Qh]
Santocx: folds
pocketdoves1 has timed out while disconnected
pocketdoves1: folds
pocketdoves1 is sitting out
ALLILS: raises 1050 to 2050
EZCoinFlip: folds
hichnick777: folds
Jarja25: folds
ALIEN999710: raises 6500 to 8550
sovrakas: folds
Paha Zhulik: folds
ALLILS: folds
Uncalled bet (6500) returned to ALIEN999710
ALIEN999710 collected 6500 from pot
*** SUMMARY ***
Total pot 6500 | Rake 0
Seat 1: sovrakas (small blind) folded before Flop
Seat 2: Paha Zhulik (big blind) folded before Flop
Seat 3: Santocx folded before Flop (didn't bet)
Seat 4: pocketdoves1 folded before Flop (didn't bet)
Seat 5: ALLILS folded before Flop
Seat 6: EZCoinFlip folded before Flop (didn't bet)
Seat 7: hichnick777 folded before Flop (didn't bet)
Seat 8: Jarja25 folded before Flop (didn't bet)
Seat 9: ALIEN999710 (button) collected (6500)


*********** # 60 **************
PokerStars Hand #176671719179: Tournament #2054568934, $20+$2 USD Hold'em No Limit - Level XIV (500/1000) - 2017/10/09 1:03:11 MSK [2017/10/08 18:03:11 ET]
Table '2054568934 506' 9-max Seat #1 is the button
Seat 1: sovrakas (14338 in chips)
Seat 2: Paha Zhulik (8600 in chips)
Seat 3: Santocx (17412 in chips)
Seat 4: pocketdoves1 (7137 in chips) is sitting out
Seat 5: ALLILS (98286 in chips)
Seat 6: EZCoinFlip (92545 in chips)
Seat 7: hichnick777 (26593 in chips)
Seat 8: Jarja25 (18744 in chips)
Seat 9: ALIEN999710 (23944 in chips)
sovrakas: posts the ante 100
Paha Zhulik: posts the ante 100
Santocx: posts the ante 100
pocketdoves1: posts the ante 100
ALLILS: posts the ante 100
EZCoinFlip: posts the ante 100
hichnick777: posts the ante 100
Jarja25: posts the ante 100
ALIEN999710: posts the ante 100
Paha Zhulik: posts small blind 500
Santocx: posts big blind 1000
*** HOLE CARDS ***
Dealt to hichnick777 [4h 9d]
pocketdoves1: folds
ALLILS: folds
EZCoinFlip: folds
hichnick777: folds
Jarja25: folds
ALIEN999710: folds
sovrakas: raises 13238 to 14238 and is all-in
Paha Zhulik: folds
Santocx: folds
Uncalled bet (13238) returned to sovrakas
sovrakas collected 3400 from pot
sovrakas: doesn't show hand
*** SUMMARY ***
Total pot 3400 | Rake 0
Seat 1: sovrakas (button) collected (3400)
Seat 2: Paha Zhulik (small blind) folded before Flop
Seat 3: Santocx (big blind) folded before Flop
Seat 4: pocketdoves1 folded before Flop (didn't bet)
Seat 5: ALLILS folded before Flop (didn't bet)
Seat 6: EZCoinFlip folded before Flop (didn't bet)
Seat 7: hichnick777 folded before Flop (didn't bet)
Seat 8: Jarja25 folded before Flop (didn't bet)
Seat 9: ALIEN999710 folded before Flop (didn't bet)


*********** # 61 **************
PokerStars Hand #176671746573: Tournament #2054568934, $20+$2 USD Hold'em No Limit - Level XIV (500/1000) - 2017/10/09 1:03:49 MSK [2017/10/08 18:03:49 ET]
Table '2054568934 506' 9-max Seat #2 is the button
Seat 1: sovrakas (16638 in chips)
Seat 2: Paha Zhulik (8000 in chips)
Seat 3: Santocx (16312 in chips)
Seat 4: pocketdoves1 (7037 in chips) is sitting out
Seat 5: ALLILS (98186 in chips)
Seat 6: EZCoinFlip (92445 in chips)
Seat 7: hichnick777 (26493 in chips)
Seat 8: Jarja25 (18644 in chips)
Seat 9: ALIEN999710 (23844 in chips)
sovrakas: posts the ante 100
Paha Zhulik: posts the ante 100
Santocx: posts the ante 100
pocketdoves1: posts the ante 100
ALLILS: posts the ante 100
EZCoinFlip: posts the ante 100
hichnick777: posts the ante 100
Jarja25: posts the ante 100
ALIEN999710: posts the ante 100
Santocx: posts small blind 500
pocketdoves1: posts big blind 1000
*** HOLE CARDS ***
Dealt to hichnick777 [7s 6c]
ALLILS: folds
EZCoinFlip: folds
hichnick777: folds
Jarja25: folds
ALIEN999710: folds
sovrakas: folds
Paha Zhulik: raises 6900 to 7900 and is all-in
Santocx: folds
pocketdoves1: folds
Uncalled bet (6900) returned to Paha Zhulik
Paha Zhulik collected 3400 from pot
*** SUMMARY ***
Total pot 3400 | Rake 0
Seat 1: sovrakas folded before Flop (didn't bet)
Seat 2: Paha Zhulik (button) collected (3400)
Seat 3: Santocx (small blind) folded before Flop
Seat 4: pocketdoves1 (big blind) folded before Flop
Seat 5: ALLILS folded before Flop (didn't bet)
Seat 6: EZCoinFlip folded before Flop (didn't bet)
Seat 7: hichnick777 folded before Flop (didn't bet)
Seat 8: Jarja25 folded before Flop (didn't bet)
Seat 9: ALIEN999710 folded before Flop (didn't bet)


*********** # 62 **************
PokerStars Hand #176671763113: Tournament #2054568934, $20+$2 USD Hold'em No Limit - Level XIV (500/1000) - 2017/10/09 1:04:12 MSK [2017/10/08 18:04:12 ET]
Table '2054568934 506' 9-max Seat #3 is the button
Seat 1: sovrakas (16538 in chips)
Seat 2: Paha Zhulik (10300 in chips)
Seat 3: Santocx (15712 in chips)
Seat 4: pocketdoves1 (5937 in chips) is sitting out
Seat 5: ALLILS (98086 in chips)
Seat 6: EZCoinFlip (92345 in chips)
Seat 7: hichnick777 (26393 in chips)
Seat 8: Jarja25 (18544 in chips)
Seat 9: ALIEN999710 (23744 in chips)
sovrakas: posts the ante 100
Paha Zhulik: posts the ante 100
Santocx: posts the ante 100
pocketdoves1: posts the ante 100
ALLILS: posts the ante 100
EZCoinFlip: posts the ante 100
hichnick777: posts the ante 100
Jarja25: posts the ante 100
ALIEN999710: posts the ante 100
pocketdoves1: posts small blind 500
ALLILS: posts big blind 1000
*** HOLE CARDS ***
Dealt to hichnick777 [Kh 5c]
EZCoinFlip: folds
hichnick777: folds
Jarja25: calls 1000
ALIEN999710: calls 1000
sovrakas: raises 15438 to 16438 and is all-in
Paha Zhulik: folds
Santocx: folds
pocketdoves1: folds
ALLILS: folds
Jarja25: folds
ALIEN999710: folds
Uncalled bet (15438) returned to sovrakas
sovrakas collected 5400 from pot
sovrakas: doesn't show hand
*** SUMMARY ***
Total pot 5400 | Rake 0
Seat 1: sovrakas collected (5400)
Seat 2: Paha Zhulik folded before Flop (didn't bet)
Seat 3: Santocx (button) folded before Flop (didn't bet)
Seat 4: pocketdoves1 (small blind) folded before Flop
Seat 5: ALLILS (big blind) folded before Flop
Seat 6: EZCoinFlip folded before Flop (didn't bet)
Seat 7: hichnick777 folded before Flop (didn't bet)
Seat 8: Jarja25 folded before Flop
Seat 9: ALIEN999710 folded before Flop


*********** # 63 **************
PokerStars Hand #176671795904: Tournament #2054568934, $20+$2 USD Hold'em No Limit - Level XIV (500/1000) - 2017/10/09 1:04:56 MSK [2017/10/08 18:04:56 ET]
Table '2054568934 506' 9-max Seat #4 is the button
Seat 1: sovrakas (20838 in chips)
Seat 2: Paha Zhulik (10200 in chips)
Seat 3: Santocx (15612 in chips)
Seat 4: pocketdoves1 (5337 in chips) is sitting out
Seat 5: ALLILS (96986 in chips)
Seat 6: EZCoinFlip (92245 in chips)
Seat 7: hichnick777 (26293 in chips)
Seat 8: Jarja25 (17444 in chips)
Seat 9: ALIEN999710 (22644 in chips)
sovrakas: posts the ante 100
Paha Zhulik: posts the ante 100
Santocx: posts the ante 100
pocketdoves1: posts the ante 100
ALLILS: posts the ante 100
EZCoinFlip: posts the ante 100
hichnick777: posts the ante 100
Jarja25: posts the ante 100
ALIEN999710: posts the ante 100
ALLILS: posts small blind 500
EZCoinFlip: posts big blind 1000
*** HOLE CARDS ***
Dealt to hichnick777 [8c 9c]
hichnick777: folds
Jarja25: folds
ALIEN999710: folds
sovrakas: folds
Paha Zhulik: raises 9100 to 10100 and is all-in
Santocx: folds
pocketdoves1: folds
ALLILS: folds
EZCoinFlip: folds
Uncalled bet (9100) returned to Paha Zhulik
Paha Zhulik collected 3400 from pot
*** SUMMARY ***
Total pot 3400 | Rake 0
Seat 1: sovrakas folded before Flop (didn't bet)
Seat 2: Paha Zhulik collected (3400)
Seat 3: Santocx folded before Flop (didn't bet)
Seat 4: pocketdoves1 (button) folded before Flop (didn't bet)
Seat 5: ALLILS (small blind) folded before Flop
Seat 6: EZCoinFlip (big blind) folded before Flop
Seat 7: hichnick777 folded before Flop (didn't bet)
Seat 8: Jarja25 folded before Flop (didn't bet)
Seat 9: ALIEN999710 folded before Flop (didn't bet)


*********** # 64 **************
PokerStars Hand #176671817927: Tournament #2054568934, $20+$2 USD Hold'em No Limit - Level XIV (500/1000) - 2017/10/09 1:05:26 MSK [2017/10/08 18:05:26 ET]
Table '2054568934 506' 9-max Seat #5 is the button
Seat 1: sovrakas (20738 in chips)
Seat 2: Paha Zhulik (12500 in chips)
Seat 3: Santocx (15512 in chips)
Seat 4: pocketdoves1 (5237 in chips) is sitting out
Seat 5: ALLILS (96386 in chips)
Seat 6: EZCoinFlip (91145 in chips)
Seat 7: hichnick777 (26193 in chips)
Seat 8: Jarja25 (17344 in chips)
Seat 9: ALIEN999710 (22544 in chips)
sovrakas: posts the ante 100
Paha Zhulik: posts the ante 100
Santocx: posts the ante 100
pocketdoves1: posts the ante 100
ALLILS: posts the ante 100
EZCoinFlip: posts the ante 100
hichnick777: posts the ante 100
Jarja25: posts the ante 100
ALIEN999710: posts the ante 100
EZCoinFlip: posts small blind 500
hichnick777: posts big blind 1000
*** HOLE CARDS ***
Dealt to hichnick777 [6h 4c]
Jarja25: folds
ALIEN999710: folds
sovrakas: folds
Paha Zhulik: folds
Santocx: folds
pocketdoves1: folds
ALLILS: folds
pocketdoves1 has returned
EZCoinFlip: folds
Uncalled bet (500) returned to hichnick777
hichnick777 collected 1900 from pot
hichnick777: doesn't show hand
*** SUMMARY ***
Total pot 1900 | Rake 0
Seat 1: sovrakas folded before Flop (didn't bet)
Seat 2: Paha Zhulik folded before Flop (didn't bet)
Seat 3: Santocx folded before Flop (didn't bet)
Seat 4: pocketdoves1 folded before Flop (didn't bet)
Seat 5: ALLILS (button) folded before Flop (didn't bet)
Seat 6: EZCoinFlip (small blind) folded before Flop
Seat 7: hichnick777 (big blind) collected (1900)
Seat 8: Jarja25 folded before Flop (didn't bet)
Seat 9: ALIEN999710 folded before Flop (didn't bet)


*********** # 65 **************
PokerStars Hand #176671838957: Tournament #2054568934, $20+$2 USD Hold'em No Limit - Level XIV (500/1000) - 2017/10/09 1:05:55 MSK [2017/10/08 18:05:55 ET]
Table '2054568934 506' 9-max Seat #6 is the button
Seat 1: sovrakas (20638 in chips)
Seat 2: Paha Zhulik (12400 in chips)
Seat 3: Santocx (15412 in chips)
Seat 4: pocketdoves1 (5137 in chips)
Seat 5: ALLILS (96286 in chips)
Seat 6: EZCoinFlip (90545 in chips)
Seat 7: hichnick777 (27493 in chips)
Seat 8: Jarja25 (17244 in chips)
Seat 9: ALIEN999710 (22444 in chips)
sovrakas: posts the ante 100
Paha Zhulik: posts the ante 100
Santocx: posts the ante 100
pocketdoves1: posts the ante 100
ALLILS: posts the ante 100
EZCoinFlip: posts the ante 100
hichnick777: posts the ante 100
Jarja25: posts the ante 100
ALIEN999710: posts the ante 100
hichnick777: posts small blind 500
Jarja25: posts big blind 1000
*** HOLE CARDS ***
Dealt to hichnick777 [Td 8c]
ALIEN999710: folds
sovrakas: raises 3000 to 4000
Paha Zhulik: folds
Santocx: folds
pocketdoves1: folds
ALLILS: raises 4000 to 8000
EZCoinFlip: folds
hichnick777: folds
Jarja25: folds
sovrakas: calls 4000
*** FLOP *** [2d Ts 3d]
sovrakas: checks
ALLILS: bets 6072
sovrakas: folds
Uncalled bet (6072) returned to ALLILS
ALLILS collected 18400 from pot
*** SUMMARY ***
Total pot 18400 | Rake 0
Board [2d Ts 3d]
Seat 1: sovrakas folded on the Flop
Seat 2: Paha Zhulik folded before Flop (didn't bet)
Seat 3: Santocx folded before Flop (didn't bet)
Seat 4: pocketdoves1 folded before Flop (didn't bet)
Seat 5: ALLILS collected (18400)
Seat 6: EZCoinFlip (button) folded before Flop (didn't bet)
Seat 7: hichnick777 (small blind) folded before Flop
Seat 8: Jarja25 (big blind) folded before Flop
Seat 9: ALIEN999710 folded before Flop (didn't bet)


*********** # 66 **************
PokerStars Hand #176671889850: Tournament #2054568934, $20+$2 USD Hold'em No Limit - Level XIV (500/1000) - 2017/10/09 1:07:05 MSK [2017/10/08 18:07:05 ET]
Table '2054568934 506' 9-max Seat #7 is the button
Seat 1: sovrakas (12538 in chips)
Seat 2: Paha Zhulik (12300 in chips)
Seat 3: Santocx (15312 in chips)
Seat 4: pocketdoves1 (5037 in chips)
Seat 5: ALLILS (106586 in chips)
Seat 6: EZCoinFlip (90445 in chips)
Seat 7: hichnick777 (26893 in chips)
Seat 8: Jarja25 (16144 in chips)
Seat 9: ALIEN999710 (22344 in chips)
sovrakas: posts the ante 100
Paha Zhulik: posts the ante 100
Santocx: posts the ante 100
pocketdoves1: posts the ante 100
ALLILS: posts the ante 100
EZCoinFlip: posts the ante 100
hichnick777: posts the ante 100
Jarja25: posts the ante 100
ALIEN999710: posts the ante 100
Jarja25: posts small blind 500
ALIEN999710: posts big blind 1000
*** HOLE CARDS ***
Dealt to hichnick777 [6h Jh]
sovrakas: folds
Paha Zhulik: raises 11200 to 12200 and is all-in
Santocx: folds
pocketdoves1: folds
ALLILS: folds
EZCoinFlip: folds
hichnick777: folds
Jarja25: folds
ALIEN999710: folds
Uncalled bet (11200) returned to Paha Zhulik
Paha Zhulik collected 3400 from pot
*** SUMMARY ***
Total pot 3400 | Rake 0
Seat 1: sovrakas folded before Flop (didn't bet)
Seat 2: Paha Zhulik collected (3400)
Seat 3: Santocx folded before Flop (didn't bet)
Seat 4: pocketdoves1 folded before Flop (didn't bet)
Seat 5: ALLILS folded before Flop (didn't bet)
Seat 6: EZCoinFlip folded before Flop (didn't bet)
Seat 7: hichnick777 (button) folded before Flop (didn't bet)
Seat 8: Jarja25 (small blind) folded before Flop
Seat 9: ALIEN999710 (big blind) folded before Flop


*********** # 67 **************
PokerStars Hand #176671912272: Tournament #2054568934, $20+$2 USD Hold'em No Limit - Level XIV (500/1000) - 2017/10/09 1:07:36 MSK [2017/10/08 18:07:36 ET]
Table '2054568934 506' 9-max Seat #8 is the button
Seat 1: sovrakas (12438 in chips)
Seat 2: Paha Zhulik (14600 in chips)
Seat 3: Santocx (15212 in chips)
Seat 4: pocketdoves1 (4937 in chips)
Seat 5: ALLILS (106486 in chips)
Seat 6: EZCoinFlip (90345 in chips)
Seat 7: hichnick777 (26793 in chips)
Seat 8: Jarja25 (15544 in chips)
Seat 9: ALIEN999710 (21244 in chips)
sovrakas: posts the ante 100
Paha Zhulik: posts the ante 100
Santocx: posts the ante 100
pocketdoves1: posts the ante 100
ALLILS: posts the ante 100
EZCoinFlip: posts the ante 100
hichnick777: posts the ante 100
Jarja25: posts the ante 100
ALIEN999710: posts the ante 100
ALIEN999710: posts small blind 500
sovrakas: posts big blind 1000
*** HOLE CARDS ***
Dealt to hichnick777 [Qs 8d]
Paha Zhulik: folds
Santocx: folds
pocketdoves1: raises 3837 to 4837 and is all-in
ALLILS: folds
EZCoinFlip: calls 4837
hichnick777: folds
Jarja25: folds
ALIEN999710: folds
sovrakas: folds
*** FLOP *** [7d 4d 5c]
*** TURN *** [7d 4d 5c] [8c]
*** RIVER *** [7d 4d 5c 8c] [Jh]
*** SHOW DOWN ***
pocketdoves1: shows [Qh Td] (high card Queen)
EZCoinFlip: shows [Ad Qd] (high card Ace)
EZCoinFlip collected 12074 from pot
pocketdoves1 finished the tournament in 2681st place
*** SUMMARY ***
Total pot 12074 | Rake 0
Board [7d 4d 5c 8c Jh]
Seat 1: sovrakas (big blind) folded before Flop
Seat 2: Paha Zhulik folded before Flop (didn't bet)
Seat 3: Santocx folded before Flop (didn't bet)
Seat 4: pocketdoves1 showed [Qh Td] and lost with high card Queen
Seat 5: ALLILS folded before Flop (didn't bet)
Seat 6: EZCoinFlip showed [Ad Qd] and won (12074) with high card Ace
Seat 7: hichnick777 folded before Flop (didn't bet)
Seat 8: Jarja25 (button) folded before Flop (didn't bet)
Seat 9: ALIEN999710 (small blind) folded before Flop


*********** # 68 **************
PokerStars Hand #176671933962: Tournament #2054568934, $20+$2 USD Hold'em No Limit - Level XIV (500/1000) - 2017/10/09 1:08:07 MSK [2017/10/08 18:08:07 ET]
Table '2054568934 506' 9-max Seat #9 is the button
Seat 1: sovrakas (11338 in chips)
Seat 2: Paha Zhulik (14500 in chips)
Seat 3: Santocx (15112 in chips)
Seat 5: ALLILS (106386 in chips)
Seat 6: EZCoinFlip (97482 in chips)
Seat 7: hichnick777 (26693 in chips)
Seat 8: Jarja25 (15444 in chips)
Seat 9: ALIEN999710 (20644 in chips)
sovrakas: posts the ante 100
Paha Zhulik: posts the ante 100
Santocx: posts the ante 100
ALLILS: posts the ante 100
EZCoinFlip: posts the ante 100
hichnick777: posts the ante 100
Jarja25: posts the ante 100
ALIEN999710: posts the ante 100
sovrakas: posts small blind 500
Paha Zhulik: posts big blind 1000
*** HOLE CARDS ***
Dealt to hichnick777 [Jc 7h]
Santocx: raises 1120 to 2120
ALLILS: folds
EZCoinFlip: folds
hichnick777: folds
Jarja25: calls 2120
ALIEN999710: folds
sovrakas: calls 1620
Paha Zhulik: calls 1120
*** FLOP *** [8s 8d 3s]
sovrakas: bets 9118 and is all-in
Paha Zhulik: calls 9118
Santocx: folds
Jarja25: calls 9118
*** TURN *** [8s 8d 3s] [Kc]
Paha Zhulik: checks
Jarja25: checks
*** RIVER *** [8s 8d 3s Kc] [Kh]
Paha Zhulik: bets 3162 and is all-in
Jarja25: calls 3162
*** SHOW DOWN ***
Paha Zhulik: shows [5c 5s] (two pair, Kings and Eights)
Jarja25: shows [Qs Qh] (two pair, Kings and Queens)
Jarja25 collected 6324 from side pot
sovrakas: shows [As 9s] (two pair, Kings and Eights)
Jarja25 collected 36634 from main pot
Paha Zhulik finished the tournament in 2624th place
sovrakas finished the tournament in 2625th place
*** SUMMARY ***
Total pot 42958 Main pot 36634. Side pot 6324. | Rake 0
Board [8s 8d 3s Kc Kh]
Seat 1: sovrakas (small blind) showed [As 9s] and lost with two pair, Kings and Eights
Seat 2: Paha Zhulik (big blind) showed [5c 5s] and lost with two pair, Kings and Eights
Seat 3: Santocx folded on the Flop
Seat 5: ALLILS folded before Flop (didn't bet)
Seat 6: EZCoinFlip folded before Flop (didn't bet)
Seat 7: hichnick777 folded before Flop (didn't bet)
Seat 8: Jarja25 showed [Qs Qh] and won (42958) with two pair, Kings and Queens
Seat 9: ALIEN999710 (button) folded before Flop (didn't bet)


*********** # 69 **************
PokerStars Hand #176672000080: Tournament #2054568934, $20+$2 USD Hold'em No Limit - Level XIV (500/1000) - 2017/10/09 1:09:34 MSK [2017/10/08 18:09:34 ET]
Table '2054568934 506' 9-max Seat #3 is the button
Seat 1: Cards Canuck (9367 in chips)
Seat 2: Patosplayer (18820 in chips)
Seat 3: Santocx (12892 in chips)
Seat 4: balamuc (34273 in chips) out of hand (moved from another table into small blind)
Seat 5: ALLILS (106286 in chips)
Seat 6: EZCoinFlip (97382 in chips)
Seat 7: hichnick777 (26593 in chips)
Seat 8: Jarja25 (43902 in chips)
Seat 9: ALIEN999710 (20544 in chips)
Cards Canuck: posts the ante 100
Patosplayer: posts the ante 100
Santocx: posts the ante 100
ALLILS: posts the ante 100
EZCoinFlip: posts the ante 100
hichnick777: posts the ante 100
Jarja25: posts the ante 100
ALIEN999710: posts the ante 100
ALLILS: posts small blind 500
EZCoinFlip: posts big blind 1000
*** HOLE CARDS ***
Dealt to hichnick777 [Kc 8d]
hichnick777: folds
Jarja25: folds
ALIEN999710: folds
Cards Canuck: folds
Patosplayer: raises 1000 to 2000
Santocx: raises 10792 to 12792 and is all-in
ALLILS: folds
EZCoinFlip: folds
Patosplayer: folds
Uncalled bet (10792) returned to Santocx
Santocx collected 6300 from pot
*** SUMMARY ***
Total pot 6300 | Rake 0
Seat 1: Cards Canuck folded before Flop (didn't bet)
Seat 2: Patosplayer folded before Flop
Seat 3: Santocx (button) collected (6300)
Seat 5: ALLILS (small blind) folded before Flop
Seat 6: EZCoinFlip (big blind) folded before Flop
Seat 7: hichnick777 folded before Flop (didn't bet)
Seat 8: Jarja25 folded before Flop (didn't bet)
Seat 9: ALIEN999710 folded before Flop (didn't bet)


*********** # 70 **************
PokerStars Hand #176672025462: Tournament #2054568934, $20+$2 USD Hold'em No Limit - Level XIV (500/1000) - 2017/10/09 1:10:09 MSK [2017/10/08 18:10:09 ET]
Table '2054568934 506' 9-max Seat #5 is the button
Seat 1: Cards Canuck (9267 in chips)
Seat 2: Patosplayer (16720 in chips)
Seat 3: Santocx (17092 in chips)
Seat 4: balamuc (34273 in chips)
Seat 5: ALLILS (105686 in chips)
Seat 6: EZCoinFlip (96282 in chips)
Seat 7: hichnick777 (26493 in chips)
Seat 8: Jarja25 (43802 in chips)
Seat 9: ALIEN999710 (20444 in chips)
Cards Canuck: posts the ante 100
Patosplayer: posts the ante 100
Santocx: posts the ante 100
balamuc: posts the ante 100
ALLILS: posts the ante 100
EZCoinFlip: posts the ante 100
hichnick777: posts the ante 100
Jarja25: posts the ante 100
ALIEN999710: posts the ante 100
EZCoinFlip: posts small blind 500
hichnick777: posts big blind 1000
*** HOLE CARDS ***
Dealt to hichnick777 [2h Ts]
Jarja25: folds
ALIEN999710: folds
Cards Canuck: raises 8167 to 9167 and is all-in
Patosplayer: folds
Santocx: folds
balamuc: folds
ALLILS: folds
EZCoinFlip: raises 87015 to 96182 and is all-in
hichnick777: folds
Uncalled bet (87015) returned to EZCoinFlip
*** FLOP *** [Kc 2d 2s]
*** TURN *** [Kc 2d 2s] [Jd]
*** RIVER *** [Kc 2d 2s Jd] [Jh]
*** SHOW DOWN ***
EZCoinFlip: shows [7d 7h] (two pair, Jacks and Sevens)
Cards Canuck: shows [9h Ac] (two pair, Jacks and Deuces)
EZCoinFlip collected 20234 from pot
Cards Canuck finished the tournament in 2562nd place
*** SUMMARY ***
Total pot 20234 | Rake 0
Board [Kc 2d 2s Jd Jh]
Seat 1: Cards Canuck showed [9h Ac] and lost with two pair, Jacks and Deuces
Seat 2: Patosplayer folded before Flop (didn't bet)
Seat 3: Santocx folded before Flop (didn't bet)
Seat 4: balamuc folded before Flop (didn't bet)
Seat 5: ALLILS (button) folded before Flop (didn't bet)
Seat 6: EZCoinFlip (small blind) showed [7d 7h] and won (20234) with two pair, Jacks and Sevens
Seat 7: hichnick777 (big blind) folded before Flop
Seat 8: Jarja25 folded before Flop (didn't bet)
Seat 9: ALIEN999710 folded before Flop (didn't bet)


*********** # 71 **************
PokerStars Hand #176672049403: Tournament #2054568934, $20+$2 USD Hold'em No Limit - Level XIV (500/1000) - 2017/10/09 1:10:43 MSK [2017/10/08 18:10:43 ET]
Table '2054568934 506' 9-max Seat #6 is the button
Seat 2: Patosplayer (16620 in chips)
Seat 3: Santocx (16992 in chips)
Seat 4: balamuc (34173 in chips)
Seat 5: ALLILS (105586 in chips)
Seat 6: EZCoinFlip (107249 in chips)
Seat 7: hichnick777 (25393 in chips)
Seat 8: Jarja25 (43702 in chips)
Seat 9: ALIEN999710 (20344 in chips)
Patosplayer: posts the ante 100
Santocx: posts the ante 100
balamuc: posts the ante 100
ALLILS: posts the ante 100
EZCoinFlip: posts the ante 100
hichnick777: posts the ante 100
Jarja25: posts the ante 100
ALIEN999710: posts the ante 100
hichnick777: posts small blind 500
Jarja25: posts big blind 1000
*** HOLE CARDS ***
Dealt to hichnick777 [6d Jc]
ALIEN999710: folds
Patosplayer: folds
Santocx: folds
balamuc: raises 1549 to 2549
ALLILS: folds
EZCoinFlip: folds
hichnick777: folds
Jarja25: calls 1549
*** FLOP *** [8h 2c 6h]
Jarja25: checks
balamuc: bets 3199
Jarja25: calls 3199
*** TURN *** [8h 2c 6h] [8d]
Jarja25: checks
balamuc: checks
*** RIVER *** [8h 2c 6h 8d] [9s]
Jarja25: bets 6000
balamuc: raises 12398 to 18398
Jarja25: folds
Uncalled bet (12398) returned to balamuc
balamuc collected 24796 from pot
balamuc: doesn't show hand
*** SUMMARY ***
Total pot 24796 | Rake 0
Board [8h 2c 6h 8d 9s]
Seat 2: Patosplayer folded before Flop (didn't bet)
Seat 3: Santocx folded before Flop (didn't bet)
Seat 4: balamuc collected (24796)
Seat 5: ALLILS folded before Flop (didn't bet)
Seat 6: EZCoinFlip (button) folded before Flop (didn't bet)
Seat 7: hichnick777 (small blind) folded before Flop
Seat 8: Jarja25 (big blind) folded on the River
Seat 9: ALIEN999710 folded before Flop (didn't bet)


*********** # 72 **************
PokerStars Hand #176672105134: Tournament #2054568934, $20+$2 USD Hold'em No Limit - Level XV (600/1200) - 2017/10/09 1:12:00 MSK [2017/10/08 18:12:00 ET]
Table '2054568934 506' 9-max Seat #7 is the button
Seat 1: Openshoves85 (54460 in chips)
Seat 2: Patosplayer (16520 in chips)
Seat 3: Santocx (16892 in chips)
Seat 4: balamuc (47121 in chips)
Seat 5: ALLILS (105486 in chips)
Seat 6: EZCoinFlip (107149 in chips)
Seat 7: hichnick777 (24793 in chips)
Seat 8: Jarja25 (31854 in chips)
Seat 9: ALIEN999710 (20244 in chips)
Openshoves85: posts the ante 120
Patosplayer: posts the ante 120
Santocx: posts the ante 120
balamuc: posts the ante 120
ALLILS: posts the ante 120
EZCoinFlip: posts the ante 120
hichnick777: posts the ante 120
Jarja25: posts the ante 120
ALIEN999710: posts the ante 120
Jarja25: posts small blind 600
ALIEN999710: posts big blind 1200
*** HOLE CARDS ***
Dealt to hichnick777 [Ah 5s]
Openshoves85: folds
Patosplayer: folds
Santocx: folds
balamuc: folds
ALLILS: raises 1260 to 2460
EZCoinFlip: folds
hichnick777: folds
Jarja25: calls 1860
ALIEN999710: calls 1260
*** FLOP *** [8h Qc Tc]
Jarja25: checks
ALIEN999710: checks
ALLILS: checks
*** TURN *** [8h Qc Tc] [2c]
Jarja25: bets 1200
ALIEN999710: calls 1200
ALLILS: folds
*** RIVER *** [8h Qc Tc 2c] [4s]
Jarja25: bets 6000
ALIEN999710: folds
Uncalled bet (6000) returned to Jarja25
Jarja25 collected 10860 from pot
*** SUMMARY ***
Total pot 10860 | Rake 0
Board [8h Qc Tc 2c 4s]
Seat 1: Openshoves85 folded before Flop (didn't bet)
Seat 2: Patosplayer folded before Flop (didn't bet)
Seat 3: Santocx folded before Flop (didn't bet)
Seat 4: balamuc folded before Flop (didn't bet)
Seat 5: ALLILS folded on the Turn
Seat 6: EZCoinFlip folded before Flop (didn't bet)
Seat 7: hichnick777 (button) folded before Flop (didn't bet)
Seat 8: Jarja25 (small blind) collected (10860)
Seat 9: ALIEN999710 (big blind) folded on the River


*********** # 73 **************
PokerStars Hand #176672152686: Tournament #2054568934, $20+$2 USD Hold'em No Limit - Level XV (600/1200) - 2017/10/09 1:13:07 MSK [2017/10/08 18:13:07 ET]
Table '2054568934 506' 9-max Seat #8 is the button
Seat 1: Openshoves85 (54340 in chips)
Seat 2: Patosplayer (16400 in chips)
Seat 3: Santocx (16772 in chips)
Seat 4: balamuc (47001 in chips)
Seat 5: ALLILS (102906 in chips)
Seat 6: EZCoinFlip (107029 in chips)
Seat 7: hichnick777 (24673 in chips)
Seat 8: Jarja25 (38934 in chips)
Seat 9: ALIEN999710 (16464 in chips)
Openshoves85: posts the ante 120
Patosplayer: posts the ante 120
Santocx: posts the ante 120
balamuc: posts the ante 120
ALLILS: posts the ante 120
EZCoinFlip: posts the ante 120
hichnick777: posts the ante 120
Jarja25: posts the ante 120
ALIEN999710: posts the ante 120
ALIEN999710: posts small blind 600
Openshoves85: posts big blind 1200
*** HOLE CARDS ***
Dealt to hichnick777 [5c 6d]
Patosplayer: folds
Santocx: folds
balamuc: folds
ALLILS: folds
EZCoinFlip: raises 1200 to 2400
hichnick777: folds
Jarja25: folds
ALIEN999710: folds
Openshoves85: folds
Uncalled bet (1200) returned to EZCoinFlip
EZCoinFlip collected 4080 from pot
EZCoinFlip: doesn't show hand
*** SUMMARY ***
Total pot 4080 | Rake 0
Seat 1: Openshoves85 (big blind) folded before Flop
Seat 2: Patosplayer folded before Flop (didn't bet)
Seat 3: Santocx folded before Flop (didn't bet)
Seat 4: balamuc folded before Flop (didn't bet)
Seat 5: ALLILS folded before Flop (didn't bet)
Seat 6: EZCoinFlip collected (4080)
Seat 7: hichnick777 folded before Flop (didn't bet)
Seat 8: Jarja25 (button) folded before Flop (didn't bet)
Seat 9: ALIEN999710 (small blind) folded before Flop


*********** # 74 **************
PokerStars Hand #176672168506: Tournament #2054568934, $20+$2 USD Hold'em No Limit - Level XV (600/1200) - 2017/10/09 1:13:29 MSK [2017/10/08 18:13:29 ET]
Table '2054568934 506' 9-max Seat #9 is the button
Seat 1: Openshoves85 (53020 in chips)
Seat 2: Patosplayer (16280 in chips)
Seat 3: Santocx (16652 in chips)
Seat 4: balamuc (46881 in chips)
Seat 5: ALLILS (102786 in chips)
Seat 6: EZCoinFlip (109789 in chips)
Seat 7: hichnick777 (24553 in chips)
Seat 8: Jarja25 (38814 in chips)
Seat 9: ALIEN999710 (15744 in chips)
Openshoves85: posts the ante 120
Patosplayer: posts the ante 120
Santocx: posts the ante 120
balamuc: posts the ante 120
ALLILS: posts the ante 120
EZCoinFlip: posts the ante 120
hichnick777: posts the ante 120
Jarja25: posts the ante 120
ALIEN999710: posts the ante 120
Openshoves85: posts small blind 600
Patosplayer: posts big blind 1200
*** HOLE CARDS ***
Dealt to hichnick777 [Js Qd]
Santocx: folds
balamuc: folds
ALLILS: folds
EZCoinFlip: raises 1200 to 2400
hichnick777: folds
Jarja25: folds
ALIEN999710: folds
Openshoves85: folds
Patosplayer: calls 1200
*** FLOP *** [9c 5s 8d]
Patosplayer: checks
EZCoinFlip: bets 1879
Patosplayer: raises 11881 to 13760 and is all-in
EZCoinFlip: folds
Uncalled bet (11881) returned to Patosplayer
Patosplayer collected 10238 from pot
*** SUMMARY ***
Total pot 10238 | Rake 0
Board [9c 5s 8d]
Seat 1: Openshoves85 (small blind) folded before Flop
Seat 2: Patosplayer (big blind) collected (10238)
Seat 3: Santocx folded before Flop (didn't bet)
Seat 4: balamuc folded before Flop (didn't bet)
Seat 5: ALLILS folded before Flop (didn't bet)
Seat 6: EZCoinFlip folded on the Flop
Seat 7: hichnick777 folded before Flop (didn't bet)
Seat 8: Jarja25 folded before Flop (didn't bet)
Seat 9: ALIEN999710 (button) folded before Flop (didn't bet)


*********** # 75 **************
PokerStars Hand #176672200210: Tournament #2054568934, $20+$2 USD Hold'em No Limit - Level XV (600/1200) - 2017/10/09 1:14:14 MSK [2017/10/08 18:14:14 ET]
Table '2054568934 506' 9-max Seat #1 is the button
Seat 1: Openshoves85 (52300 in chips)
Seat 2: Patosplayer (22119 in chips)
Seat 3: Santocx (16532 in chips)
Seat 4: balamuc (46761 in chips)
Seat 5: ALLILS (102666 in chips)
Seat 6: EZCoinFlip (105390 in chips)
Seat 7: hichnick777 (24433 in chips)
Seat 8: Jarja25 (38694 in chips)
Seat 9: ALIEN999710 (15624 in chips)
Openshoves85: posts the ante 120
Patosplayer: posts the ante 120
Santocx: posts the ante 120
balamuc: posts the ante 120
ALLILS: posts the ante 120
EZCoinFlip: posts the ante 120
hichnick777: posts the ante 120
Jarja25: posts the ante 120
ALIEN999710: posts the ante 120
Patosplayer: posts small blind 600
Santocx: posts big blind 1200
*** HOLE CARDS ***
Dealt to hichnick777 [Kd 6c]
balamuc: folds
ALLILS: folds
EZCoinFlip: folds
hichnick777: folds
Jarja25: folds
ALIEN999710: folds
Openshoves85: folds
Patosplayer: raises 1800 to 3000
Santocx: folds
Uncalled bet (1800) returned to Patosplayer
Patosplayer collected 3480 from pot
Patosplayer: doesn't show hand
*** SUMMARY ***
Total pot 3480 | Rake 0
Seat 1: Openshoves85 (button) folded before Flop (didn't bet)
Seat 2: Patosplayer (small blind) collected (3480)
Seat 3: Santocx (big blind) folded before Flop
Seat 4: balamuc folded before Flop (didn't bet)
Seat 5: ALLILS folded before Flop (didn't bet)
Seat 6: EZCoinFlip folded before Flop (didn't bet)
Seat 7: hichnick777 folded before Flop (didn't bet)
Seat 8: Jarja25 folded before Flop (didn't bet)
Seat 9: ALIEN999710 folded before Flop (didn't bet)


*********** # 76 **************
PokerStars Hand #176672222689: Tournament #2054568934, $20+$2 USD Hold'em No Limit - Level XV (600/1200) - 2017/10/09 1:14:46 MSK [2017/10/08 18:14:46 ET]
Table '2054568934 506' 9-max Seat #2 is the button
Seat 1: Openshoves85 (52180 in chips)
Seat 2: Patosplayer (24279 in chips)
Seat 3: Santocx (15212 in chips)
Seat 4: balamuc (46641 in chips)
Seat 5: ALLILS (102546 in chips)
Seat 6: EZCoinFlip (105270 in chips)
Seat 7: hichnick777 (24313 in chips)
Seat 8: Jarja25 (38574 in chips)
Seat 9: ALIEN999710 (15504 in chips)
Openshoves85: posts the ante 120
Patosplayer: posts the ante 120
Santocx: posts the ante 120
balamuc: posts the ante 120
ALLILS: posts the ante 120
EZCoinFlip: posts the ante 120
hichnick777: posts the ante 120
Jarja25: posts the ante 120
ALIEN999710: posts the ante 120
Santocx: posts small blind 600
balamuc: posts big blind 1200
*** HOLE CARDS ***
Dealt to hichnick777 [7d Kh]
ALLILS: folds
EZCoinFlip: folds
hichnick777: folds
Jarja25: folds
ALIEN999710: folds
Openshoves85: raises 1320 to 2520
Patosplayer: folds
Santocx: raises 12572 to 15092 and is all-in
balamuc: raises 31429 to 46521 and is all-in
Openshoves85: folds
Uncalled bet (31429) returned to balamuc
*** FLOP *** [Qh 7c 8c]
*** TURN *** [Qh 7c 8c] [Th]
*** RIVER *** [Qh 7c 8c Th] [2c]
*** SHOW DOWN ***
Santocx: shows [Qc Kd] (a pair of Queens)
balamuc: shows [Jc Jh] (a pair of Jacks)
Santocx collected 33784 from pot
*** SUMMARY ***
Total pot 33784 | Rake 0
Board [Qh 7c 8c Th 2c]
Seat 1: Openshoves85 folded before Flop
Seat 2: Patosplayer (button) folded before Flop (didn't bet)
Seat 3: Santocx (small blind) showed [Qc Kd] and won (33784) with a pair of Queens
Seat 4: balamuc (big blind) showed [Jc Jh] and lost with a pair of Jacks
Seat 5: ALLILS folded before Flop (didn't bet)
Seat 6: EZCoinFlip folded before Flop (didn't bet)
Seat 7: hichnick777 folded before Flop (didn't bet)
Seat 8: Jarja25 folded before Flop (didn't bet)
Seat 9: ALIEN999710 folded before Flop (didn't bet)


*********** # 77 **************
PokerStars Hand #176672258777: Tournament #2054568934, $20+$2 USD Hold'em No Limit - Level XV (600/1200) - 2017/10/09 1:15:37 MSK [2017/10/08 18:15:37 ET]
Table '2054568934 506' 9-max Seat #3 is the button
Seat 1: Openshoves85 (49540 in chips)
Seat 2: Patosplayer (24159 in chips)
Seat 3: Santocx (33784 in chips)
Seat 4: balamuc (31429 in chips)
Seat 5: ALLILS (102426 in chips)
Seat 6: EZCoinFlip (105150 in chips)
Seat 7: hichnick777 (24193 in chips)
Seat 8: Jarja25 (38454 in chips)
Seat 9: ALIEN999710 (15384 in chips)
Openshoves85: posts the ante 120
Patosplayer: posts the ante 120
Santocx: posts the ante 120
balamuc: posts the ante 120
ALLILS: posts the ante 120
EZCoinFlip: posts the ante 120
hichnick777: posts the ante 120
Jarja25: posts the ante 120
ALIEN999710: posts the ante 120
balamuc: posts small blind 600
ALLILS: posts big blind 1200
*** HOLE CARDS ***
Dealt to hichnick777 [4h 7d]
EZCoinFlip: folds
hichnick777: folds
Jarja25: calls 1200
ALIEN999710: folds
Openshoves85: folds
Patosplayer: folds
Santocx: folds
balamuc: folds
ALLILS: raises 101106 to 102306 and is all-in
Jarja25: folds
Uncalled bet (101106) returned to ALLILS
ALLILS collected 4080 from pot
*** SUMMARY ***
Total pot 4080 | Rake 0
Seat 1: Openshoves85 folded before Flop (didn't bet)
Seat 2: Patosplayer folded before Flop (didn't bet)
Seat 3: Santocx (button) folded before Flop (didn't bet)
Seat 4: balamuc (small blind) folded before Flop
Seat 5: ALLILS (big blind) collected (4080)
Seat 6: EZCoinFlip folded before Flop (didn't bet)
Seat 7: hichnick777 folded before Flop (didn't bet)
Seat 8: Jarja25 folded before Flop
Seat 9: ALIEN999710 folded before Flop (didn't bet)


*********** # 78 **************
PokerStars Hand #176672287080: Tournament #2054568934, $20+$2 USD Hold'em No Limit - Level XV (600/1200) - 2017/10/09 1:16:17 MSK [2017/10/08 18:16:17 ET]
Table '2054568934 506' 9-max Seat #4 is the button
Seat 1: Openshoves85 (49420 in chips)
Seat 2: Patosplayer (24039 in chips)
Seat 3: Santocx (33664 in chips)
Seat 4: balamuc (30709 in chips)
Seat 5: ALLILS (105186 in chips)
Seat 6: EZCoinFlip (105030 in chips)
Seat 7: hichnick777 (24073 in chips)
Seat 8: Jarja25 (37134 in chips)
Seat 9: ALIEN999710 (15264 in chips)
Openshoves85: posts the ante 120
Patosplayer: posts the ante 120
Santocx: posts the ante 120
balamuc: posts the ante 120
ALLILS: posts the ante 120
EZCoinFlip: posts the ante 120
hichnick777: posts the ante 120
Jarja25: posts the ante 120
ALIEN999710: posts the ante 120
ALLILS: posts small blind 600
EZCoinFlip: posts big blind 1200
*** HOLE CARDS ***
Dealt to hichnick777 [9d Kc]
hichnick777: folds
Jarja25: folds
ALIEN999710: folds
Openshoves85: folds
Patosplayer: raises 1200 to 2400
Santocx: raises 4499 to 6899
balamuc: folds
ALLILS: folds
EZCoinFlip: folds
Patosplayer: raises 17020 to 23919 and is all-in
Santocx: folds
Uncalled bet (17020) returned to Patosplayer
Patosplayer collected 16678 from pot
Patosplayer: doesn't show hand
*** SUMMARY ***
Total pot 16678 | Rake 0
Seat 1: Openshoves85 folded before Flop (didn't bet)
Seat 2: Patosplayer collected (16678)
Seat 3: Santocx folded before Flop
Seat 4: balamuc (button) folded before Flop (didn't bet)
Seat 5: ALLILS (small blind) folded before Flop
Seat 6: EZCoinFlip (big blind) folded before Flop
Seat 7: hichnick777 folded before Flop (didn't bet)
Seat 8: Jarja25 folded before Flop (didn't bet)
Seat 9: ALIEN999710 folded before Flop (didn't bet)


*********** # 79 **************
PokerStars Hand #176672325369: Tournament #2054568934, $20+$2 USD Hold'em No Limit - Level XV (600/1200) - 2017/10/09 1:17:13 MSK [2017/10/08 18:17:13 ET]
Table '2054568934 506' 9-max Seat #5 is the button
Seat 1: Openshoves85 (49300 in chips)
Seat 2: Patosplayer (33698 in chips)
Seat 3: Santocx (26645 in chips)
Seat 4: balamuc (30589 in chips)
Seat 5: ALLILS (104466 in chips)
Seat 6: EZCoinFlip (103710 in chips)
Seat 7: hichnick777 (23953 in chips)
Seat 8: Jarja25 (37014 in chips)
Seat 9: ALIEN999710 (15144 in chips)
Openshoves85: posts the ante 120
Patosplayer: posts the ante 120
Santocx: posts the ante 120
balamuc: posts the ante 120
ALLILS: posts the ante 120
EZCoinFlip: posts the ante 120
hichnick777: posts the ante 120
Jarja25: posts the ante 120
ALIEN999710: posts the ante 120
EZCoinFlip: posts small blind 600
hichnick777: posts big blind 1200
*** HOLE CARDS ***
Dealt to hichnick777 [9s Tc]
Jarja25: folds
ALIEN999710: folds
Openshoves85: folds
Patosplayer: folds
Santocx: folds
balamuc: raises 1200 to 2400
ALLILS: folds
EZCoinFlip: calls 1800
hichnick777: calls 1200
*** FLOP *** [3s 2c Ts]
EZCoinFlip: checks
hichnick777: checks
balamuc: checks
*** TURN *** [3s 2c Ts] [3c]
EZCoinFlip: bets 2974
hichnick777: calls 2974
balamuc: folds
*** RIVER *** [3s 2c Ts 3c] [2d]
EZCoinFlip: checks
hichnick777: checks
*** SHOW DOWN ***
EZCoinFlip: shows [7s 7c] (two pair, Sevens and Threes)
hichnick777: shows [9s Tc] (two pair, Tens and Threes)
hichnick777 collected 14228 from pot
*** SUMMARY ***
Total pot 14228 | Rake 0
Board [3s 2c Ts 3c 2d]
Seat 1: Openshoves85 folded before Flop (didn't bet)
Seat 2: Patosplayer folded before Flop (didn't bet)
Seat 3: Santocx folded before Flop (didn't bet)
Seat 4: balamuc folded on the Turn
Seat 5: ALLILS (button) folded before Flop (didn't bet)
Seat 6: EZCoinFlip (small blind) showed [7s 7c] and lost with two pair, Sevens and Threes
Seat 7: hichnick777 (big blind) showed [9s Tc] and won (14228) with two pair, Tens and Threes
Seat 8: Jarja25 folded before Flop (didn't bet)
Seat 9: ALIEN999710 folded before Flop (didn't bet)


*********** # 80 **************
PokerStars Hand #176672389657: Tournament #2054568934, $20+$2 USD Hold'em No Limit - Level XV (600/1200) - 2017/10/09 1:18:45 MSK [2017/10/08 18:18:45 ET]
Table '2054568934 506' 9-max Seat #6 is the button
Seat 1: Openshoves85 (49180 in chips)
Seat 2: Patosplayer (33578 in chips)
Seat 3: Santocx (26525 in chips)
Seat 4: balamuc (28069 in chips)
Seat 5: ALLILS (104346 in chips)
Seat 6: EZCoinFlip (98216 in chips)
Seat 7: hichnick777 (32687 in chips)
Seat 8: Jarja25 (36894 in chips)
Seat 9: ALIEN999710 (15024 in chips)
Openshoves85: posts the ante 120
Patosplayer: posts the ante 120
Santocx: posts the ante 120
balamuc: posts the ante 120
ALLILS: posts the ante 120
EZCoinFlip: posts the ante 120
hichnick777: posts the ante 120
Jarja25: posts the ante 120
ALIEN999710: posts the ante 120
hichnick777: posts small blind 600
Jarja25: posts big blind 1200
*** HOLE CARDS ***
Dealt to hichnick777 [8s 6c]
ALIEN999710: folds
Openshoves85: folds
Patosplayer: folds
Santocx: raises 1344 to 2544
balamuc: folds
ALLILS: folds
EZCoinFlip: folds
hichnick777: folds
Jarja25: folds
Uncalled bet (1344) returned to Santocx
Santocx collected 4080 from pot
*** SUMMARY ***
Total pot 4080 | Rake 0
Seat 1: Openshoves85 folded before Flop (didn't bet)
Seat 2: Patosplayer folded before Flop (didn't bet)
Seat 3: Santocx collected (4080)
Seat 4: balamuc folded before Flop (didn't bet)
Seat 5: ALLILS folded before Flop (didn't bet)
Seat 6: EZCoinFlip (button) folded before Flop (didn't bet)
Seat 7: hichnick777 (small blind) folded before Flop
Seat 8: Jarja25 (big blind) folded before Flop
Seat 9: ALIEN999710 folded before Flop (didn't bet)


*********** # 81 **************
PokerStars Hand #176672411265: Tournament #2054568934, $20+$2 USD Hold'em No Limit - Level XV (600/1200) - 2017/10/09 1:19:16 MSK [2017/10/08 18:19:16 ET]
Table '2054568934 506' 9-max Seat #7 is the button
Seat 1: Openshoves85 (49060 in chips)
Seat 2: Patosplayer (33458 in chips)
Seat 3: Santocx (29285 in chips)
Seat 4: balamuc (27949 in chips)
Seat 5: ALLILS (104226 in chips)
Seat 6: EZCoinFlip (98096 in chips)
Seat 7: hichnick777 (31967 in chips)
Seat 8: Jarja25 (35574 in chips)
Seat 9: ALIEN999710 (14904 in chips)
Openshoves85: posts the ante 120
Patosplayer: posts the ante 120
Santocx: posts the ante 120
balamuc: posts the ante 120
ALLILS: posts the ante 120
EZCoinFlip: posts the ante 120
hichnick777: posts the ante 120
Jarja25: posts the ante 120
ALIEN999710: posts the ante 120
Jarja25: posts small blind 600
ALIEN999710: posts big blind 1200
*** HOLE CARDS ***
Dealt to hichnick777 [4d 9s]
Openshoves85: folds
Patosplayer: folds
Santocx: raises 1344 to 2544
balamuc: calls 2544
ALLILS: folds
EZCoinFlip: raises 5676 to 8220
hichnick777: folds
Jarja25: folds
ALIEN999710: calls 7020
Santocx: folds
balamuc: calls 5676
*** FLOP *** [Ah 5h 8h]
ALIEN999710: checks
balamuc: checks
EZCoinFlip: bets 6564
ALIEN999710: folds
balamuc: folds
Uncalled bet (6564) returned to EZCoinFlip
EZCoinFlip collected 28884 from pot
EZCoinFlip: doesn't show hand
*** SUMMARY ***
Total pot 28884 | Rake 0
Board [Ah 5h 8h]
Seat 1: Openshoves85 folded before Flop (didn't bet)
Seat 2: Patosplayer folded before Flop (didn't bet)
Seat 3: Santocx folded before Flop
Seat 4: balamuc folded on the Flop
Seat 5: ALLILS folded before Flop (didn't bet)
Seat 6: EZCoinFlip collected (28884)
Seat 7: hichnick777 (button) folded before Flop (didn't bet)
Seat 8: Jarja25 (small blind) folded before Flop
Seat 9: ALIEN999710 (big blind) folded on the Flop


*********** # 82 **************
PokerStars Hand #176672467006: Tournament #2054568934, $20+$2 USD Hold'em No Limit - Level XV (600/1200) - 2017/10/09 1:20:37 MSK [2017/10/08 18:20:37 ET]
Table '2054568934 506' 9-max Seat #8 is the button
Seat 1: Openshoves85 (48940 in chips)
Seat 2: Patosplayer (33338 in chips)
Seat 3: Santocx (26621 in chips)
Seat 4: balamuc (19609 in chips)
Seat 5: ALLILS (104106 in chips)
Seat 6: EZCoinFlip (118640 in chips)
Seat 7: hichnick777 (31847 in chips)
Seat 8: Jarja25 (34854 in chips)
Seat 9: ALIEN999710 (6564 in chips)
Openshoves85: posts the ante 120
Patosplayer: posts the ante 120
Santocx: posts the ante 120
balamuc: posts the ante 120
ALLILS: posts the ante 120
EZCoinFlip: posts the ante 120
hichnick777: posts the ante 120
Jarja25: posts the ante 120
ALIEN999710: posts the ante 120
ALIEN999710: posts small blind 600
Openshoves85: posts big blind 1200
*** HOLE CARDS ***
Dealt to hichnick777 [Kc Td]
Patosplayer: folds
Santocx: raises 1344 to 2544
balamuc: folds
ALLILS: folds
EZCoinFlip: folds
hichnick777: folds
Jarja25: folds
ALIEN999710: folds
Openshoves85: folds
Uncalled bet (1344) returned to Santocx
Santocx collected 4080 from pot
*** SUMMARY ***
Total pot 4080 | Rake 0
Seat 1: Openshoves85 (big blind) folded before Flop
Seat 2: Patosplayer folded before Flop (didn't bet)
Seat 3: Santocx collected (4080)
Seat 4: balamuc folded before Flop (didn't bet)
Seat 5: ALLILS folded before Flop (didn't bet)
Seat 6: EZCoinFlip folded before Flop (didn't bet)
Seat 7: hichnick777 folded before Flop (didn't bet)
Seat 8: Jarja25 (button) folded before Flop (didn't bet)
Seat 9: ALIEN999710 (small blind) folded before Flop


*********** # 83 **************
PokerStars Hand #176672481846: Tournament #2054568934, $20+$2 USD Hold'em No Limit - Level XV (600/1200) - 2017/10/09 1:20:59 MSK [2017/10/08 18:20:59 ET]
Table '2054568934 506' 9-max Seat #9 is the button
Seat 1: Openshoves85 (47620 in chips)
Seat 2: Patosplayer (33218 in chips)
Seat 3: Santocx (29381 in chips)
Seat 4: balamuc (19489 in chips)
Seat 5: ALLILS (103986 in chips)
Seat 6: EZCoinFlip (118520 in chips)
Seat 7: hichnick777 (31727 in chips)
Seat 8: Jarja25 (34734 in chips)
Seat 9: ALIEN999710 (5844 in chips)
Openshoves85: posts the ante 120
Patosplayer: posts the ante 120
Santocx: posts the ante 120
balamuc: posts the ante 120
ALLILS: posts the ante 120
EZCoinFlip: posts the ante 120
hichnick777: posts the ante 120
Jarja25: posts the ante 120
ALIEN999710: posts the ante 120
Openshoves85: posts small blind 600
Patosplayer: posts big blind 1200
*** HOLE CARDS ***
Dealt to hichnick777 [4s 9c]
Santocx: folds
balamuc: folds
ALLILS: folds
EZCoinFlip: folds
hichnick777: folds
Jarja25: folds
ALIEN999710: raises 4524 to 5724 and is all-in
Openshoves85: folds
Patosplayer: calls 4524
*** FLOP *** [4c As Kc]
*** TURN *** [4c As Kc] [8c]
*** RIVER *** [4c As Kc 8c] [6d]
*** SHOW DOWN ***
Patosplayer: shows [2s 2c] (a pair of Deuces)
ALIEN999710: shows [Js Kd] (a pair of Kings)
ALIEN999710 collected 13128 from pot
*** SUMMARY ***
Total pot 13128 | Rake 0
Board [4c As Kc 8c 6d]
Seat 1: Openshoves85 (small blind) folded before Flop
Seat 2: Patosplayer (big blind) showed [2s 2c] and lost with a pair of Deuces
Seat 3: Santocx folded before Flop (didn't bet)
Seat 4: balamuc folded before Flop (didn't bet)
Seat 5: ALLILS folded before Flop (didn't bet)
Seat 6: EZCoinFlip folded before Flop (didn't bet)
Seat 7: hichnick777 folded before Flop (didn't bet)
Seat 8: Jarja25 folded before Flop (didn't bet)
Seat 9: ALIEN999710 (button) showed [Js Kd] and won (13128) with a pair of Kings


*********** # 84 **************
PokerStars Hand #176672501080: Tournament #2054568934, $20+$2 USD Hold'em No Limit - Level XV (600/1200) - 2017/10/09 1:21:27 MSK [2017/10/08 18:21:27 ET]
Table '2054568934 506' 9-max Seat #1 is the button
Seat 1: Openshoves85 (46900 in chips)
Seat 2: Patosplayer (27374 in chips)
Seat 3: Santocx (29261 in chips)
Seat 4: balamuc (19369 in chips)
Seat 5: ALLILS (103866 in chips)
Seat 6: EZCoinFlip (118400 in chips)
Seat 7: hichnick777 (31607 in chips)
Seat 8: Jarja25 (34614 in chips)
Seat 9: ALIEN999710 (13128 in chips)
Openshoves85: posts the ante 120
Patosplayer: posts the ante 120
Santocx: posts the ante 120
balamuc: posts the ante 120
ALLILS: posts the ante 120
EZCoinFlip: posts the ante 120
hichnick777: posts the ante 120
Jarja25: posts the ante 120
ALIEN999710: posts the ante 120
Patosplayer: posts small blind 600
Santocx: posts big blind 1200
*** HOLE CARDS ***
Dealt to hichnick777 [Ad 6s]
balamuc: folds
ALLILS: folds
EZCoinFlip: raises 1200 to 2400
hichnick777: folds
Jarja25: folds
ALIEN999710: folds
Openshoves85: folds
Patosplayer: folds
Santocx: folds
Uncalled bet (1200) returned to EZCoinFlip
EZCoinFlip collected 4080 from pot
EZCoinFlip: doesn't show hand
*** SUMMARY ***
Total pot 4080 | Rake 0
Seat 1: Openshoves85 (button) folded before Flop (didn't bet)
Seat 2: Patosplayer (small blind) folded before Flop
Seat 3: Santocx (big blind) folded before Flop
Seat 4: balamuc folded before Flop (didn't bet)
Seat 5: ALLILS folded before Flop (didn't bet)
Seat 6: EZCoinFlip collected (4080)
Seat 7: hichnick777 folded before Flop (didn't bet)
Seat 8: Jarja25 folded before Flop (didn't bet)
Seat 9: ALIEN999710 folded before Flop (didn't bet)


*********** # 85 **************
PokerStars Hand #176672512190: Tournament #2054568934, $20+$2 USD Hold'em No Limit - Level XV (600/1200) - 2017/10/09 1:21:43 MSK [2017/10/08 18:21:43 ET]
Table '2054568934 506' 9-max Seat #2 is the button
Seat 1: Openshoves85 (46780 in chips)
Seat 2: Patosplayer (26654 in chips)
Seat 3: Santocx (27941 in chips)
Seat 4: balamuc (19249 in chips)
Seat 5: ALLILS (103746 in chips)
Seat 6: EZCoinFlip (121160 in chips)
Seat 7: hichnick777 (31487 in chips)
Seat 8: Jarja25 (34494 in chips)
Seat 9: ALIEN999710 (13008 in chips)
Openshoves85: posts the ante 120
Patosplayer: posts the ante 120
Santocx: posts the ante 120
balamuc: posts the ante 120
ALLILS: posts the ante 120
EZCoinFlip: posts the ante 120
hichnick777: posts the ante 120
Jarja25: posts the ante 120
ALIEN999710: posts the ante 120
Santocx: posts small blind 600
balamuc: posts big blind 1200
*** HOLE CARDS ***
Dealt to hichnick777 [8c 2s]
ALLILS: folds
EZCoinFlip: folds
hichnick777: folds
Jarja25: folds
ALIEN999710: folds
Openshoves85: folds
Patosplayer: folds
Santocx: folds
Uncalled bet (600) returned to balamuc
balamuc collected 2280 from pot
*** SUMMARY ***
Total pot 2280 | Rake 0
Seat 1: Openshoves85 folded before Flop (didn't bet)
Seat 2: Patosplayer (button) folded before Flop (didn't bet)
Seat 3: Santocx (small blind) folded before Flop
Seat 4: balamuc (big blind) collected (2280)
Seat 5: ALLILS folded before Flop (didn't bet)
Seat 6: EZCoinFlip folded before Flop (didn't bet)
Seat 7: hichnick777 folded before Flop (didn't bet)
Seat 8: Jarja25 folded before Flop (didn't bet)
Seat 9: ALIEN999710 folded before Flop (didn't bet)


*********** # 86 **************
PokerStars Hand #176672534842: Tournament #2054568934, $20+$2 USD Hold'em No Limit - Level XV (600/1200) - 2017/10/09 1:22:11 MSK [2017/10/08 18:22:11 ET]
Table '2054568934 506' 9-max Seat #3 is the button
Seat 1: Openshoves85 (46660 in chips)
Seat 2: Patosplayer (26534 in chips)
Seat 3: Santocx (27221 in chips)
Seat 4: balamuc (20809 in chips)
Seat 5: ALLILS (103626 in chips)
Seat 6: EZCoinFlip (121040 in chips)
Seat 7: hichnick777 (31367 in chips)
Seat 8: Jarja25 (34374 in chips)
Seat 9: ALIEN999710 (12888 in chips)
Openshoves85: posts the ante 120
Patosplayer: posts the ante 120
Santocx: posts the ante 120
balamuc: posts the ante 120
ALLILS: posts the ante 120
EZCoinFlip: posts the ante 120
hichnick777: posts the ante 120
Jarja25: posts the ante 120
ALIEN999710: posts the ante 120
balamuc: posts small blind 600
ALLILS: posts big blind 1200
*** HOLE CARDS ***
Dealt to hichnick777 [7c Th]
EZCoinFlip: folds
hichnick777: folds
Jarja25: calls 1200
ALIEN999710: calls 1200
Openshoves85: folds
Patosplayer: folds
Santocx: folds
balamuc: folds
ALLILS: checks
*** FLOP *** [3s 5d 5s]
ALLILS: checks
Jarja25: bets 1200
ALIEN999710: folds
ALLILS: folds
Uncalled bet (1200) returned to Jarja25
Jarja25 collected 5280 from pot
*** SUMMARY ***
Total pot 5280 | Rake 0
Board [3s 5d 5s]
Seat 1: Openshoves85 folded before Flop (didn't bet)
Seat 2: Patosplayer folded before Flop (didn't bet)
Seat 3: Santocx (button) folded before Flop (didn't bet)
Seat 4: balamuc (small blind) folded before Flop
Seat 5: ALLILS (big blind) folded on the Flop
Seat 6: EZCoinFlip folded before Flop (didn't bet)
Seat 7: hichnick777 folded before Flop (didn't bet)
Seat 8: Jarja25 collected (5280)
Seat 9: ALIEN999710 folded on the Flop


*********** # 87 **************
PokerStars Hand #176672565262: Tournament #2054568934, $20+$2 USD Hold'em No Limit - Level XV (600/1200) - 2017/10/09 1:22:56 MSK [2017/10/08 18:22:56 ET]
Table '2054568934 506' 9-max Seat #4 is the button
Seat 1: Openshoves85 (46540 in chips)
Seat 2: Patosplayer (26414 in chips)
Seat 3: Santocx (27101 in chips)
Seat 4: balamuc (20089 in chips)
Seat 5: ALLILS (102306 in chips)
Seat 6: EZCoinFlip (120920 in chips)
Seat 7: hichnick777 (31247 in chips)
Seat 8: Jarja25 (38334 in chips)
Seat 9: ALIEN999710 (11568 in chips)
Openshoves85: posts the ante 120
Patosplayer: posts the ante 120
Santocx: posts the ante 120
balamuc: posts the ante 120
ALLILS: posts the ante 120
EZCoinFlip: posts the ante 120
hichnick777: posts the ante 120
Jarja25: posts the ante 120
ALIEN999710: posts the ante 120
ALLILS: posts small blind 600
EZCoinFlip: posts big blind 1200
*** HOLE CARDS ***
Dealt to hichnick777 [6s Jh]
hichnick777: folds
Jarja25: folds
ALIEN999710: raises 10248 to 11448 and is all-in
Openshoves85: folds
Patosplayer: folds
Santocx: folds
balamuc: folds
ALLILS: folds
EZCoinFlip: calls 10248
*** FLOP *** [Ks Ad 7h]
*** TURN *** [Ks Ad 7h] [Qh]
*** RIVER *** [Ks Ad 7h Qh] [4c]
*** SHOW DOWN ***
EZCoinFlip: shows [Ac 7d] (two pair, Aces and Sevens)
ALIEN999710: shows [9d As] (a pair of Aces)
EZCoinFlip collected 24576 from pot
ALIEN999710 finished the tournament in 2123rd place
*** SUMMARY ***
Total pot 24576 | Rake 0
Board [Ks Ad 7h Qh 4c]
Seat 1: Openshoves85 folded before Flop (didn't bet)
Seat 2: Patosplayer folded before Flop (didn't bet)
Seat 3: Santocx folded before Flop (didn't bet)
Seat 4: balamuc (button) folded before Flop (didn't bet)
Seat 5: ALLILS (small blind) folded before Flop
Seat 6: EZCoinFlip (big blind) showed [Ac 7d] and won (24576) with two pair, Aces and Sevens
Seat 7: hichnick777 folded before Flop (didn't bet)
Seat 8: Jarja25 folded before Flop (didn't bet)
Seat 9: ALIEN999710 showed [9d As] and lost with a pair of Aces


*********** # 88 **************
PokerStars Hand #176672598563: Tournament #2054568934, $20+$2 USD Hold'em No Limit - Level XVI (800/1600) - 2017/10/09 1:23:44 MSK [2017/10/08 18:23:44 ET]
Table '2054568934 506' 9-max Seat #5 is the button
Seat 1: Openshoves85 (46420 in chips)
Seat 2: Patosplayer (26294 in chips)
Seat 3: Santocx (26981 in chips)
Seat 4: balamuc (19969 in chips)
Seat 5: ALLILS (101586 in chips)
Seat 6: EZCoinFlip (133928 in chips)
Seat 7: hichnick777 (31127 in chips)
Seat 8: Jarja25 (38214 in chips)
Seat 9: guirib8ir0 (75818 in chips)
Openshoves85: posts the ante 160
Patosplayer: posts the ante 160
Santocx: posts the ante 160
balamuc: posts the ante 160
ALLILS: posts the ante 160
EZCoinFlip: posts the ante 160
hichnick777: posts the ante 160
Jarja25: posts the ante 160
guirib8ir0: posts the ante 160
EZCoinFlip: posts small blind 800
hichnick777: posts big blind 1600
*** HOLE CARDS ***
Dealt to hichnick777 [6c 9d]
Jarja25: folds
guirib8ir0: folds
Openshoves85: folds
Patosplayer: folds
Santocx: raises 25221 to 26821 and is all-in
balamuc: folds
ALLILS: folds
EZCoinFlip: folds
hichnick777: folds
Uncalled bet (25221) returned to Santocx
Santocx collected 5440 from pot
*** SUMMARY ***
Total pot 5440 | Rake 0
Seat 1: Openshoves85 folded before Flop (didn't bet)
Seat 2: Patosplayer folded before Flop (didn't bet)
Seat 3: Santocx collected (5440)
Seat 4: balamuc folded before Flop (didn't bet)
Seat 5: ALLILS (button) folded before Flop (didn't bet)
Seat 6: EZCoinFlip (small blind) folded before Flop
Seat 7: hichnick777 (big blind) folded before Flop
Seat 8: Jarja25 folded before Flop (didn't bet)
Seat 9: guirib8ir0 folded before Flop (didn't bet)


*********** # 89 **************
PokerStars Hand #176672623146: Tournament #2054568934, $20+$2 USD Hold'em No Limit - Level XVI (800/1600) - 2017/10/09 1:24:20 MSK [2017/10/08 18:24:20 ET]
Table '2054568934 506' 9-max Seat #6 is the button
Seat 1: Openshoves85 (46260 in chips)
Seat 2: Patosplayer (26134 in chips)
Seat 3: Santocx (30661 in chips)
Seat 4: balamuc (19809 in chips)
Seat 5: ALLILS (101426 in chips)
Seat 6: EZCoinFlip (132968 in chips)
Seat 7: hichnick777 (29367 in chips)
Seat 8: Jarja25 (38054 in chips)
Seat 9: guirib8ir0 (75658 in chips)
Openshoves85: posts the ante 160
Patosplayer: posts the ante 160
Santocx: posts the ante 160
balamuc: posts the ante 160
ALLILS: posts the ante 160
EZCoinFlip: posts the ante 160
hichnick777: posts the ante 160
Jarja25: posts the ante 160
guirib8ir0: posts the ante 160
hichnick777: posts small blind 800
Jarja25: posts big blind 1600
*** HOLE CARDS ***
Dealt to hichnick777 [3d 8h]
guirib8ir0: folds
Openshoves85: raises 2400 to 4000
Patosplayer: folds
Santocx: folds
balamuc: folds
ALLILS: raises 8125 to 12125
EZCoinFlip: folds
hichnick777: folds
Jarja25: folds
Openshoves85: folds
Uncalled bet (8125) returned to ALLILS
ALLILS collected 11840 from pot
*** SUMMARY ***
Total pot 11840 | Rake 0
Seat 1: Openshoves85 folded before Flop
Seat 2: Patosplayer folded before Flop (didn't bet)
Seat 3: Santocx folded before Flop (didn't bet)
Seat 4: balamuc folded before Flop (didn't bet)
Seat 5: ALLILS collected (11840)
Seat 6: EZCoinFlip (button) folded before Flop (didn't bet)
Seat 7: hichnick777 (small blind) folded before Flop
Seat 8: Jarja25 (big blind) folded before Flop
Seat 9: guirib8ir0 folded before Flop (didn't bet)


*********** # 90 **************
PokerStars Hand #176672656060: Tournament #2054568934, $20+$2 USD Hold'em No Limit - Level XVI (800/1600) - 2017/10/09 1:25:08 MSK [2017/10/08 18:25:08 ET]
Table '2054568934 506' 9-max Seat #7 is the button
Seat 1: Openshoves85 (42100 in chips)
Seat 2: Patosplayer (25974 in chips)
Seat 3: Santocx (30501 in chips)
Seat 4: balamuc (19649 in chips)
Seat 5: ALLILS (109106 in chips)
Seat 6: EZCoinFlip (132808 in chips)
Seat 7: hichnick777 (28407 in chips)
Seat 8: Jarja25 (36294 in chips)
Seat 9: guirib8ir0 (75498 in chips)
Openshoves85: posts the ante 160
Patosplayer: posts the ante 160
Santocx: posts the ante 160
balamuc: posts the ante 160
ALLILS: posts the ante 160
EZCoinFlip: posts the ante 160
hichnick777: posts the ante 160
Jarja25: posts the ante 160
guirib8ir0: posts the ante 160
Jarja25: posts small blind 800
guirib8ir0: posts big blind 1600
*** HOLE CARDS ***
Dealt to hichnick777 [Kd 4c]
Openshoves85: folds
Patosplayer: folds
Santocx: folds
balamuc: folds
ALLILS: folds
EZCoinFlip: folds
hichnick777: folds
Jarja25: calls 800
guirib8ir0: checks
*** FLOP *** [Ac 6d 9s]
Jarja25: bets 1600
guirib8ir0: calls 1600
*** TURN *** [Ac 6d 9s] [Th]
Jarja25: bets 1600
guirib8ir0: calls 1600
*** RIVER *** [Ac 6d 9s Th] [3s]
Jarja25: bets 3200
guirib8ir0: raises 32000 to 35200
Jarja25: folds
Uncalled bet (32000) returned to guirib8ir0
guirib8ir0 collected 17440 from pot
guirib8ir0: doesn't show hand
*** SUMMARY ***
Total pot 17440 | Rake 0
Board [Ac 6d 9s Th 3s]
Seat 1: Openshoves85 folded before Flop (didn't bet)
Seat 2: Patosplayer folded before Flop (didn't bet)
Seat 3: Santocx folded before Flop (didn't bet)
Seat 4: balamuc folded before Flop (didn't bet)
Seat 5: ALLILS folded before Flop (didn't bet)
Seat 6: EZCoinFlip folded before Flop (didn't bet)
Seat 7: hichnick777 (button) folded before Flop (didn't bet)
Seat 8: Jarja25 (small blind) folded on the River
Seat 9: guirib8ir0 (big blind) collected (17440)


*********** # 91 **************
PokerStars Hand #176672705203: Tournament #2054568934, $20+$2 USD Hold'em No Limit - Level XVI (800/1600) - 2017/10/09 1:26:20 MSK [2017/10/08 18:26:20 ET]
Table '2054568934 506' 9-max Seat #8 is the button
Seat 1: Openshoves85 (41940 in chips)
Seat 2: Patosplayer (25814 in chips)
Seat 3: Santocx (30341 in chips)
Seat 4: balamuc (19489 in chips)
Seat 5: ALLILS (108946 in chips)
Seat 6: EZCoinFlip (132648 in chips)
Seat 7: hichnick777 (28247 in chips)
Seat 8: Jarja25 (28134 in chips)
Seat 9: guirib8ir0 (84778 in chips)
Openshoves85: posts the ante 160
Patosplayer: posts the ante 160
Santocx: posts the ante 160
balamuc: posts the ante 160
ALLILS: posts the ante 160
EZCoinFlip: posts the ante 160
hichnick777: posts the ante 160
Jarja25: posts the ante 160
guirib8ir0: posts the ante 160
guirib8ir0: posts small blind 800
Openshoves85: posts big blind 1600
*** HOLE CARDS ***
Dealt to hichnick777 [2d Ks]
Patosplayer: folds
Santocx: folds
balamuc: folds
ALLILS: folds
EZCoinFlip: folds
hichnick777: folds
Jarja25: folds
guirib8ir0: calls 800
Openshoves85: raises 40180 to 41780 and is all-in
guirib8ir0: folds
Uncalled bet (40180) returned to Openshoves85
Openshoves85 collected 4640 from pot
Openshoves85: doesn't show hand
*** SUMMARY ***
Total pot 4640 | Rake 0
Seat 1: Openshoves85 (big blind) collected (4640)
Seat 2: Patosplayer folded before Flop (didn't bet)
Seat 3: Santocx folded before Flop (didn't bet)
Seat 4: balamuc folded before Flop (didn't bet)
Seat 5: ALLILS folded before Flop (didn't bet)
Seat 6: EZCoinFlip folded before Flop (didn't bet)
Seat 7: hichnick777 folded before Flop (didn't bet)
Seat 8: Jarja25 (button) folded before Flop (didn't bet)
Seat 9: guirib8ir0 (small blind) folded before Flop


*********** # 92 **************
PokerStars Hand #176672720766: Tournament #2054568934, $20+$2 USD Hold'em No Limit - Level XVI (800/1600) - 2017/10/09 1:26:43 MSK [2017/10/08 18:26:43 ET]
Table '2054568934 506' 9-max Seat #9 is the button
Seat 1: Openshoves85 (44820 in chips)
Seat 2: Patosplayer (25654 in chips)
Seat 3: Santocx (30181 in chips)
Seat 4: balamuc (19329 in chips)
Seat 5: ALLILS (108786 in chips)
Seat 6: EZCoinFlip (132488 in chips)
Seat 7: hichnick777 (28087 in chips)
Seat 8: Jarja25 (27974 in chips)
Seat 9: guirib8ir0 (83018 in chips)
Openshoves85: posts the ante 160
Patosplayer: posts the ante 160
Santocx: posts the ante 160
balamuc: posts the ante 160
ALLILS: posts the ante 160
EZCoinFlip: posts the ante 160
hichnick777: posts the ante 160
Jarja25: posts the ante 160
guirib8ir0: posts the ante 160
Openshoves85: posts small blind 800
Patosplayer: posts big blind 1600
*** HOLE CARDS ***
Dealt to hichnick777 [7s 4s]
Santocx: folds
balamuc: folds
ALLILS: raises 1680 to 3280
EZCoinFlip: folds
hichnick777: folds
Jarja25: folds
guirib8ir0: folds
Openshoves85: folds
Patosplayer: folds
Uncalled bet (1680) returned to ALLILS
ALLILS collected 5440 from pot
*** SUMMARY ***
Total pot 5440 | Rake 0
Seat 1: Openshoves85 (small blind) folded before Flop
Seat 2: Patosplayer (big blind) folded before Flop
Seat 3: Santocx folded before Flop (didn't bet)
Seat 4: balamuc folded before Flop (didn't bet)
Seat 5: ALLILS collected (5440)
Seat 6: EZCoinFlip folded before Flop (didn't bet)
Seat 7: hichnick777 folded before Flop (didn't bet)
Seat 8: Jarja25 folded before Flop (didn't bet)
Seat 9: guirib8ir0 (button) folded before Flop (didn't bet)


*********** # 93 **************
PokerStars Hand #176672737394: Tournament #2054568934, $20+$2 USD Hold'em No Limit - Level XVI (800/1600) - 2017/10/09 1:27:08 MSK [2017/10/08 18:27:08 ET]
Table '2054568934 506' 9-max Seat #1 is the button
Seat 1: Openshoves85 (43860 in chips)
Seat 2: Patosplayer (23894 in chips)
Seat 3: Santocx (30021 in chips)
Seat 4: balamuc (19169 in chips)
Seat 5: ALLILS (112466 in chips)
Seat 6: EZCoinFlip (132328 in chips)
Seat 7: hichnick777 (27927 in chips)
Seat 8: Jarja25 (27814 in chips)
Seat 9: guirib8ir0 (82858 in chips)
Openshoves85: posts the ante 160
Patosplayer: posts the ante 160
Santocx: posts the ante 160
balamuc: posts the ante 160
ALLILS: posts the ante 160
EZCoinFlip: posts the ante 160
hichnick777: posts the ante 160
Jarja25: posts the ante 160
guirib8ir0: posts the ante 160
Patosplayer: posts small blind 800
Santocx: posts big blind 1600
*** HOLE CARDS ***
Dealt to hichnick777 [9s 7h]
balamuc: folds
ALLILS: folds
EZCoinFlip: raises 1600 to 3200
hichnick777: folds
Jarja25: folds
guirib8ir0: folds
Openshoves85: folds
Patosplayer: folds
Santocx: calls 1600
*** FLOP *** [As Tc 5h]
Santocx: checks
EZCoinFlip: bets 3506
Santocx: calls 3506
*** TURN *** [As Tc 5h] [Qd]
Santocx: checks
EZCoinFlip: bets 7513
Santocx: calls 7513
*** RIVER *** [As Tc 5h Qd] [Qc]
Santocx: checks
EZCoinFlip: bets 117949 and is all-in
Santocx: calls 15642 and is all-in
Uncalled bet (102307) returned to EZCoinFlip
*** SHOW DOWN ***
EZCoinFlip: shows [Ad Qh] (a full house, Queens full of Aces)
Santocx: shows [Ah 8d] (two pair, Aces and Queens)
EZCoinFlip collected 61962 from pot
Santocx finished the tournament in 1955th place
*** SUMMARY ***
Total pot 61962 | Rake 0
Board [As Tc 5h Qd Qc]
Seat 1: Openshoves85 (button) folded before Flop (didn't bet)
Seat 2: Patosplayer (small blind) folded before Flop
Seat 3: Santocx (big blind) showed [Ah 8d] and lost with two pair, Aces and Queens
Seat 4: balamuc folded before Flop (didn't bet)
Seat 5: ALLILS folded before Flop (didn't bet)
Seat 6: EZCoinFlip showed [Ad Qh] and won (61962) with a full house, Queens full of Aces
Seat 7: hichnick777 folded before Flop (didn't bet)
Seat 8: Jarja25 folded before Flop (didn't bet)
Seat 9: guirib8ir0 folded before Flop (didn't bet)


*********** # 94 **************
PokerStars Hand #176672821065: Tournament #2054568934, $20+$2 USD Hold'em No Limit - Level XVI (800/1600) - 2017/10/09 1:29:12 MSK [2017/10/08 18:29:12 ET]
Table '2054568934 506' 9-max Seat #2 is the button
Seat 1: Openshoves85 (43700 in chips)
Seat 2: Patosplayer (22934 in chips)
Seat 4: balamuc (19009 in chips)
Seat 5: ALLILS (112306 in chips)
Seat 6: EZCoinFlip (164269 in chips)
Seat 7: hichnick777 (27767 in chips)
Seat 8: Jarja25 (27654 in chips)
Seat 9: guirib8ir0 (82698 in chips)
Openshoves85: posts the ante 160
Patosplayer: posts the ante 160
balamuc: posts the ante 160
ALLILS: posts the ante 160
EZCoinFlip: posts the ante 160
hichnick777: posts the ante 160
Jarja25: posts the ante 160
guirib8ir0: posts the ante 160
balamuc: posts small blind 800
ALLILS: posts big blind 1600
*** HOLE CARDS ***
Dealt to hichnick777 [8c As]
EZCoinFlip: folds
hichnick777: folds
Jarja25: folds
guirib8ir0: folds
Openshoves85: folds
Patosplayer: raises 1600 to 3200
balamuc: raises 15649 to 18849 and is all-in
ALLILS: folds
Patosplayer: folds
Uncalled bet (15649) returned to balamuc
balamuc collected 9280 from pot
balamuc: doesn't show hand
*** SUMMARY ***
Total pot 9280 | Rake 0
Seat 1: Openshoves85 folded before Flop (didn't bet)
Seat 2: Patosplayer (button) folded before Flop
Seat 4: balamuc (small blind) collected (9280)
Seat 5: ALLILS (big blind) folded before Flop
Seat 6: EZCoinFlip folded before Flop (didn't bet)
Seat 7: hichnick777 folded before Flop (didn't bet)
Seat 8: Jarja25 folded before Flop (didn't bet)
Seat 9: guirib8ir0 folded before Flop (didn't bet)


*********** # 95 **************
PokerStars Hand #176672841874: Tournament #2054568934, $20+$2 USD Hold'em No Limit - Level XVI (800/1600) - 2017/10/09 1:29:43 MSK [2017/10/08 18:29:43 ET]
Table '2054568934 506' 9-max Seat #4 is the button
Seat 1: Openshoves85 (43540 in chips)
Seat 2: Patosplayer (19574 in chips)
Seat 3: TATAR-10 (39348 in chips)
Seat 4: balamuc (24929 in chips)
Seat 5: ALLILS (110546 in chips)
Seat 6: EZCoinFlip (164109 in chips)
Seat 7: hichnick777 (27607 in chips)
Seat 8: Jarja25 (27494 in chips)
Seat 9: guirib8ir0 (82538 in chips)
Openshoves85: posts the ante 160
Patosplayer: posts the ante 160
TATAR-10: posts the ante 160
balamuc: posts the ante 160
ALLILS: posts the ante 160
EZCoinFlip: posts the ante 160
hichnick777: posts the ante 160
Jarja25: posts the ante 160
guirib8ir0: posts the ante 160
ALLILS: posts small blind 800
EZCoinFlip: posts big blind 1600
*** HOLE CARDS ***
Dealt to hichnick777 [8c 2h]
hichnick777: folds
Jarja25: folds
guirib8ir0: folds
Openshoves85: folds
Patosplayer: folds
TATAR-10: folds
balamuc: calls 1600
ALLILS: calls 800
EZCoinFlip: checks
*** FLOP *** [7h 2d Jh]
ALLILS: checks
EZCoinFlip: checks
balamuc: bets 3200
ALLILS: folds
EZCoinFlip: folds
Uncalled bet (3200) returned to balamuc
balamuc collected 6240 from pot
balamuc: shows [Js]
*** SUMMARY ***
Total pot 6240 | Rake 0
Board [7h 2d Jh]
Seat 1: Openshoves85 folded before Flop (didn't bet)
Seat 2: Patosplayer folded before Flop (didn't bet)
Seat 3: TATAR-10 folded before Flop (didn't bet)
Seat 4: balamuc (button) collected (6240)
Seat 5: ALLILS (small blind) folded on the Flop
Seat 6: EZCoinFlip (big blind) folded on the Flop
Seat 7: hichnick777 folded before Flop (didn't bet)
Seat 8: Jarja25 folded before Flop (didn't bet)
Seat 9: guirib8ir0 folded before Flop (didn't bet)


*********** # 96 **************
PokerStars Hand #176672874834: Tournament #2054568934, $20+$2 USD Hold'em No Limit - Level XVI (800/1600) - 2017/10/09 1:30:32 MSK [2017/10/08 18:30:32 ET]
Table '2054568934 506' 9-max Seat #5 is the button
Seat 1: Openshoves85 (43380 in chips)
Seat 2: Patosplayer (19414 in chips)
Seat 3: TATAR-10 (39188 in chips)
Seat 4: balamuc (29409 in chips)
Seat 5: ALLILS (108786 in chips)
Seat 6: EZCoinFlip (162349 in chips)
Seat 7: hichnick777 (27447 in chips)
Seat 8: Jarja25 (27334 in chips)
Seat 9: guirib8ir0 (82378 in chips)
Openshoves85: posts the ante 160
Patosplayer: posts the ante 160
TATAR-10: posts the ante 160
balamuc: posts the ante 160
ALLILS: posts the ante 160
EZCoinFlip: posts the ante 160
hichnick777: posts the ante 160
Jarja25: posts the ante 160
guirib8ir0: posts the ante 160
EZCoinFlip: posts small blind 800
hichnick777: posts big blind 1600
*** HOLE CARDS ***
Dealt to hichnick777 [7d Th]
Jarja25: folds
guirib8ir0: folds
Openshoves85: folds
Patosplayer: folds
TATAR-10: folds
balamuc: folds
ALLILS: folds
EZCoinFlip: raises 160589 to 162189 and is all-in
hichnick777: folds
Uncalled bet (160589) returned to EZCoinFlip
EZCoinFlip collected 4640 from pot
EZCoinFlip: doesn't show hand
*** SUMMARY ***
Total pot 4640 | Rake 0
Seat 1: Openshoves85 folded before Flop (didn't bet)
Seat 2: Patosplayer folded before Flop (didn't bet)
Seat 3: TATAR-10 folded before Flop (didn't bet)
Seat 4: balamuc folded before Flop (didn't bet)
Seat 5: ALLILS (button) folded before Flop (didn't bet)
Seat 6: EZCoinFlip (small blind) collected (4640)
Seat 7: hichnick777 (big blind) folded before Flop
Seat 8: Jarja25 folded before Flop (didn't bet)
Seat 9: guirib8ir0 folded before Flop (didn't bet)


*********** # 97 **************
PokerStars Hand #176672904854: Tournament #2054568934, $20+$2 USD Hold'em No Limit - Level XVI (800/1600) - 2017/10/09 1:31:16 MSK [2017/10/08 18:31:16 ET]
Table '2054568934 506' 9-max Seat #6 is the button
Seat 1: Openshoves85 (43220 in chips)
Seat 2: Patosplayer (19254 in chips)
Seat 3: TATAR-10 (39028 in chips)
Seat 4: balamuc (29249 in chips)
Seat 5: ALLILS (108626 in chips)
Seat 6: EZCoinFlip (165229 in chips)
Seat 7: hichnick777 (25687 in chips)
Seat 8: Jarja25 (27174 in chips)
Seat 9: guirib8ir0 (82218 in chips)
Openshoves85: posts the ante 160
Patosplayer: posts the ante 160
TATAR-10: posts the ante 160
balamuc: posts the ante 160
ALLILS: posts the ante 160
EZCoinFlip: posts the ante 160
hichnick777: posts the ante 160
Jarja25: posts the ante 160
guirib8ir0: posts the ante 160
hichnick777: posts small blind 800
Jarja25: posts big blind 1600
*** HOLE CARDS ***
Dealt to hichnick777 [4h 9s]
guirib8ir0: folds
Openshoves85: folds
Patosplayer: folds
TATAR-10: raises 1600 to 3200
balamuc: folds
ALLILS: folds
EZCoinFlip: folds
hichnick777: folds
Jarja25: calls 1600
*** FLOP *** [Tc 6d Qc]
Jarja25: checks
TATAR-10: bets 3024
Jarja25: folds
Uncalled bet (3024) returned to TATAR-10
TATAR-10 collected 8640 from pot
TATAR-10: doesn't show hand
*** SUMMARY ***
Total pot 8640 | Rake 0
Board [Tc 6d Qc]
Seat 1: Openshoves85 folded before Flop (didn't bet)
Seat 2: Patosplayer folded before Flop (didn't bet)
Seat 3: TATAR-10 collected (8640)
Seat 4: balamuc folded before Flop (didn't bet)
Seat 5: ALLILS folded before Flop (didn't bet)
Seat 6: EZCoinFlip (button) folded before Flop (didn't bet)
Seat 7: hichnick777 (small blind) folded before Flop
Seat 8: Jarja25 (big blind) folded on the Flop
Seat 9: guirib8ir0 folded before Flop (didn't bet)


*********** # 98 **************
PokerStars Hand #176672936961: Tournament #2054568934, $20+$2 USD Hold'em No Limit - Level XVI (800/1600) - 2017/10/09 1:32:04 MSK [2017/10/08 18:32:04 ET]
Table '2054568934 506' 9-max Seat #7 is the button
Seat 1: Openshoves85 (43060 in chips)
Seat 2: Patosplayer (19094 in chips)
Seat 3: TATAR-10 (44308 in chips)
Seat 4: balamuc (29089 in chips)
Seat 5: ALLILS (108466 in chips)
Seat 6: EZCoinFlip (165069 in chips)
Seat 7: hichnick777 (24727 in chips)
Seat 8: Jarja25 (23814 in chips)
Seat 9: guirib8ir0 (82058 in chips)
Openshoves85: posts the ante 160
Patosplayer: posts the ante 160
TATAR-10: posts the ante 160
balamuc: posts the ante 160
ALLILS: posts the ante 160
EZCoinFlip: posts the ante 160
hichnick777: posts the ante 160
Jarja25: posts the ante 160
guirib8ir0: posts the ante 160
Jarja25: posts small blind 800
guirib8ir0: posts big blind 1600
*** HOLE CARDS ***
Dealt to hichnick777 [3c 8c]
Openshoves85: folds
Patosplayer: folds
TATAR-10: folds
balamuc: folds
ALLILS: raises 1680 to 3280
EZCoinFlip: folds
hichnick777: folds
Jarja25: folds
guirib8ir0: calls 1680
*** FLOP *** [Qh 8s Jc]
guirib8ir0: checks
ALLILS: bets 3520
guirib8ir0: folds
Uncalled bet (3520) returned to ALLILS
ALLILS collected 8800 from pot
*** SUMMARY ***
Total pot 8800 | Rake 0
Board [Qh 8s Jc]
Seat 1: Openshoves85 folded before Flop (didn't bet)
Seat 2: Patosplayer folded before Flop (didn't bet)
Seat 3: TATAR-10 folded before Flop (didn't bet)
Seat 4: balamuc folded before Flop (didn't bet)
Seat 5: ALLILS collected (8800)
Seat 6: EZCoinFlip folded before Flop (didn't bet)
Seat 7: hichnick777 (button) folded before Flop (didn't bet)
Seat 8: Jarja25 (small blind) folded before Flop
Seat 9: guirib8ir0 (big blind) folded on the Flop


*********** # 99 **************
PokerStars Hand #176672974285: Tournament #2054568934, $20+$2 USD Hold'em No Limit - Level XVI (800/1600) - 2017/10/09 1:33:00 MSK [2017/10/08 18:33:00 ET]
Table '2054568934 506' 9-max Seat #8 is the button
Seat 1: Openshoves85 (42900 in chips)
Seat 2: Patosplayer (18934 in chips)
Seat 3: TATAR-10 (44148 in chips)
Seat 4: balamuc (28929 in chips)
Seat 5: ALLILS (113826 in chips)
Seat 6: EZCoinFlip (164909 in chips)
Seat 7: hichnick777 (24567 in chips)
Seat 8: Jarja25 (22854 in chips)
Seat 9: guirib8ir0 (78618 in chips)
Openshoves85: posts the ante 160
Patosplayer: posts the ante 160
TATAR-10: posts the ante 160
balamuc: posts the ante 160
ALLILS: posts the ante 160
EZCoinFlip: posts the ante 160
hichnick777: posts the ante 160
Jarja25: posts the ante 160
guirib8ir0: posts the ante 160
guirib8ir0: posts small blind 800
Openshoves85: posts big blind 1600
*** HOLE CARDS ***
Dealt to hichnick777 [Th Qh]
Patosplayer: raises 1600 to 3200
TATAR-10: folds
balamuc: folds
ALLILS: folds
EZCoinFlip: folds
hichnick777: folds
Jarja25: folds
guirib8ir0: calls 2400
Openshoves85: folds
*** FLOP *** [Qd 7c 6s]
guirib8ir0: checks
Patosplayer: bets 2926
guirib8ir0: raises 17874 to 20800
Patosplayer: folds
Uncalled bet (17874) returned to guirib8ir0
guirib8ir0 collected 15292 from pot
guirib8ir0: doesn't show hand
*** SUMMARY ***
Total pot 15292 | Rake 0
Board [Qd 7c 6s]
Seat 1: Openshoves85 (big blind) folded before Flop
Seat 2: Patosplayer folded on the Flop
Seat 3: TATAR-10 folded before Flop (didn't bet)
Seat 4: balamuc folded before Flop (didn't bet)
Seat 5: ALLILS folded before Flop (didn't bet)
Seat 6: EZCoinFlip folded before Flop (didn't bet)
Seat 7: hichnick777 folded before Flop (didn't bet)
Seat 8: Jarja25 (button) folded before Flop (didn't bet)
Seat 9: guirib8ir0 (small blind) collected (15292)


*********** # 100 **************
PokerStars Hand #176673017547: Tournament #2054568934, $20+$2 USD Hold'em No Limit - Level XVI (800/1600) - 2017/10/09 1:34:04 MSK [2017/10/08 18:34:04 ET]
Table '2054568934 506' 9-max Seat #9 is the button
Seat 1: Openshoves85 (41140 in chips)
Seat 2: Patosplayer (12648 in chips)
Seat 3: TATAR-10 (43988 in chips)
Seat 4: balamuc (28769 in chips)
Seat 5: ALLILS (113666 in chips)
Seat 6: EZCoinFlip (164749 in chips)
Seat 7: hichnick777 (24407 in chips)
Seat 8: Jarja25 (22694 in chips)
Seat 9: guirib8ir0 (87624 in chips)
Openshoves85: posts the ante 160
Patosplayer: posts the ante 160
TATAR-10: posts the ante 160
balamuc: posts the ante 160
ALLILS: posts the ante 160
EZCoinFlip: posts the ante 160
hichnick777: posts the ante 160
Jarja25: posts the ante 160
guirib8ir0: posts the ante 160
Openshoves85: posts small blind 800
Patosplayer: posts big blind 1600
*** HOLE CARDS ***
Dealt to hichnick777 [5d 6d]
TATAR-10: folds
balamuc: folds
ALLILS: folds
EZCoinFlip: folds
hichnick777: folds
Jarja25: folds
guirib8ir0: raises 1600 to 3200
Openshoves85: folds
Patosplayer: calls 1600
*** FLOP *** [Js Td Qs]
Patosplayer: bets 9288 and is all-in
guirib8ir0: calls 9288
*** TURN *** [Js Td Qs] [9c]
*** RIVER *** [Js Td Qs 9c] [9d]
*** SHOW DOWN ***
Patosplayer: shows [5s 7s] (a pair of Nines)
guirib8ir0: shows [3h Ad] (a pair of Nines - Ace kicker)
guirib8ir0 collected 27216 from pot
Patosplayer finished the tournament in 1842nd place
*** SUMMARY ***
Total pot 27216 | Rake 0
Board [Js Td Qs 9c 9d]
Seat 1: Openshoves85 (small blind) folded before Flop
Seat 2: Patosplayer (big blind) showed [5s 7s] and lost with a pair of Nines
Seat 3: TATAR-10 folded before Flop (didn't bet)
Seat 4: balamuc folded before Flop (didn't bet)
Seat 5: ALLILS folded before Flop (didn't bet)
Seat 6: EZCoinFlip folded before Flop (didn't bet)
Seat 7: hichnick777 folded before Flop (didn't bet)
Seat 8: Jarja25 folded before Flop (didn't bet)
Seat 9: guirib8ir0 (button) showed [3h Ad] and won (27216) with a pair of Nines


*********** # 101 **************
PokerStars Hand #176673043296: Tournament #2054568934, $20+$2 USD Hold'em No Limit - Level XVI (800/1600) - 2017/10/09 1:34:43 MSK [2017/10/08 18:34:43 ET]
Table '2054568934 506' 9-max Seat #1 is the button
Seat 1: Openshoves85 (40180 in chips)
Seat 3: TATAR-10 (43828 in chips)
Seat 4: balamuc (28609 in chips)
Seat 5: ALLILS (113506 in chips)
Seat 6: EZCoinFlip (164589 in chips)
Seat 7: hichnick777 (24247 in chips)
Seat 8: Jarja25 (22534 in chips)
Seat 9: guirib8ir0 (102192 in chips)
Openshoves85: posts the ante 160
TATAR-10: posts the ante 160
balamuc: posts the ante 160
ALLILS: posts the ante 160
EZCoinFlip: posts the ante 160
hichnick777: posts the ante 160
Jarja25: posts the ante 160
guirib8ir0: posts the ante 160
TATAR-10: posts small blind 800
balamuc: posts big blind 1600
*** HOLE CARDS ***
Dealt to hichnick777 [8s 8d]
ALLILS: raises 1680 to 3280
EZCoinFlip: folds
hichnick777: calls 3280
Jarja25: folds
guirib8ir0: folds
Openshoves85: calls 3280
TATAR-10: folds
balamuc: calls 1680
*** FLOP *** [Jh Td Qc]
balamuc: checks
ALLILS: checks
hichnick777: checks
Openshoves85: checks
*** TURN *** [Jh Td Qc] [Qh]
balamuc: checks
ALLILS: checks
hichnick777: checks
Openshoves85: bets 3040
balamuc: calls 3040
ALLILS: calls 3040
hichnick777: folds
*** RIVER *** [Jh Td Qc Qh] [7h]
balamuc: checks
ALLILS: bets 107026 and is all-in
Openshoves85: folds
balamuc: folds
Uncalled bet (107026) returned to ALLILS
ALLILS collected 24320 from pot
*** SUMMARY ***
Total pot 24320 | Rake 0
Board [Jh Td Qc Qh 7h]
Seat 1: Openshoves85 (button) folded on the River
Seat 3: TATAR-10 (small blind) folded before Flop
Seat 4: balamuc (big blind) folded on the River
Seat 5: ALLILS collected (24320)
Seat 6: EZCoinFlip folded before Flop (didn't bet)
Seat 7: hichnick777 folded on the Turn
Seat 8: Jarja25 folded before Flop (didn't bet)
Seat 9: guirib8ir0 folded before Flop (didn't bet)


*********** # 102 **************
PokerStars Hand #176673136058: Tournament #2054568934, $20+$2 USD Hold'em No Limit - Level XVII (1000/2000) - 2017/10/09 1:37:02 MSK [2017/10/08 18:37:02 ET]
Table '2054568934 506' 9-max Seat #3 is the button
Seat 1: Openshoves85 (33700 in chips)
Seat 2: jesuismary (123357 in chips)
Seat 3: TATAR-10 (42868 in chips)
Seat 4: balamuc (22129 in chips)
Seat 5: ALLILS (131346 in chips)
Seat 6: EZCoinFlip (164429 in chips)
Seat 7: hichnick777 (20807 in chips)
Seat 8: Jarja25 (22374 in chips)
Seat 9: guirib8ir0 (102032 in chips)
Openshoves85: posts the ante 200
jesuismary: posts the ante 200
TATAR-10: posts the ante 200
balamuc: posts the ante 200
ALLILS: posts the ante 200
EZCoinFlip: posts the ante 200
hichnick777: posts the ante 200
Jarja25: posts the ante 200
guirib8ir0: posts the ante 200
balamuc: posts small blind 1000
ALLILS: posts big blind 2000
*** HOLE CARDS ***
Dealt to hichnick777 [Ks Qc]
EZCoinFlip: folds
hichnick777: raises 18607 to 20607 and is all-in
Jarja25: folds
guirib8ir0: folds
Openshoves85: folds
jesuismary: folds
TATAR-10: folds
balamuc: folds
ALLILS: folds
Uncalled bet (18607) returned to hichnick777
hichnick777 collected 6800 from pot
hichnick777: doesn't show hand
*** SUMMARY ***
Total pot 6800 | Rake 0
Seat 1: Openshoves85 folded before Flop (didn't bet)
Seat 2: jesuismary folded before Flop (didn't bet)
Seat 3: TATAR-10 (button) folded before Flop (didn't bet)
Seat 4: balamuc (small blind) folded before Flop
Seat 5: ALLILS (big blind) folded before Flop
Seat 6: EZCoinFlip folded before Flop (didn't bet)
Seat 7: hichnick777 collected (6800)
Seat 8: Jarja25 folded before Flop (didn't bet)
Seat 9: guirib8ir0 folded before Flop (didn't bet)


*********** # 103 **************
PokerStars Hand #176673156815: Tournament #2054568934, $20+$2 USD Hold'em No Limit - Level XVII (1000/2000) - 2017/10/09 1:37:30 MSK [2017/10/08 18:37:30 ET]
Table '2054568934 506' 9-max Seat #4 is the button
Seat 1: Openshoves85 (33500 in chips)
Seat 2: jesuismary (123157 in chips)
Seat 3: TATAR-10 (42668 in chips)
Seat 4: balamuc (20929 in chips)
Seat 5: ALLILS (129146 in chips)
Seat 6: EZCoinFlip (164229 in chips)
Seat 7: hichnick777 (25407 in chips)
Seat 8: Jarja25 (22174 in chips)
Seat 9: guirib8ir0 (101832 in chips)
Openshoves85: posts the ante 200
jesuismary: posts the ante 200
TATAR-10: posts the ante 200
balamuc: posts the ante 200
ALLILS: posts the ante 200
EZCoinFlip: posts the ante 200
hichnick777: posts the ante 200
Jarja25: posts the ante 200
guirib8ir0: posts the ante 200
ALLILS: posts small blind 1000
EZCoinFlip: posts big blind 2000
*** HOLE CARDS ***
Dealt to hichnick777 [Jd 3h]
hichnick777: folds
Jarja25: folds
guirib8ir0: raises 2000 to 4000
Openshoves85: folds
jesuismary: folds
TATAR-10: folds
balamuc: folds
ALLILS: folds
EZCoinFlip: folds
Uncalled bet (2000) returned to guirib8ir0
guirib8ir0 collected 6800 from pot
guirib8ir0: doesn't show hand
*** SUMMARY ***
Total pot 6800 | Rake 0
Seat 1: Openshoves85 folded before Flop (didn't bet)
Seat 2: jesuismary folded before Flop (didn't bet)
Seat 3: TATAR-10 folded before Flop (didn't bet)
Seat 4: balamuc (button) folded before Flop (didn't bet)
Seat 5: ALLILS (small blind) folded before Flop
Seat 6: EZCoinFlip (big blind) folded before Flop
Seat 7: hichnick777 folded before Flop (didn't bet)
Seat 8: Jarja25 folded before Flop (didn't bet)
Seat 9: guirib8ir0 collected (6800)


*********** # 104 **************
PokerStars Hand #176673174256: Tournament #2054568934, $20+$2 USD Hold'em No Limit - Level XVII (1000/2000) - 2017/10/09 1:37:57 MSK [2017/10/08 18:37:57 ET]
Table '2054568934 506' 9-max Seat #5 is the button
Seat 1: Openshoves85 (33300 in chips)
Seat 2: jesuismary (122957 in chips)
Seat 3: TATAR-10 (42468 in chips)
Seat 4: balamuc (20729 in chips)
Seat 5: ALLILS (127946 in chips)
Seat 6: EZCoinFlip (162029 in chips)
Seat 7: hichnick777 (25207 in chips)
Seat 8: Jarja25 (21974 in chips)
Seat 9: guirib8ir0 (106432 in chips)
Openshoves85: posts the ante 200
jesuismary: posts the ante 200
TATAR-10: posts the ante 200
balamuc: posts the ante 200
ALLILS: posts the ante 200
EZCoinFlip: posts the ante 200
hichnick777: posts the ante 200
Jarja25: posts the ante 200
guirib8ir0: posts the ante 200
EZCoinFlip: posts small blind 1000
hichnick777: posts big blind 2000
*** HOLE CARDS ***
Dealt to hichnick777 [7d 2s]
Jarja25: folds
guirib8ir0: folds
Openshoves85: folds
jesuismary: raises 2000 to 4000
TATAR-10: folds
balamuc: folds
ALLILS: folds
EZCoinFlip: folds
hichnick777: folds
Uncalled bet (2000) returned to jesuismary
jesuismary collected 6800 from pot
jesuismary: doesn't show hand
*** SUMMARY ***
Total pot 6800 | Rake 0
Seat 1: Openshoves85 folded before Flop (didn't bet)
Seat 2: jesuismary collected (6800)
Seat 3: TATAR-10 folded before Flop (didn't bet)
Seat 4: balamuc folded before Flop (didn't bet)
Seat 5: ALLILS (button) folded before Flop (didn't bet)
Seat 6: EZCoinFlip (small blind) folded before Flop
Seat 7: hichnick777 (big blind) folded before Flop
Seat 8: Jarja25 folded before Flop (didn't bet)
Seat 9: guirib8ir0 folded before Flop (didn't bet)


*********** # 105 **************
PokerStars Hand #176673196617: Tournament #2054568934, $20+$2 USD Hold'em No Limit - Level XVII (1000/2000) - 2017/10/09 1:38:31 MSK [2017/10/08 18:38:31 ET]
Table '2054568934 506' 9-max Seat #6 is the button
Seat 1: Openshoves85 (33100 in chips)
Seat 2: jesuismary (127557 in chips)
Seat 3: TATAR-10 (42268 in chips)
Seat 4: balamuc (20529 in chips)
Seat 5: ALLILS (127746 in chips)
Seat 6: EZCoinFlip (160829 in chips)
Seat 7: hichnick777 (23007 in chips)
Seat 8: Jarja25 (21774 in chips)
Seat 9: guirib8ir0 (106232 in chips)
Openshoves85: posts the ante 200
jesuismary: posts the ante 200
TATAR-10: posts the ante 200
balamuc: posts the ante 200
ALLILS: posts the ante 200
EZCoinFlip: posts the ante 200
hichnick777: posts the ante 200
Jarja25: posts the ante 200
guirib8ir0: posts the ante 200
hichnick777: posts small blind 1000
Jarja25: posts big blind 2000
*** HOLE CARDS ***
Dealt to hichnick777 [Qc Qh]
guirib8ir0: folds
Openshoves85: folds
jesuismary: folds
TATAR-10: folds
balamuc: folds
ALLILS: raises 2100 to 4100
EZCoinFlip: raises 7600 to 11700
hichnick777: raises 11106 to 22806
Jarja25: folds
ALLILS: raises 11106 to 33912
EZCoinFlip: folds
hichnick777: calls 1 and is all-in
Uncalled bet (11105) returned to ALLILS
*** FLOP *** [9s Ac 8h]
*** TURN *** [9s Ac 8h] [3s]
*** RIVER *** [9s Ac 8h 3s] [Kc]
*** SHOW DOWN ***
hichnick777: shows [Qc Qh] (a pair of Queens)
ALLILS: shows [Js Jc] (a pair of Jacks)
hichnick777 collected 61114 from pot
*** SUMMARY ***
Total pot 61114 | Rake 0
Board [9s Ac 8h 3s Kc]
Seat 1: Openshoves85 folded before Flop (didn't bet)
Seat 2: jesuismary folded before Flop (didn't bet)
Seat 3: TATAR-10 folded before Flop (didn't bet)
Seat 4: balamuc folded before Flop (didn't bet)
Seat 5: ALLILS showed [Js Jc] and lost with a pair of Jacks
Seat 6: EZCoinFlip (button) folded before Flop
Seat 7: hichnick777 (small blind) showed [Qc Qh] and won (61114) with a pair of Queens
Seat 8: Jarja25 (big blind) folded before Flop
Seat 9: guirib8ir0 folded before Flop (didn't bet)


*********** # 106 **************
PokerStars Hand #176673282600: Tournament #2054568934, $20+$2 USD Hold'em No Limit - Level XVII (1000/2000) - 2017/10/09 1:40:44 MSK [2017/10/08 18:40:44 ET]
Table '2054568934 506' 9-max Seat #7 is the button
Seat 1: Openshoves85 (32900 in chips)
Seat 2: jesuismary (127357 in chips)
Seat 3: TATAR-10 (42068 in chips)
Seat 4: balamuc (20329 in chips)
Seat 5: ALLILS (104739 in chips)
Seat 6: EZCoinFlip (148929 in chips)
Seat 7: hichnick777 (61114 in chips)
Seat 8: Jarja25 (19574 in chips)
Seat 9: guirib8ir0 (106032 in chips)
Openshoves85: posts the ante 200
jesuismary: posts the ante 200
TATAR-10: posts the ante 200
balamuc: posts the ante 200
ALLILS: posts the ante 200
EZCoinFlip: posts the ante 200
hichnick777: posts the ante 200
Jarja25: posts the ante 200
guirib8ir0: posts the ante 200
Jarja25: posts small blind 1000
guirib8ir0: posts big blind 2000
*** HOLE CARDS ***
Dealt to hichnick777 [5c 3d]
Openshoves85: folds
jesuismary: folds
TATAR-10: folds
balamuc: folds
ALLILS: folds
EZCoinFlip: folds
hichnick777: folds
Jarja25: raises 17374 to 19374 and is all-in
guirib8ir0: calls 17374
*** FLOP *** [Kc 8c 3c]
*** TURN *** [Kc 8c 3c] [4c]
*** RIVER *** [Kc 8c 3c 4c] [7h]
*** SHOW DOWN ***
Jarja25: shows [Qs Kh] (a pair of Kings)
guirib8ir0: shows [2d Ah] (high card Ace)
Jarja25 collected 40548 from pot
*** SUMMARY ***
Total pot 40548 | Rake 0
Board [Kc 8c 3c 4c 7h]
Seat 1: Openshoves85 folded before Flop (didn't bet)
Seat 2: jesuismary folded before Flop (didn't bet)
Seat 3: TATAR-10 folded before Flop (didn't bet)
Seat 4: balamuc folded before Flop (didn't bet)
Seat 5: ALLILS folded before Flop (didn't bet)
Seat 6: EZCoinFlip folded before Flop (didn't bet)
Seat 7: hichnick777 (button) folded before Flop (didn't bet)
Seat 8: Jarja25 (small blind) showed [Qs Kh] and won (40548) with a pair of Kings
Seat 9: guirib8ir0 (big blind) showed [2d Ah] and lost with high card Ace


*********** # 107 **************
PokerStars Hand #176673311724: Tournament #2054568934, $20+$2 USD Hold'em No Limit - Level XVII (1000/2000) - 2017/10/09 1:41:28 MSK [2017/10/08 18:41:28 ET]
Table '2054568934 506' 9-max Seat #8 is the button
Seat 1: Openshoves85 (32700 in chips)
Seat 2: jesuismary (127157 in chips)
Seat 3: TATAR-10 (41868 in chips)
Seat 4: balamuc (20129 in chips)
Seat 5: ALLILS (104539 in chips)
Seat 6: EZCoinFlip (148729 in chips)
Seat 7: hichnick777 (60914 in chips)
Seat 8: Jarja25 (40548 in chips)
Seat 9: guirib8ir0 (86458 in chips)
Openshoves85: posts the ante 200
jesuismary: posts the ante 200
TATAR-10: posts the ante 200
balamuc: posts the ante 200
ALLILS: posts the ante 200
EZCoinFlip: posts the ante 200
hichnick777: posts the ante 200
Jarja25: posts the ante 200
guirib8ir0: posts the ante 200
guirib8ir0: posts small blind 1000
Openshoves85: posts big blind 2000
*** HOLE CARDS ***
Dealt to hichnick777 [6s Qs]
jesuismary: folds
TATAR-10: folds
balamuc: folds
ALLILS: folds
EZCoinFlip: folds
hichnick777: raises 2160 to 4160
Jarja25: folds
guirib8ir0: calls 3160
Openshoves85: folds
*** FLOP *** [9c 5s Ah]
guirib8ir0: checks
hichnick777: bets 4000
guirib8ir0: calls 4000
*** TURN *** [9c 5s Ah] [9h]
guirib8ir0: checks
hichnick777: checks
*** RIVER *** [9c 5s Ah 9h] [8d]
guirib8ir0: bets 78098 and is all-in
hichnick777: folds
Uncalled bet (78098) returned to guirib8ir0
guirib8ir0 collected 20120 from pot
guirib8ir0: doesn't show hand
*** SUMMARY ***
Total pot 20120 | Rake 0
Board [9c 5s Ah 9h 8d]
Seat 1: Openshoves85 (big blind) folded before Flop
Seat 2: jesuismary folded before Flop (didn't bet)
Seat 3: TATAR-10 folded before Flop (didn't bet)
Seat 4: balamuc folded before Flop (didn't bet)
Seat 5: ALLILS folded before Flop (didn't bet)
Seat 6: EZCoinFlip folded before Flop (didn't bet)
Seat 7: hichnick777 folded on the River
Seat 8: Jarja25 (button) folded before Flop (didn't bet)
Seat 9: guirib8ir0 (small blind) collected (20120)


*********** # 108 **************
PokerStars Hand #176673378829: Tournament #2054568934, $20+$2 USD Hold'em No Limit - Level XVII (1000/2000) - 2017/10/09 1:43:12 MSK [2017/10/08 18:43:12 ET]
Table '2054568934 506' 9-max Seat #9 is the button
Seat 1: Openshoves85 (30500 in chips)
Seat 2: jesuismary (126957 in chips)
Seat 3: TATAR-10 (41668 in chips)
Seat 4: balamuc (19929 in chips)
Seat 5: ALLILS (104339 in chips)
Seat 6: EZCoinFlip (148529 in chips)
Seat 7: hichnick777 (52554 in chips)
Seat 8: Jarja25 (40348 in chips)
Seat 9: guirib8ir0 (98218 in chips)
Openshoves85: posts the ante 200
jesuismary: posts the ante 200
TATAR-10: posts the ante 200
balamuc: posts the ante 200
ALLILS: posts the ante 200
EZCoinFlip: posts the ante 200
hichnick777: posts the ante 200
Jarja25: posts the ante 200
guirib8ir0: posts the ante 200
Openshoves85: posts small blind 1000
jesuismary: posts big blind 2000
*** HOLE CARDS ***
Dealt to hichnick777 [3h 5c]
TATAR-10: folds
balamuc: folds
ALLILS: folds
EZCoinFlip: folds
hichnick777: folds
Jarja25: folds
guirib8ir0: folds
Openshoves85: raises 28300 to 30300 and is all-in
jesuismary: folds
Uncalled bet (28300) returned to Openshoves85
Openshoves85 collected 5800 from pot
Openshoves85: doesn't show hand
*** SUMMARY ***
Total pot 5800 | Rake 0
Seat 1: Openshoves85 (small blind) collected (5800)
Seat 2: jesuismary (big blind) folded before Flop
Seat 3: TATAR-10 folded before Flop (didn't bet)
Seat 4: balamuc folded before Flop (didn't bet)
Seat 5: ALLILS folded before Flop (didn't bet)
Seat 6: EZCoinFlip folded before Flop (didn't bet)
Seat 7: hichnick777 folded before Flop (didn't bet)
Seat 8: Jarja25 folded before Flop (didn't bet)
Seat 9: guirib8ir0 (button) folded before Flop (didn't bet)


*********** # 109 **************
PokerStars Hand #176673395016: Tournament #2054568934, $20+$2 USD Hold'em No Limit - Level XVII (1000/2000) - 2017/10/09 1:43:38 MSK [2017/10/08 18:43:38 ET]
Table '2054568934 506' 9-max Seat #1 is the button
Seat 1: Openshoves85 (34100 in chips)
Seat 2: jesuismary (124757 in chips)
Seat 3: TATAR-10 (41468 in chips)
Seat 4: balamuc (19729 in chips)
Seat 5: ALLILS (104139 in chips)
Seat 6: EZCoinFlip (148329 in chips)
Seat 7: hichnick777 (52354 in chips)
Seat 8: Jarja25 (40148 in chips)
Seat 9: guirib8ir0 (98018 in chips)
Openshoves85: posts the ante 200
jesuismary: posts the ante 200
TATAR-10: posts the ante 200
balamuc: posts the ante 200
ALLILS: posts the ante 200
EZCoinFlip: posts the ante 200
hichnick777: posts the ante 200
Jarja25: posts the ante 200
guirib8ir0: posts the ante 200
jesuismary: posts small blind 1000
TATAR-10: posts big blind 2000
*** HOLE CARDS ***
Dealt to hichnick777 [8h Ad]
balamuc: folds
ALLILS: raises 2100 to 4100
EZCoinFlip: calls 4100
hichnick777: folds
Jarja25: folds
guirib8ir0: folds
Openshoves85: folds
jesuismary: calls 3100
TATAR-10: folds
*** FLOP *** [9c Th 8d]
jesuismary: checks
ALLILS: bets 9660
EZCoinFlip: calls 9660
jesuismary: calls 9660
*** TURN *** [9c Th 8d] [3c]
jesuismary: checks
ALLILS: bets 18032
EZCoinFlip: calls 18032
jesuismary: folds
*** RIVER *** [9c Th 8d 3c] [5c]
ALLILS: checks
EZCoinFlip: bets 116337 and is all-in
ALLILS: calls 72147 and is all-in
Uncalled bet (44190) returned to EZCoinFlip
*** SHOW DOWN ***
EZCoinFlip: shows [Ah Ac] (a pair of Aces)
ALLILS: shows [Td Ts] (three of a kind, Tens)
ALLILS collected 225438 from pot
*** SUMMARY ***
Total pot 225438 | Rake 0
Board [9c Th 8d 3c 5c]
Seat 1: Openshoves85 (button) folded before Flop (didn't bet)
Seat 2: jesuismary (small blind) folded on the Turn
Seat 3: TATAR-10 (big blind) folded before Flop
Seat 4: balamuc folded before Flop (didn't bet)
Seat 5: ALLILS showed [Td Ts] and won (225438) with three of a kind, Tens
Seat 6: EZCoinFlip showed [Ah Ac] and lost with a pair of Aces
Seat 7: hichnick777 folded before Flop (didn't bet)
Seat 8: Jarja25 folded before Flop (didn't bet)
Seat 9: guirib8ir0 folded before Flop (didn't bet)


*********** # 110 **************
PokerStars Hand #176673480534: Tournament #2054568934, $20+$2 USD Hold'em No Limit - Level XVII (1000/2000) - 2017/10/09 1:45:40 MSK [2017/10/08 18:45:40 ET]
Table '2054568934 506' 9-max Seat #2 is the button
Seat 1: Openshoves85 (33900 in chips)
Seat 2: jesuismary (110797 in chips)
Seat 3: TATAR-10 (39268 in chips)
Seat 4: balamuc (19529 in chips)
Seat 5: ALLILS (225438 in chips)
Seat 6: EZCoinFlip (44190 in chips)
Seat 7: hichnick777 (52154 in chips)
Seat 8: Jarja25 (39948 in chips)
Seat 9: guirib8ir0 (97818 in chips)
Openshoves85: posts the ante 200
jesuismary: posts the ante 200
TATAR-10: posts the ante 200
balamuc: posts the ante 200
ALLILS: posts the ante 200
EZCoinFlip: posts the ante 200
hichnick777: posts the ante 200
Jarja25: posts the ante 200
guirib8ir0: posts the ante 200
TATAR-10: posts small blind 1000
balamuc: posts big blind 2000
*** HOLE CARDS ***
Dealt to hichnick777 [Td 8c]
ALLILS: folds
EZCoinFlip: raises 2000 to 4000
hichnick777: folds
Jarja25: calls 4000
guirib8ir0: folds
Openshoves85: folds
jesuismary: folds
TATAR-10: calls 3000
balamuc: folds
*** FLOP *** [3h 6h 3d]
TATAR-10: checks
EZCoinFlip: checks
Jarja25: bets 8000
TATAR-10: raises 10000 to 18000
EZCoinFlip: raises 21990 to 39990 and is all-in
Jarja25: folds
TATAR-10: calls 17068 and is all-in
Uncalled bet (4922) returned to EZCoinFlip
*** TURN *** [3h 6h 3d] [Qd]
*** RIVER *** [3h 6h 3d Qd] [Tc]
*** SHOW DOWN ***
TATAR-10: shows [7d 7c] (two pair, Sevens and Threes)
EZCoinFlip: shows [6d 6s] (a full house, Sixes full of Threes)
EZCoinFlip collected 93936 from pot
TATAR-10 finished the tournament in 1528th place and received $35.83.
*** SUMMARY ***
Total pot 93936 | Rake 0
Board [3h 6h 3d Qd Tc]
Seat 1: Openshoves85 folded before Flop (didn't bet)
Seat 2: jesuismary (button) folded before Flop (didn't bet)
Seat 3: TATAR-10 (small blind) showed [7d 7c] and lost with two pair, Sevens and Threes
Seat 4: balamuc (big blind) folded before Flop
Seat 5: ALLILS folded before Flop (didn't bet)
Seat 6: EZCoinFlip showed [6d 6s] and won (93936) with a full house, Sixes full of Threes
Seat 7: hichnick777 folded before Flop (didn't bet)
Seat 8: Jarja25 folded on the Flop
Seat 9: guirib8ir0 folded before Flop (didn't bet)


*********** # 111 **************
PokerStars Hand #176673532552: Tournament #2054568934, $20+$2 USD Hold'em No Limit - Level XVII (1000/2000) - 2017/10/09 1:47:02 MSK [2017/10/08 18:47:02 ET]
Table '2054568934 506' 9-max Seat #4 is the button
Seat 1: Openshoves85 (33700 in chips)
Seat 2: jesuismary (110597 in chips)
Seat 4: balamuc (17329 in chips)
Seat 5: ALLILS (225238 in chips)
Seat 6: EZCoinFlip (98858 in chips)
Seat 7: hichnick777 (51954 in chips)
Seat 8: Jarja25 (27748 in chips)
Seat 9: guirib8ir0 (97618 in chips)
Openshoves85: posts the ante 200
jesuismary: posts the ante 200
balamuc: posts the ante 200
ALLILS: posts the ante 200
EZCoinFlip: posts the ante 200
hichnick777: posts the ante 200
Jarja25: posts the ante 200
guirib8ir0: posts the ante 200
ALLILS: posts small blind 1000
EZCoinFlip: posts big blind 2000
*** HOLE CARDS ***
Dealt to hichnick777 [9s 3h]
hichnick777: folds
Jarja25: folds
guirib8ir0: folds
Openshoves85: folds
jesuismary: folds
balamuc: folds
ALLILS: calls 1000
EZCoinFlip: checks
*** FLOP *** [Qc 6d Kc]
ALLILS: bets 2240
EZCoinFlip: calls 2240
*** TURN *** [Qc 6d Kc] [8d]
ALLILS: checks
EZCoinFlip: bets 5838
ALLILS: folds
Uncalled bet (5838) returned to EZCoinFlip
EZCoinFlip collected 10080 from pot
EZCoinFlip: doesn't show hand
*** SUMMARY ***
Total pot 10080 | Rake 0
Board [Qc 6d Kc 8d]
Seat 1: Openshoves85 folded before Flop (didn't bet)
Seat 2: jesuismary folded before Flop (didn't bet)
Seat 4: balamuc (button) folded before Flop (didn't bet)
Seat 5: ALLILS (small blind) folded on the Turn
Seat 6: EZCoinFlip (big blind) collected (10080)
Seat 7: hichnick777 folded before Flop (didn't bet)
Seat 8: Jarja25 folded before Flop (didn't bet)
Seat 9: guirib8ir0 folded before Flop (didn't bet)


*********** # 112 **************
PokerStars Hand #176673572565: Tournament #2054568934, $20+$2 USD Hold'em No Limit - Level XVIII (1200/2400) - 2017/10/09 1:48:05 MSK [2017/10/08 18:48:05 ET]
Table '2054568934 506' 9-max Seat #5 is the button
Seat 1: Openshoves85 (33500 in chips)
Seat 2: jesuismary (110397 in chips)
Seat 3: CaioCapT (63295 in chips)
Seat 4: balamuc (17129 in chips)
Seat 5: ALLILS (220798 in chips)
Seat 6: EZCoinFlip (104498 in chips)
Seat 7: hichnick777 (51754 in chips)
Seat 8: Jarja25 (27548 in chips)
Seat 9: guirib8ir0 (97418 in chips)
Openshoves85: posts the ante 240
jesuismary: posts the ante 240
CaioCapT: posts the ante 240
balamuc: posts the ante 240
ALLILS: posts the ante 240
EZCoinFlip: posts the ante 240
hichnick777: posts the ante 240
Jarja25: posts the ante 240
guirib8ir0: posts the ante 240
EZCoinFlip: posts small blind 1200
hichnick777: posts big blind 2400
*** HOLE CARDS ***
Dealt to hichnick777 [Qh 6c]
Jarja25: calls 2400
guirib8ir0: folds
Openshoves85: folds
jesuismary: folds
CaioCapT: folds
balamuc: folds
ALLILS: folds
EZCoinFlip: calls 1200
hichnick777: checks
*** FLOP *** [6s 6d Jd]
EZCoinFlip: checks
hichnick777: bets 3600
Jarja25: raises 21308 to 24908 and is all-in
EZCoinFlip: folds
hichnick777: calls 21308
*** TURN *** [6s 6d Jd] [3s]
*** RIVER *** [6s 6d Jd 3s] [8s]
*** SHOW DOWN ***
hichnick777: shows [Qh 6c] (three of a kind, Sixes)
Jarja25: shows [As Ah] (two pair, Aces and Sixes)
hichnick777 collected 59176 from pot
Jarja25 finished the tournament in 1478th place and received $35.83.
*** SUMMARY ***
Total pot 59176 | Rake 0
Board [6s 6d Jd 3s 8s]
Seat 1: Openshoves85 folded before Flop (didn't bet)
Seat 2: jesuismary folded before Flop (didn't bet)
Seat 3: CaioCapT folded before Flop (didn't bet)
Seat 4: balamuc folded before Flop (didn't bet)
Seat 5: ALLILS (button) folded before Flop (didn't bet)
Seat 6: EZCoinFlip (small blind) folded on the Flop
Seat 7: hichnick777 (big blind) showed [Qh 6c] and won (59176) with three of a kind, Sixes
Seat 8: Jarja25 showed [As Ah] and lost with two pair, Aces and Sixes
Seat 9: guirib8ir0 folded before Flop (didn't bet)


*********** # 113 **************
PokerStars Hand #176673602542: Tournament #2054568934, $20+$2 USD Hold'em No Limit - Level XVIII (1200/2400) - 2017/10/09 1:48:52 MSK [2017/10/08 18:48:52 ET]
Table '2054568934 506' 9-max Seat #6 is the button
Seat 1: Openshoves85 (33260 in chips)
Seat 2: jesuismary (110157 in chips)
Seat 3: CaioCapT (63055 in chips)
Seat 4: balamuc (16889 in chips)
Seat 5: ALLILS (220558 in chips)
Seat 6: EZCoinFlip (101858 in chips)
Seat 7: hichnick777 (83382 in chips)
Seat 8: serduk138 (6716 in chips) is sitting out
Seat 9: guirib8ir0 (97178 in chips)
Openshoves85: posts the ante 240
jesuismary: posts the ante 240
CaioCapT: posts the ante 240
balamuc: posts the ante 240
ALLILS: posts the ante 240
EZCoinFlip: posts the ante 240
hichnick777: posts the ante 240
serduk138: posts the ante 240
guirib8ir0: posts the ante 240
hichnick777: posts small blind 1200
serduk138: posts big blind 2400
*** HOLE CARDS ***
Dealt to hichnick777 [4d 3d]
guirib8ir0: folds
Openshoves85: raises 30620 to 33020 and is all-in
jesuismary: folds
CaioCapT: folds
balamuc: folds
ALLILS: folds
EZCoinFlip: folds
hichnick777: folds
serduk138: folds
Uncalled bet (30620) returned to Openshoves85
Openshoves85 collected 8160 from pot
Openshoves85: doesn't show hand
*** SUMMARY ***
Total pot 8160 | Rake 0
Seat 1: Openshoves85 collected (8160)
Seat 2: jesuismary folded before Flop (didn't bet)
Seat 3: CaioCapT folded before Flop (didn't bet)
Seat 4: balamuc folded before Flop (didn't bet)
Seat 5: ALLILS folded before Flop (didn't bet)
Seat 6: EZCoinFlip (button) folded before Flop (didn't bet)
Seat 7: hichnick777 (small blind) folded before Flop
Seat 8: serduk138 (big blind) folded before Flop
Seat 9: guirib8ir0 folded before Flop (didn't bet)


*********** # 114 **************
PokerStars Hand #176673618569: Tournament #2054568934, $20+$2 USD Hold'em No Limit - Level XVIII (1200/2400) - 2017/10/09 1:49:17 MSK [2017/10/08 18:49:17 ET]
Table '2054568934 506' 9-max Seat #7 is the button
Seat 1: Openshoves85 (38780 in chips)
Seat 2: jesuismary (109917 in chips)
Seat 3: CaioCapT (62815 in chips)
Seat 4: balamuc (16649 in chips)
Seat 5: ALLILS (220318 in chips)
Seat 6: EZCoinFlip (101618 in chips)
Seat 7: hichnick777 (81942 in chips)
Seat 8: serduk138 (4076 in chips) is sitting out
Seat 9: guirib8ir0 (96938 in chips)
Openshoves85: posts the ante 240
jesuismary: posts the ante 240
CaioCapT: posts the ante 240
balamuc: posts the ante 240
ALLILS: posts the ante 240
EZCoinFlip: posts the ante 240
hichnick777: posts the ante 240
serduk138: posts the ante 240
guirib8ir0: posts the ante 240
serduk138: posts small blind 1200
guirib8ir0: posts big blind 2400
*** HOLE CARDS ***
Dealt to hichnick777 [Jh Qd]
Openshoves85: folds
jesuismary: raises 3072 to 5472
CaioCapT: folds
balamuc: folds
ALLILS: folds
EZCoinFlip: folds
hichnick777: folds
serduk138: folds
guirib8ir0: calls 3072
*** FLOP *** [4h Js Td]
guirib8ir0: checks
jesuismary: bets 6437
guirib8ir0: folds
Uncalled bet (6437) returned to jesuismary
jesuismary collected 14304 from pot
jesuismary: doesn't show hand
*** SUMMARY ***
Total pot 14304 | Rake 0
Board [4h Js Td]
Seat 1: Openshoves85 folded before Flop (didn't bet)
Seat 2: jesuismary collected (14304)
Seat 3: CaioCapT folded before Flop (didn't bet)
Seat 4: balamuc folded before Flop (didn't bet)
Seat 5: ALLILS folded before Flop (didn't bet)
Seat 6: EZCoinFlip folded before Flop (didn't bet)
Seat 7: hichnick777 (button) folded before Flop (didn't bet)
Seat 8: serduk138 (small blind) folded before Flop
Seat 9: guirib8ir0 (big blind) folded on the Flop


*********** # 115 **************
PokerStars Hand #176673656634: Tournament #2054568934, $20+$2 USD Hold'em No Limit - Level XVIII (1200/2400) - 2017/10/09 1:50:18 MSK [2017/10/08 18:50:18 ET]
Table '2054568934 506' 9-max Seat #8 is the button
Seat 1: Openshoves85 (38540 in chips)
Seat 2: jesuismary (118509 in chips)
Seat 3: CaioCapT (62575 in chips)
Seat 4: balamuc (16409 in chips)
Seat 5: ALLILS (220078 in chips)
Seat 6: EZCoinFlip (101378 in chips)
Seat 7: hichnick777 (81702 in chips)
Seat 8: serduk138 (2636 in chips) is sitting out
Seat 9: guirib8ir0 (91226 in chips)
Openshoves85: posts the ante 240
jesuismary: posts the ante 240
CaioCapT: posts the ante 240
balamuc: posts the ante 240
ALLILS: posts the ante 240
EZCoinFlip: posts the ante 240
hichnick777: posts the ante 240
serduk138: posts the ante 240
guirib8ir0: posts the ante 240
guirib8ir0: posts small blind 1200
Openshoves85: posts big blind 2400
*** HOLE CARDS ***
Dealt to hichnick777 [8c 4c]
jesuismary: raises 2400 to 4800
CaioCapT: folds
balamuc: folds
ALLILS: folds
EZCoinFlip: folds
hichnick777: folds
serduk138: folds
guirib8ir0: folds
Openshoves85: calls 2400
*** FLOP *** [9c 7d 7c]
Openshoves85: checks
jesuismary: checks
*** TURN *** [9c 7d 7c] [Kd]
Openshoves85: checks
jesuismary: bets 5000
Openshoves85: raises 28500 to 33500 and is all-in
jesuismary: folds
Uncalled bet (28500) returned to Openshoves85
Openshoves85 collected 22960 from pot
Openshoves85: doesn't show hand
*** SUMMARY ***
Total pot 22960 | Rake 0
Board [9c 7d 7c Kd]
Seat 1: Openshoves85 (big blind) collected (22960)
Seat 2: jesuismary folded on the Turn
Seat 3: CaioCapT folded before Flop (didn't bet)
Seat 4: balamuc folded before Flop (didn't bet)
Seat 5: ALLILS folded before Flop (didn't bet)
Seat 6: EZCoinFlip folded before Flop (didn't bet)
Seat 7: hichnick777 folded before Flop (didn't bet)
Seat 8: serduk138 (button) folded before Flop (didn't bet)
Seat 9: guirib8ir0 (small blind) folded before Flop


*********** # 116 **************
PokerStars Hand #176673687085: Tournament #2054568934, $20+$2 USD Hold'em No Limit - Level XVIII (1200/2400) - 2017/10/09 1:51:07 MSK [2017/10/08 18:51:07 ET]
Table '2054568934 506' 9-max Seat #9 is the button
Seat 1: Openshoves85 (51460 in chips)
Seat 2: jesuismary (108469 in chips)
Seat 3: CaioCapT (62335 in chips)
Seat 4: balamuc (16169 in chips)
Seat 5: ALLILS (219838 in chips)
Seat 6: EZCoinFlip (101138 in chips)
Seat 7: hichnick777 (81462 in chips)
Seat 8: serduk138 (2396 in chips) is sitting out
Seat 9: guirib8ir0 (89786 in chips)
Openshoves85: posts the ante 240
jesuismary: posts the ante 240
CaioCapT: posts the ante 240
balamuc: posts the ante 240
ALLILS: posts the ante 240
EZCoinFlip: posts the ante 240
hichnick777: posts the ante 240
serduk138: posts the ante 240
guirib8ir0: posts the ante 240
Openshoves85: posts small blind 1200
jesuismary: posts big blind 2400
*** HOLE CARDS ***
Dealt to hichnick777 [Ad 9s]
CaioCapT: folds
balamuc: folds
ALLILS: raises 2520 to 4920
EZCoinFlip: folds
hichnick777: folds
serduk138: folds
guirib8ir0: folds
Openshoves85: folds
jesuismary: calls 2520
*** FLOP *** [6s 4h Jc]
jesuismary: checks
ALLILS: checks
*** TURN *** [6s 4h Jc] [8d]
jesuismary: bets 9999
ALLILS: calls 9999
*** RIVER *** [6s 4h Jc 8d] [Th]
jesuismary: bets 25000
ALLILS: calls 25000
*** SHOW DOWN ***
jesuismary: shows [9c 7c] (a straight, Seven to Jack)
ALLILS: mucks hand
jesuismary collected 83198 from pot
*** SUMMARY ***
Total pot 83198 | Rake 0
Board [6s 4h Jc 8d Th]
Seat 1: Openshoves85 (small blind) folded before Flop
Seat 2: jesuismary (big blind) showed [9c 7c] and won (83198) with a straight, Seven to Jack
Seat 3: CaioCapT folded before Flop (didn't bet)
Seat 4: balamuc folded before Flop (didn't bet)
Seat 5: ALLILS mucked [8h 8c]
Seat 6: EZCoinFlip folded before Flop (didn't bet)
Seat 7: hichnick777 folded before Flop (didn't bet)
Seat 8: serduk138 folded before Flop (didn't bet)
Seat 9: guirib8ir0 (button) folded before Flop (didn't bet)


*********** # 117 **************
PokerStars Hand #176673738458: Tournament #2054568934, $20+$2 USD Hold'em No Limit - Level XVIII (1200/2400) - 2017/10/09 1:52:29 MSK [2017/10/08 18:52:29 ET]
Table '2054568934 506' 9-max Seat #1 is the button
Seat 1: Openshoves85 (50020 in chips)
Seat 2: jesuismary (151508 in chips)
Seat 3: CaioCapT (62095 in chips)
Seat 4: balamuc (15929 in chips)
Seat 5: ALLILS (179679 in chips)
Seat 6: EZCoinFlip (100898 in chips)
Seat 7: hichnick777 (81222 in chips)
Seat 8: serduk138 (2156 in chips) is sitting out
Seat 9: guirib8ir0 (89546 in chips)
Openshoves85: posts the ante 240
jesuismary: posts the ante 240
CaioCapT: posts the ante 240
balamuc: posts the ante 240
ALLILS: posts the ante 240
EZCoinFlip: posts the ante 240
hichnick777: posts the ante 240
serduk138: posts the ante 240
guirib8ir0: posts the ante 240
jesuismary: posts small blind 1200
CaioCapT: posts big blind 2400
*** HOLE CARDS ***
Dealt to hichnick777 [2c Th]
balamuc: folds
ALLILS said, "lol"
ALLILS: folds
EZCoinFlip: raises 2400 to 4800
hichnick777: folds
serduk138: folds
guirib8ir0: folds
Openshoves85: folds
jesuismary: folds
CaioCapT: calls 2400
*** FLOP *** [Js 8s 5d]
CaioCapT: checks
EZCoinFlip: bets 4758
CaioCapT: raises 10842 to 15600
EZCoinFlip: folds
Uncalled bet (10842) returned to CaioCapT
CaioCapT collected 22476 from pot
*** SUMMARY ***
Total pot 22476 | Rake 0
Board [Js 8s 5d]
Seat 1: Openshoves85 (button) folded before Flop (didn't bet)
Seat 2: jesuismary (small blind) folded before Flop
Seat 3: CaioCapT (big blind) collected (22476)
Seat 4: balamuc folded before Flop (didn't bet)
Seat 5: ALLILS folded before Flop (didn't bet)
Seat 6: EZCoinFlip folded on the Flop
Seat 7: hichnick777 folded before Flop (didn't bet)
Seat 8: serduk138 folded before Flop (didn't bet)
Seat 9: guirib8ir0 folded before Flop (didn't bet)


*********** # 118 **************
PokerStars Hand #176673797208: Tournament #2054568934, $20+$2 USD Hold'em No Limit - Level XVIII (1200/2400) - 2017/10/09 1:54:06 MSK [2017/10/08 18:54:06 ET]
Table '2054568934 506' 9-max Seat #2 is the button
Seat 1: Openshoves85 (49780 in chips)
Seat 2: jesuismary (150068 in chips)
Seat 3: CaioCapT (74773 in chips)
Seat 4: balamuc (15689 in chips)
Seat 5: ALLILS (179439 in chips)
Seat 6: EZCoinFlip (91100 in chips)
Seat 7: hichnick777 (80982 in chips)
Seat 8: serduk138 (1916 in chips) is sitting out
Seat 9: guirib8ir0 (89306 in chips)
Openshoves85: posts the ante 240
jesuismary: posts the ante 240
CaioCapT: posts the ante 240
balamuc: posts the ante 240
ALLILS: posts the ante 240
EZCoinFlip: posts the ante 240
hichnick777: posts the ante 240
serduk138: posts the ante 240
guirib8ir0: posts the ante 240
CaioCapT: posts small blind 1200
balamuc: posts big blind 2400
*** HOLE CARDS ***
Dealt to hichnick777 [3c 5d]
ALLILS: folds
EZCoinFlip: raises 2400 to 4800
hichnick777: folds
serduk138: folds
guirib8ir0: folds
Openshoves85: folds
jesuismary: folds
CaioCapT: folds
balamuc: calls 2400
*** FLOP *** [7d Th Td]
balamuc: checks
EZCoinFlip: bets 2400
balamuc: calls 2400
*** TURN *** [7d Th Td] [Qd]
balamuc: bets 8249 and is all-in
EZCoinFlip: calls 8249
*** RIVER *** [7d Th Td Qd] [Ks]
*** SHOW DOWN ***
balamuc: shows [6c Tc] (three of a kind, Tens)
EZCoinFlip: shows [Ts Ad] (three of a kind, Tens - Ace kicker)
EZCoinFlip collected 34258 from pot
balamuc finished the tournament in 1321st place and received $41.89.
*** SUMMARY ***
Total pot 34258 | Rake 0
Board [7d Th Td Qd Ks]
Seat 1: Openshoves85 folded before Flop (didn't bet)
Seat 2: jesuismary (button) folded before Flop (didn't bet)
Seat 3: CaioCapT (small blind) folded before Flop
Seat 4: balamuc (big blind) showed [6c Tc] and lost with three of a kind, Tens
Seat 5: ALLILS folded before Flop (didn't bet)
Seat 6: EZCoinFlip showed [Ts Ad] and won (34258) with three of a kind, Tens
Seat 7: hichnick777 folded before Flop (didn't bet)
Seat 8: serduk138 folded before Flop (didn't bet)
Seat 9: guirib8ir0 folded before Flop (didn't bet)


*********** # 119 **************
PokerStars Hand #176673825047: Tournament #2054568934, $20+$2 USD Hold'em No Limit - Level XVIII (1200/2400) - 2017/10/09 1:54:52 MSK [2017/10/08 18:54:52 ET]
Table '2054568934 506' 9-max Seat #3 is the button
Seat 1: Openshoves85 (49540 in chips)
Seat 2: jesuismary (149828 in chips)
Seat 3: CaioCapT (73333 in chips)
Seat 5: ALLILS (179199 in chips)
Seat 6: EZCoinFlip (109669 in chips)
Seat 7: hichnick777 (80742 in chips)
Seat 8: serduk138 (1676 in chips) is sitting out
Seat 9: guirib8ir0 (89066 in chips)
Openshoves85: posts the ante 240
jesuismary: posts the ante 240
CaioCapT: posts the ante 240
ALLILS: posts the ante 240
EZCoinFlip: posts the ante 240
hichnick777: posts the ante 240
serduk138: posts the ante 240
guirib8ir0: posts the ante 240
ALLILS: posts small blind 1200
EZCoinFlip: posts big blind 2400
*** HOLE CARDS ***
Dealt to hichnick777 [Ac 3c]
hichnick777: folds
serduk138: folds
guirib8ir0: folds
Openshoves85: folds
jesuismary: folds
CaioCapT: folds
ALLILS: raises 3600 to 6000
EZCoinFlip: folds
Uncalled bet (3600) returned to ALLILS
ALLILS collected 6720 from pot
*** SUMMARY ***
Total pot 6720 | Rake 0
Seat 1: Openshoves85 folded before Flop (didn't bet)
Seat 2: jesuismary folded before Flop (didn't bet)
Seat 3: CaioCapT (button) folded before Flop (didn't bet)
Seat 5: ALLILS (small blind) collected (6720)
Seat 6: EZCoinFlip (big blind) folded before Flop
Seat 7: hichnick777 folded before Flop (didn't bet)
Seat 8: serduk138 folded before Flop (didn't bet)
Seat 9: guirib8ir0 folded before Flop (didn't bet)


*********** # 120 **************
PokerStars Hand #176674043353: Tournament #2054568934, $20+$2 USD Hold'em No Limit - Level XVIII (1200/2400) - 2017/10/09 2:02:08 MSK [2017/10/08 19:02:08 ET]
Table '2054568934 506' 9-max Seat #5 is the button
Seat 1: Openshoves85 (49300 in chips)
Seat 2: jesuismary (149588 in chips)
Seat 3: CaioCapT (73093 in chips)
Seat 4: weichushy (148931 in chips)
Seat 5: ALLILS (183279 in chips)
Seat 6: EZCoinFlip (107029 in chips)
Seat 7: hichnick777 (80502 in chips)
Seat 8: serduk138 (1436 in chips) is sitting out
Seat 9: guirib8ir0 (88826 in chips)
Openshoves85: posts the ante 240
jesuismary: posts the ante 240
CaioCapT: posts the ante 240
weichushy: posts the ante 240
ALLILS: posts the ante 240
EZCoinFlip: posts the ante 240
hichnick777: posts the ante 240
serduk138: posts the ante 240
guirib8ir0: posts the ante 240
EZCoinFlip: posts small blind 1200
hichnick777: posts big blind 2400
*** HOLE CARDS ***
Dealt to hichnick777 [9s 3c]
serduk138: folds
guirib8ir0: folds
Openshoves85: folds
jesuismary: folds
CaioCapT: folds
weichushy: folds
ALLILS: folds
EZCoinFlip: calls 1200
hichnick777: checks
*** FLOP *** [Kc Th 8s]
EZCoinFlip: bets 2400
hichnick777: folds
Uncalled bet (2400) returned to EZCoinFlip
EZCoinFlip collected 6960 from pot
EZCoinFlip: doesn't show hand
*** SUMMARY ***
Total pot 6960 | Rake 0
Board [Kc Th 8s]
Seat 1: Openshoves85 folded before Flop (didn't bet)
Seat 2: jesuismary folded before Flop (didn't bet)
Seat 3: CaioCapT folded before Flop (didn't bet)
Seat 4: weichushy folded before Flop (didn't bet)
Seat 5: ALLILS (button) folded before Flop (didn't bet)
Seat 6: EZCoinFlip (small blind) collected (6960)
Seat 7: hichnick777 (big blind) folded on the Flop
Seat 8: serduk138 folded before Flop (didn't bet)
Seat 9: guirib8ir0 folded before Flop (didn't bet)


*********** # 121 **************
PokerStars Hand #176674067250: Tournament #2054568934, $20+$2 USD Hold'em No Limit - Level XVIII (1200/2400) - 2017/10/09 2:02:49 MSK [2017/10/08 19:02:49 ET]
Table '2054568934 506' 9-max Seat #6 is the button
Seat 1: Openshoves85 (49060 in chips)
Seat 2: jesuismary (149348 in chips)
Seat 3: CaioCapT (72853 in chips)
Seat 4: weichushy (148691 in chips)
Seat 5: ALLILS (183039 in chips)
Seat 6: EZCoinFlip (111349 in chips)
Seat 7: hichnick777 (77862 in chips)
Seat 8: serduk138 (1196 in chips) is sitting out
Seat 9: guirib8ir0 (88586 in chips)
Openshoves85: posts the ante 240
jesuismary: posts the ante 240
CaioCapT: posts the ante 240
weichushy: posts the ante 240
ALLILS: posts the ante 240
EZCoinFlip: posts the ante 240
hichnick777: posts the ante 240
serduk138: posts the ante 240
guirib8ir0: posts the ante 240
hichnick777: posts small blind 1200
serduk138: posts big blind 956 and is all-in
*** HOLE CARDS ***
Dealt to hichnick777 [5h Qd]
guirib8ir0: folds
Openshoves85: folds
jesuismary: folds
CaioCapT: raises 3600 to 4800
weichushy: folds
ALLILS: raises 7745 to 12545
EZCoinFlip: folds
hichnick777: folds
serduk138: folds
CaioCapT: raises 60068 to 72613 and is all-in
ALLILS: folds
Uncalled bet (60068) returned to CaioCapT
CaioCapT collected 29406 from pot
serduk138 finished the tournament in 1271st place and received $41.89.
*** SUMMARY ***
Total pot 29406 | Rake 0
Seat 1: Openshoves85 folded before Flop (didn't bet)
Seat 2: jesuismary folded before Flop (didn't bet)
Seat 3: CaioCapT collected (29406)
Seat 4: weichushy folded before Flop (didn't bet)
Seat 5: ALLILS folded before Flop
Seat 6: EZCoinFlip (button) folded before Flop (didn't bet)
Seat 7: hichnick777 (small blind) folded before Flop
Seat 8: serduk138 (big blind) folded before Flop
Seat 9: guirib8ir0 folded before Flop (didn't bet)


*********** # 122 **************
PokerStars Hand #176674097894: Tournament #2054568934, $20+$2 USD Hold'em No Limit - Level XVIII (1200/2400) - 2017/10/09 2:03:41 MSK [2017/10/08 19:03:41 ET]
Table '2054568934 506' 9-max Seat #7 is the button
Seat 1: Openshoves85 (48820 in chips)
Seat 2: jesuismary (149108 in chips)
Seat 3: CaioCapT (89474 in chips)
Seat 4: weichushy (148451 in chips)
Seat 5: ALLILS (170254 in chips)
Seat 6: EZCoinFlip (111109 in chips)
Seat 7: hichnick777 (76422 in chips)
Seat 9: guirib8ir0 (88346 in chips)
Openshoves85: posts the ante 240
jesuismary: posts the ante 240
CaioCapT: posts the ante 240
weichushy: posts the ante 240
ALLILS: posts the ante 240
EZCoinFlip: posts the ante 240
hichnick777: posts the ante 240
guirib8ir0: posts the ante 240
guirib8ir0: posts small blind 1200
Openshoves85: posts big blind 2400
*** HOLE CARDS ***
Dealt to hichnick777 [Qd 9h]
jesuismary: folds
CaioCapT: folds
weichushy: folds
ALLILS: folds
EZCoinFlip: raises 2400 to 4800
hichnick777: folds
guirib8ir0: folds
Openshoves85: calls 2400
*** FLOP *** [Jh Jd 9c]
Openshoves85: checks
EZCoinFlip: checks
*** TURN *** [Jh Jd 9c] [6d]
Openshoves85: bets 7200
EZCoinFlip: folds
Uncalled bet (7200) returned to Openshoves85
Openshoves85 collected 12720 from pot
Openshoves85: doesn't show hand
*** SUMMARY ***
Total pot 12720 | Rake 0
Board [Jh Jd 9c 6d]
Seat 1: Openshoves85 (big blind) collected (12720)
Seat 2: jesuismary folded before Flop (didn't bet)
Seat 3: CaioCapT folded before Flop (didn't bet)
Seat 4: weichushy folded before Flop (didn't bet)
Seat 5: ALLILS folded before Flop (didn't bet)
Seat 6: EZCoinFlip folded on the Turn
Seat 7: hichnick777 (button) folded before Flop (didn't bet)
Seat 9: guirib8ir0 (small blind) folded before Flop


*********** # 123 **************
PokerStars Hand #176674132014: Tournament #2054568934, $20+$2 USD Hold'em No Limit - Level XVIII (1200/2400) - 2017/10/09 2:04:39 MSK [2017/10/08 19:04:39 ET]
Table '2054568934 506' 9-max Seat #9 is the button
Seat 1: Openshoves85 (56500 in chips)
Seat 2: jesuismary (148868 in chips)
Seat 3: CaioCapT (89234 in chips)
Seat 4: weichushy (148211 in chips)
Seat 5: ALLILS (170014 in chips)
Seat 6: EZCoinFlip (106069 in chips)
Seat 7: hichnick777 (76182 in chips)
Seat 8: lalalaurens (68341 in chips) is sitting out
Seat 9: guirib8ir0 (86906 in chips)
Openshoves85: posts the ante 240
jesuismary: posts the ante 240
CaioCapT: posts the ante 240
weichushy: posts the ante 240
ALLILS: posts the ante 240
EZCoinFlip: posts the ante 240
hichnick777: posts the ante 240
lalalaurens: posts the ante 240
guirib8ir0: posts the ante 240
Openshoves85: posts small blind 1200
jesuismary: posts big blind 2400
*** HOLE CARDS ***
Dealt to hichnick777 [8d Qs]
CaioCapT: folds
weichushy: folds
ALLILS: folds
EZCoinFlip: folds
hichnick777: folds
lalalaurens: folds
guirib8ir0: raises 2400 to 4800
Openshoves85: folds
jesuismary: calls 2400
*** FLOP *** [9s Jc 2d]
jesuismary: checks
guirib8ir0: bets 4277
jesuismary: calls 4277
*** TURN *** [9s Jc 2d] [Js]
jesuismary: checks
guirib8ir0: checks
*** RIVER *** [9s Jc 2d Js] [8h]
jesuismary: checks
guirib8ir0: checks
*** SHOW DOWN ***
jesuismary: shows [Qd 2c] (two pair, Jacks and Deuces)
guirib8ir0: shows [7c 9h] (two pair, Jacks and Nines)
guirib8ir0 collected 21514 from pot
*** SUMMARY ***
Total pot 21514 | Rake 0
Board [9s Jc 2d Js 8h]
Seat 1: Openshoves85 (small blind) folded before Flop
Seat 2: jesuismary (big blind) showed [Qd 2c] and lost with two pair, Jacks and Deuces
Seat 3: CaioCapT folded before Flop (didn't bet)
Seat 4: weichushy folded before Flop (didn't bet)
Seat 5: ALLILS folded before Flop (didn't bet)
Seat 6: EZCoinFlip folded before Flop (didn't bet)
Seat 7: hichnick777 folded before Flop (didn't bet)
Seat 8: lalalaurens folded before Flop (didn't bet)
Seat 9: guirib8ir0 (button) showed [7c 9h] and won (21514) with two pair, Jacks and Nines


*********** # 124 **************
PokerStars Hand #176674174714: Tournament #2054568934, $20+$2 USD Hold'em No Limit - Level XVIII (1200/2400) - 2017/10/09 2:05:51 MSK [2017/10/08 19:05:51 ET]
Table '2054568934 506' 9-max Seat #1 is the button
Seat 1: Openshoves85 (55060 in chips)
Seat 2: jesuismary (139551 in chips)
Seat 3: CaioCapT (88994 in chips)
Seat 4: weichushy (147971 in chips)
Seat 5: ALLILS (169774 in chips)
Seat 6: EZCoinFlip (105829 in chips)
Seat 7: hichnick777 (75942 in chips)
Seat 8: lalalaurens (68101 in chips) is sitting out
Seat 9: guirib8ir0 (99103 in chips)
Openshoves85: posts the ante 240
jesuismary: posts the ante 240
CaioCapT: posts the ante 240
weichushy: posts the ante 240
ALLILS: posts the ante 240
EZCoinFlip: posts the ante 240
hichnick777: posts the ante 240
lalalaurens: posts the ante 240
guirib8ir0: posts the ante 240
jesuismary: posts small blind 1200
CaioCapT: posts big blind 2400
*** HOLE CARDS ***
Dealt to hichnick777 [8h 2c]
weichushy: folds
ALLILS: folds
EZCoinFlip: folds
hichnick777: folds
lalalaurens: folds
guirib8ir0: raises 2400 to 4800
Openshoves85: folds
jesuismary: folds
CaioCapT: calls 2400
*** FLOP *** [5h 7c As]
CaioCapT: checks
guirib8ir0: bets 5962
CaioCapT: folds
Uncalled bet (5962) returned to guirib8ir0
guirib8ir0 collected 12960 from pot
guirib8ir0: doesn't show hand
*** SUMMARY ***
Total pot 12960 | Rake 0
Board [5h 7c As]
Seat 1: Openshoves85 (button) folded before Flop (didn't bet)
Seat 2: jesuismary (small blind) folded before Flop
Seat 3: CaioCapT (big blind) folded on the Flop
Seat 4: weichushy folded before Flop (didn't bet)
Seat 5: ALLILS folded before Flop (didn't bet)
Seat 6: EZCoinFlip folded before Flop (didn't bet)
Seat 7: hichnick777 folded before Flop (didn't bet)
Seat 8: lalalaurens folded before Flop (didn't bet)
Seat 9: guirib8ir0 collected (12960)


*********** # 125 **************
PokerStars Hand #176674217843: Tournament #2054568934, $20+$2 USD Hold'em No Limit - Level XIX (1400/2800) - 2017/10/09 2:07:05 MSK [2017/10/08 19:07:05 ET]
Table '2054568934 506' 9-max Seat #2 is the button
Seat 1: Openshoves85 (54820 in chips)
Seat 2: jesuismary (138111 in chips)
Seat 3: CaioCapT (83954 in chips)
Seat 4: weichushy (147731 in chips)
Seat 5: ALLILS (169534 in chips)
Seat 6: EZCoinFlip (105589 in chips)
Seat 7: hichnick777 (75702 in chips)
Seat 8: lalalaurens (67861 in chips) is sitting out
Seat 9: guirib8ir0 (107023 in chips)
Openshoves85: posts the ante 280
jesuismary: posts the ante 280
CaioCapT: posts the ante 280
weichushy: posts the ante 280
ALLILS: posts the ante 280
EZCoinFlip: posts the ante 280
hichnick777: posts the ante 280
lalalaurens: posts the ante 280
guirib8ir0: posts the ante 280
CaioCapT: posts small blind 1400
weichushy: posts big blind 2800
*** HOLE CARDS ***
Dealt to hichnick777 [As 5d]
ALLILS: raises 2940 to 5740
EZCoinFlip: folds
hichnick777: folds
lalalaurens: folds
guirib8ir0: folds
Openshoves85: folds
jesuismary: folds
CaioCapT: folds
weichushy: folds
Uncalled bet (2940) returned to ALLILS
ALLILS collected 9520 from pot
*** SUMMARY ***
Total pot 9520 | Rake 0
Seat 1: Openshoves85 folded before Flop (didn't bet)
Seat 2: jesuismary (button) folded before Flop (didn't bet)
Seat 3: CaioCapT (small blind) folded before Flop
Seat 4: weichushy (big blind) folded before Flop
Seat 5: ALLILS collected (9520)
Seat 6: EZCoinFlip folded before Flop (didn't bet)
Seat 7: hichnick777 folded before Flop (didn't bet)
Seat 8: lalalaurens folded before Flop (didn't bet)
Seat 9: guirib8ir0 folded before Flop (didn't bet)


*********** # 126 **************
PokerStars Hand #176674235505: Tournament #2054568934, $20+$2 USD Hold'em No Limit - Level XIX (1400/2800) - 2017/10/09 2:07:35 MSK [2017/10/08 19:07:35 ET]
Table '2054568934 506' 9-max Seat #3 is the button
Seat 1: Openshoves85 (54540 in chips)
Seat 2: jesuismary (137831 in chips)
Seat 3: CaioCapT (82274 in chips)
Seat 4: weichushy (144651 in chips)
Seat 5: ALLILS (175974 in chips)
Seat 6: EZCoinFlip (105309 in chips)
Seat 7: hichnick777 (75422 in chips)
Seat 8: lalalaurens (67581 in chips) is sitting out
Seat 9: guirib8ir0 (106743 in chips)
Openshoves85: posts the ante 280
jesuismary: posts the ante 280
CaioCapT: posts the ante 280
weichushy: posts the ante 280
ALLILS: posts the ante 280
EZCoinFlip: posts the ante 280
hichnick777: posts the ante 280
lalalaurens: posts the ante 280
guirib8ir0: posts the ante 280
weichushy: posts small blind 1400
ALLILS: posts big blind 2800
*** HOLE CARDS ***
Dealt to hichnick777 [9s Th]
EZCoinFlip: folds
hichnick777: folds
lalalaurens: folds
guirib8ir0: raises 2800 to 5600
Openshoves85: folds
jesuismary: folds
lalalaurens has returned
CaioCapT: raises 9800 to 15400
weichushy: raises 128971 to 144371 and is all-in
ALLILS: folds
guirib8ir0: folds
CaioCapT: folds
Uncalled bet (128971) returned to weichushy
weichushy collected 41720 from pot
weichushy: doesn't show hand
*** SUMMARY ***
Total pot 41720 | Rake 0
Seat 1: Openshoves85 folded before Flop (didn't bet)
Seat 2: jesuismary folded before Flop (didn't bet)
Seat 3: CaioCapT (button) folded before Flop
Seat 4: weichushy (small blind) collected (41720)
Seat 5: ALLILS (big blind) folded before Flop
Seat 6: EZCoinFlip folded before Flop (didn't bet)
Seat 7: hichnick777 folded before Flop (didn't bet)
Seat 8: lalalaurens folded before Flop (didn't bet)
Seat 9: guirib8ir0 folded before Flop


*********** # 127 **************
PokerStars Hand #176674268277: Tournament #2054568934, $20+$2 USD Hold'em No Limit - Level XIX (1400/2800) - 2017/10/09 2:08:31 MSK [2017/10/08 19:08:31 ET]
Table '2054568934 506' 9-max Seat #4 is the button
Seat 1: Openshoves85 (54260 in chips)
Seat 2: jesuismary (137551 in chips)
Seat 3: CaioCapT (66594 in chips)
Seat 4: weichushy (170691 in chips)
Seat 5: ALLILS (172894 in chips)
Seat 6: EZCoinFlip (105029 in chips)
Seat 7: hichnick777 (75142 in chips)
Seat 8: lalalaurens (67301 in chips)
Seat 9: guirib8ir0 (100863 in chips)
Openshoves85: posts the ante 280
jesuismary: posts the ante 280
CaioCapT: posts the ante 280
weichushy: posts the ante 280
ALLILS: posts the ante 280
EZCoinFlip: posts the ante 280
hichnick777: posts the ante 280
lalalaurens: posts the ante 280
guirib8ir0: posts the ante 280
ALLILS: posts small blind 1400
EZCoinFlip: posts big blind 2800
*** HOLE CARDS ***
Dealt to hichnick777 [Qs 4h]
hichnick777: folds
lalalaurens: folds
guirib8ir0: folds
Openshoves85: folds
jesuismary: folds
CaioCapT: raises 2800 to 5600
weichushy: folds
ALLILS: folds
EZCoinFlip: calls 2800
*** FLOP *** [4d 2h Ks]
EZCoinFlip: checks
CaioCapT: bets 5140
EZCoinFlip: calls 5140
*** TURN *** [4d 2h Ks] [6h]
EZCoinFlip: checks
CaioCapT: bets 14732
EZCoinFlip: folds
Uncalled bet (14732) returned to CaioCapT
CaioCapT collected 25400 from pot
*** SUMMARY ***
Total pot 25400 | Rake 0
Board [4d 2h Ks 6h]
Seat 1: Openshoves85 folded before Flop (didn't bet)
Seat 2: jesuismary folded before Flop (didn't bet)
Seat 3: CaioCapT collected (25400)
Seat 4: weichushy (button) folded before Flop (didn't bet)
Seat 5: ALLILS (small blind) folded before Flop
Seat 6: EZCoinFlip (big blind) folded on the Turn
Seat 7: hichnick777 folded before Flop (didn't bet)
Seat 8: lalalaurens folded before Flop (didn't bet)
Seat 9: guirib8ir0 folded before Flop (didn't bet)


*********** # 128 **************
PokerStars Hand #176674313876: Tournament #2054568934, $20+$2 USD Hold'em No Limit - Level XIX (1400/2800) - 2017/10/09 2:09:50 MSK [2017/10/08 19:09:50 ET]
Table '2054568934 506' 9-max Seat #5 is the button
Seat 1: Openshoves85 (53980 in chips)
Seat 2: jesuismary (137271 in chips)
Seat 3: CaioCapT (80974 in chips)
Seat 4: weichushy (170411 in chips)
Seat 5: ALLILS (171214 in chips)
Seat 6: EZCoinFlip (94009 in chips)
Seat 7: hichnick777 (74862 in chips)
Seat 8: lalalaurens (67021 in chips)
Seat 9: guirib8ir0 (100583 in chips)
Openshoves85: posts the ante 280
jesuismary: posts the ante 280
CaioCapT: posts the ante 280
weichushy: posts the ante 280
ALLILS: posts the ante 280
EZCoinFlip: posts the ante 280
hichnick777: posts the ante 280
lalalaurens: posts the ante 280
guirib8ir0: posts the ante 280
EZCoinFlip: posts small blind 1400
hichnick777: posts big blind 2800
*** HOLE CARDS ***
Dealt to hichnick777 [7h Qc]
lalalaurens: folds
guirib8ir0: folds
Openshoves85: folds
jesuismary: folds
CaioCapT: folds
weichushy: folds
ALLILS: raises 2940 to 5740
EZCoinFlip: folds
hichnick777: calls 2940
*** FLOP *** [2h Jc 8h]
hichnick777: checks
ALLILS: bets 6750
hichnick777: folds
Uncalled bet (6750) returned to ALLILS
ALLILS collected 15400 from pot
*** SUMMARY ***
Total pot 15400 | Rake 0
Board [2h Jc 8h]
Seat 1: Openshoves85 folded before Flop (didn't bet)
Seat 2: jesuismary folded before Flop (didn't bet)
Seat 3: CaioCapT folded before Flop (didn't bet)
Seat 4: weichushy folded before Flop (didn't bet)
Seat 5: ALLILS (button) collected (15400)
Seat 6: EZCoinFlip (small blind) folded before Flop
Seat 7: hichnick777 (big blind) folded on the Flop
Seat 8: lalalaurens folded before Flop (didn't bet)
Seat 9: guirib8ir0 folded before Flop (didn't bet)


*********** # 129 **************
PokerStars Hand #176674347629: Tournament #2054568934, $20+$2 USD Hold'em No Limit - Level XIX (1400/2800) - 2017/10/09 2:10:49 MSK [2017/10/08 19:10:49 ET]
Table '2054568934 506' 9-max Seat #6 is the button
Seat 1: Openshoves85 (53700 in chips)
Seat 2: jesuismary (136991 in chips)
Seat 3: CaioCapT (80694 in chips)
Seat 4: weichushy (170131 in chips)
Seat 5: ALLILS (180594 in chips)
Seat 6: EZCoinFlip (92329 in chips)
Seat 7: hichnick777 (68842 in chips)
Seat 8: lalalaurens (66741 in chips)
Seat 9: guirib8ir0 (100303 in chips)
Openshoves85: posts the ante 280
jesuismary: posts the ante 280
CaioCapT: posts the ante 280
weichushy: posts the ante 280
ALLILS: posts the ante 280
EZCoinFlip: posts the ante 280
hichnick777: posts the ante 280
lalalaurens: posts the ante 280
guirib8ir0: posts the ante 280
hichnick777: posts small blind 1400
lalalaurens: posts big blind 2800
*** HOLE CARDS ***
Dealt to hichnick777 [6s 2s]
guirib8ir0: folds
Openshoves85: folds
jesuismary: folds
CaioCapT: folds
weichushy: folds
ALLILS: folds
EZCoinFlip: raises 2800 to 5600
hichnick777: folds
lalalaurens: folds
Uncalled bet (2800) returned to EZCoinFlip
EZCoinFlip collected 9520 from pot
EZCoinFlip: doesn't show hand
*** SUMMARY ***
Total pot 9520 | Rake 0
Seat 1: Openshoves85 folded before Flop (didn't bet)
Seat 2: jesuismary folded before Flop (didn't bet)
Seat 3: CaioCapT folded before Flop (didn't bet)
Seat 4: weichushy folded before Flop (didn't bet)
Seat 5: ALLILS folded before Flop (didn't bet)
Seat 6: EZCoinFlip (button) collected (9520)
Seat 7: hichnick777 (small blind) folded before Flop
Seat 8: lalalaurens (big blind) folded before Flop
Seat 9: guirib8ir0 folded before Flop (didn't bet)


*********** # 130 **************
PokerStars Hand #176674381554: Tournament #2054568934, $20+$2 USD Hold'em No Limit - Level XIX (1400/2800) - 2017/10/09 2:11:48 MSK [2017/10/08 19:11:48 ET]
Table '2054568934 506' 9-max Seat #7 is the button
Seat 1: Openshoves85 (53420 in chips)
Seat 2: jesuismary (136711 in chips)
Seat 3: CaioCapT (80414 in chips)
Seat 4: weichushy (169851 in chips)
Seat 5: ALLILS (180314 in chips)
Seat 6: EZCoinFlip (98769 in chips)
Seat 7: hichnick777 (67162 in chips)
Seat 8: lalalaurens (63661 in chips)
Seat 9: guirib8ir0 (100023 in chips)
Openshoves85: posts the ante 280
jesuismary: posts the ante 280
CaioCapT: posts the ante 280
weichushy: posts the ante 280
ALLILS: posts the ante 280
EZCoinFlip: posts the ante 280
hichnick777: posts the ante 280
lalalaurens: posts the ante 280
guirib8ir0: posts the ante 280
lalalaurens: posts small blind 1400
guirib8ir0: posts big blind 2800
*** HOLE CARDS ***
Dealt to hichnick777 [7c 4s]
Openshoves85: folds
jesuismary: folds
CaioCapT: folds
weichushy: raises 3220 to 6020
ALLILS: folds
EZCoinFlip: folds
hichnick777: folds
lalalaurens: folds
guirib8ir0: calls 3220
*** FLOP *** [Ts Qs 3c]
guirib8ir0: checks
weichushy: bets 6703
guirib8ir0: folds
Uncalled bet (6703) returned to weichushy
weichushy collected 15960 from pot
weichushy: doesn't show hand
*** SUMMARY ***
Total pot 15960 | Rake 0
Board [Ts Qs 3c]
Seat 1: Openshoves85 folded before Flop (didn't bet)
Seat 2: jesuismary folded before Flop (didn't bet)
Seat 3: CaioCapT folded before Flop (didn't bet)
Seat 4: weichushy collected (15960)
Seat 5: ALLILS folded before Flop (didn't bet)
Seat 6: EZCoinFlip folded before Flop (didn't bet)
Seat 7: hichnick777 (button) folded before Flop (didn't bet)
Seat 8: lalalaurens (small blind) folded before Flop
Seat 9: guirib8ir0 (big blind) folded on the Flop


*********** # 131 **************
PokerStars Hand #176674423295: Tournament #2054568934, $20+$2 USD Hold'em No Limit - Level XIX (1400/2800) - 2017/10/09 2:13:02 MSK [2017/10/08 19:13:02 ET]
Table '2054568934 506' 9-max Seat #8 is the button
Seat 1: Openshoves85 (53140 in chips)
Seat 2: jesuismary (136431 in chips)
Seat 3: CaioCapT (80134 in chips)
Seat 4: weichushy (179511 in chips)
Seat 5: ALLILS (180034 in chips)
Seat 6: EZCoinFlip (98489 in chips)
Seat 7: hichnick777 (66882 in chips)
Seat 8: lalalaurens (61981 in chips)
Seat 9: guirib8ir0 (93723 in chips)
Openshoves85: posts the ante 280
jesuismary: posts the ante 280
CaioCapT: posts the ante 280
weichushy: posts the ante 280
ALLILS: posts the ante 280
EZCoinFlip: posts the ante 280
hichnick777: posts the ante 280
lalalaurens: posts the ante 280
guirib8ir0: posts the ante 280
guirib8ir0: posts small blind 1400
Openshoves85: posts big blind 2800
*** HOLE CARDS ***
Dealt to hichnick777 [4s 4c]
jesuismary: folds
CaioCapT: raises 2800 to 5600
weichushy: raises 9800 to 15400
ALLILS: folds
EZCoinFlip: folds
hichnick777: folds
lalalaurens: folds
guirib8ir0: folds
Openshoves85: folds
CaioCapT: folds
Uncalled bet (9800) returned to weichushy
weichushy collected 17920 from pot
weichushy: doesn't show hand
*** SUMMARY ***
Total pot 17920 | Rake 0
Seat 1: Openshoves85 (big blind) folded before Flop
Seat 2: jesuismary folded before Flop (didn't bet)
Seat 3: CaioCapT folded before Flop
Seat 4: weichushy collected (17920)
Seat 5: ALLILS folded before Flop (didn't bet)
Seat 6: EZCoinFlip folded before Flop (didn't bet)
Seat 7: hichnick777 folded before Flop (didn't bet)
Seat 8: lalalaurens (button) folded before Flop (didn't bet)
Seat 9: guirib8ir0 (small blind) folded before Flop


*********** # 132 **************
PokerStars Hand #176674451891: Tournament #2054568934, $20+$2 USD Hold'em No Limit - Level XIX (1400/2800) - 2017/10/09 2:13:53 MSK [2017/10/08 19:13:53 ET]
Table '2054568934 506' 9-max Seat #9 is the button
Seat 1: Openshoves85 (50060 in chips)
Seat 2: jesuismary (136151 in chips)
Seat 3: CaioCapT (74254 in chips)
Seat 4: weichushy (191551 in chips)
Seat 5: ALLILS (179754 in chips)
Seat 6: EZCoinFlip (98209 in chips)
Seat 7: hichnick777 (66602 in chips)
Seat 8: lalalaurens (61701 in chips)
Seat 9: guirib8ir0 (92043 in chips)
Openshoves85: posts the ante 280
jesuismary: posts the ante 280
CaioCapT: posts the ante 280
weichushy: posts the ante 280
ALLILS: posts the ante 280
EZCoinFlip: posts the ante 280
hichnick777: posts the ante 280
lalalaurens: posts the ante 280
guirib8ir0: posts the ante 280
Openshoves85: posts small blind 1400
jesuismary: posts big blind 2800
*** HOLE CARDS ***
Dealt to hichnick777 [6d Qs]
CaioCapT: folds
weichushy: folds
ALLILS: folds
EZCoinFlip: folds
hichnick777: folds
lalalaurens: folds
guirib8ir0: folds
Openshoves85: raises 46980 to 49780 and is all-in
jesuismary: folds
Uncalled bet (46980) returned to Openshoves85
Openshoves85 collected 8120 from pot
Openshoves85: doesn't show hand
*** SUMMARY ***
Total pot 8120 | Rake 0
Seat 1: Openshoves85 (small blind) collected (8120)
Seat 2: jesuismary (big blind) folded before Flop
Seat 3: CaioCapT folded before Flop (didn't bet)
Seat 4: weichushy folded before Flop (didn't bet)
Seat 5: ALLILS folded before Flop (didn't bet)
Seat 6: EZCoinFlip folded before Flop (didn't bet)
Seat 7: hichnick777 folded before Flop (didn't bet)
Seat 8: lalalaurens folded before Flop (didn't bet)
Seat 9: guirib8ir0 (button) folded before Flop (didn't bet)


*********** # 133 **************
PokerStars Hand #176674466395: Tournament #2054568934, $20+$2 USD Hold'em No Limit - Level XIX (1400/2800) - 2017/10/09 2:14:18 MSK [2017/10/08 19:14:18 ET]
Table '2054568934 506' 9-max Seat #1 is the button
Seat 1: Openshoves85 (55100 in chips)
Seat 2: jesuismary (133071 in chips)
Seat 3: CaioCapT (73974 in chips)
Seat 4: weichushy (191271 in chips)
Seat 5: ALLILS (179474 in chips)
Seat 6: EZCoinFlip (97929 in chips)
Seat 7: hichnick777 (66322 in chips)
Seat 8: lalalaurens (61421 in chips)
Seat 9: guirib8ir0 (91763 in chips)
Openshoves85: posts the ante 280
jesuismary: posts the ante 280
CaioCapT: posts the ante 280
weichushy: posts the ante 280
ALLILS: posts the ante 280
EZCoinFlip: posts the ante 280
hichnick777: posts the ante 280
lalalaurens: posts the ante 280
guirib8ir0: posts the ante 280
jesuismary: posts small blind 1400
CaioCapT: posts big blind 2800
*** HOLE CARDS ***
Dealt to hichnick777 [9h 4d]
weichushy: folds
ALLILS: folds
EZCoinFlip: folds
hichnick777: folds
lalalaurens: folds
guirib8ir0: folds
Openshoves85: raises 3080 to 5880
jesuismary: folds
CaioCapT: folds
Uncalled bet (3080) returned to Openshoves85
Openshoves85 collected 9520 from pot
Openshoves85: doesn't show hand
*** SUMMARY ***
Total pot 9520 | Rake 0
Seat 1: Openshoves85 (button) collected (9520)
Seat 2: jesuismary (small blind) folded before Flop
Seat 3: CaioCapT (big blind) folded before Flop
Seat 4: weichushy folded before Flop (didn't bet)
Seat 5: ALLILS folded before Flop (didn't bet)
Seat 6: EZCoinFlip folded before Flop (didn't bet)
Seat 7: hichnick777 folded before Flop (didn't bet)
Seat 8: lalalaurens folded before Flop (didn't bet)
Seat 9: guirib8ir0 folded before Flop (didn't bet)


*********** # 134 **************
PokerStars Hand #176674497231: Tournament #2054568934, $20+$2 USD Hold'em No Limit - Level XIX (1400/2800) - 2017/10/09 2:15:13 MSK [2017/10/08 19:15:13 ET]
Table '2054568934 506' 9-max Seat #2 is the button
Seat 1: Openshoves85 (61540 in chips)
Seat 2: jesuismary (131391 in chips)
Seat 3: CaioCapT (70894 in chips)
Seat 4: weichushy (190991 in chips)
Seat 5: ALLILS (179194 in chips)
Seat 6: EZCoinFlip (97649 in chips)
Seat 7: hichnick777 (66042 in chips)
Seat 8: lalalaurens (61141 in chips)
Seat 9: guirib8ir0 (91483 in chips)
Openshoves85: posts the ante 280
jesuismary: posts the ante 280
CaioCapT: posts the ante 280
weichushy: posts the ante 280
ALLILS: posts the ante 280
EZCoinFlip: posts the ante 280
hichnick777: posts the ante 280
lalalaurens: posts the ante 280
guirib8ir0: posts the ante 280
CaioCapT: posts small blind 1400
weichushy: posts big blind 2800
*** HOLE CARDS ***
Dealt to hichnick777 [Qd Qh]
ALLILS: raises 2940 to 5740
EZCoinFlip: folds
hichnick777: calls 5740
lalalaurens: calls 5740
guirib8ir0: folds
Openshoves85: raises 55520 to 61260 and is all-in
jesuismary: folds
CaioCapT: folds
weichushy: folds
ALLILS: folds
hichnick777: raises 4502 to 65762 and is all-in
lalalaurens: folds
Uncalled bet (4502) returned to hichnick777
*** FLOP *** [Tc 4d 2d]
*** TURN *** [Tc 4d 2d] [Ks]
*** RIVER *** [Tc 4d 2d Ks] [Ah]
*** SHOW DOWN ***
hichnick777: shows [Qd Qh] (a pair of Queens)
Openshoves85: shows [6h 6d] (a pair of Sixes)
hichnick777 collected 140720 from pot
Openshoves85 finished the tournament in 1022nd place and received $48.97.
*** SUMMARY ***
Total pot 140720 | Rake 0
Board [Tc 4d 2d Ks Ah]
Seat 1: Openshoves85 showed [6h 6d] and lost with a pair of Sixes
Seat 2: jesuismary (button) folded before Flop (didn't bet)
Seat 3: CaioCapT (small blind) folded before Flop
Seat 4: weichushy (big blind) folded before Flop
Seat 5: ALLILS folded before Flop
Seat 6: EZCoinFlip folded before Flop (didn't bet)
Seat 7: hichnick777 showed [Qd Qh] and won (140720) with a pair of Queens
Seat 8: lalalaurens folded before Flop
Seat 9: guirib8ir0 folded before Flop (didn't bet)


*********** # 135 **************
PokerStars Hand #176674529685: Tournament #2054568934, $20+$2 USD Hold'em No Limit - Level XIX (1400/2800) - 2017/10/09 2:16:10 MSK [2017/10/08 19:16:10 ET]
Table '2054568934 506' 9-max Seat #3 is the button
Seat 2: jesuismary (131111 in chips)
Seat 3: CaioCapT (69214 in chips)
Seat 4: weichushy (187911 in chips)
Seat 5: ALLILS (173174 in chips)
Seat 6: EZCoinFlip (97369 in chips)
Seat 7: hichnick777 (145222 in chips)
Seat 8: lalalaurens (55121 in chips)
Seat 9: guirib8ir0 (91203 in chips)
jesuismary: posts the ante 280
CaioCapT: posts the ante 280
weichushy: posts the ante 280
ALLILS: posts the ante 280
EZCoinFlip: posts the ante 280
hichnick777: posts the ante 280
lalalaurens: posts the ante 280
guirib8ir0: posts the ante 280
weichushy: posts small blind 1400
ALLILS: posts big blind 2800
*** HOLE CARDS ***
Dealt to hichnick777 [Qh Jc]
EZCoinFlip: folds
hichnick777: raises 3500 to 6300
lalalaurens: folds
guirib8ir0: folds
jesuismary: folds
CaioCapT: folds
weichushy: folds
ALLILS: calls 3500
*** FLOP *** [4c Kc As]
ALLILS: checks
hichnick777: bets 5359
ALLILS: folds
Uncalled bet (5359) returned to hichnick777
hichnick777 collected 16240 from pot
hichnick777: doesn't show hand
*** SUMMARY ***
Total pot 16240 | Rake 0
Board [4c Kc As]
Seat 2: jesuismary folded before Flop (didn't bet)
Seat 3: CaioCapT (button) folded before Flop (didn't bet)
Seat 4: weichushy (small blind) folded before Flop
Seat 5: ALLILS (big blind) folded on the Flop
Seat 6: EZCoinFlip folded before Flop (didn't bet)
Seat 7: hichnick777 collected (16240)
Seat 8: lalalaurens folded before Flop (didn't bet)
Seat 9: guirib8ir0 folded before Flop (didn't bet)


*********** # 136 **************
PokerStars Hand #176674563018: Tournament #2054568934, $20+$2 USD Hold'em No Limit - Level XIX (1400/2800) - 2017/10/09 2:17:10 MSK [2017/10/08 19:17:10 ET]
Table '2054568934 506' 9-max Seat #4 is the button
Seat 1: zozitimo (99232 in chips)
Seat 2: jesuismary (130831 in chips)
Seat 3: CaioCapT (68934 in chips)
Seat 4: weichushy (186231 in chips)
Seat 5: ALLILS (166594 in chips)
Seat 6: EZCoinFlip (97089 in chips)
Seat 7: hichnick777 (154882 in chips)
Seat 8: lalalaurens (54841 in chips)
Seat 9: guirib8ir0 (90923 in chips)
zozitimo: posts the ante 280
jesuismary: posts the ante 280
CaioCapT: posts the ante 280
weichushy: posts the ante 280
ALLILS: posts the ante 280
EZCoinFlip: posts the ante 280
hichnick777: posts the ante 280
lalalaurens: posts the ante 280
guirib8ir0: posts the ante 280
ALLILS: posts small blind 1400
EZCoinFlip: posts big blind 2800
*** HOLE CARDS ***
Dealt to hichnick777 [Qc Js]
hichnick777: raises 3500 to 6300
lalalaurens: folds
guirib8ir0: folds
zozitimo: folds
jesuismary: raises 15100 to 21400
CaioCapT: folds
weichushy: folds
ALLILS: folds
EZCoinFlip: folds
hichnick777: folds
Uncalled bet (15100) returned to jesuismary
jesuismary collected 19320 from pot
jesuismary: doesn't show hand
*** SUMMARY ***
Total pot 19320 | Rake 0
Seat 1: zozitimo folded before Flop (didn't bet)
Seat 2: jesuismary collected (19320)
Seat 3: CaioCapT folded before Flop (didn't bet)
Seat 4: weichushy (button) folded before Flop (didn't bet)
Seat 5: ALLILS (small blind) folded before Flop
Seat 6: EZCoinFlip (big blind) folded before Flop
Seat 7: hichnick777 folded before Flop
Seat 8: lalalaurens folded before Flop (didn't bet)
Seat 9: guirib8ir0 folded before Flop (didn't bet)


*********** # 137 **************
PokerStars Hand #176674599330: Tournament #2054568934, $20+$2 USD Hold'em No Limit - Level XIX (1400/2800) - 2017/10/09 2:18:11 MSK [2017/10/08 19:18:11 ET]
Table '2054568934 506' 9-max Seat #5 is the button
Seat 1: zozitimo (98952 in chips)
Seat 2: jesuismary (143571 in chips)
Seat 3: CaioCapT (68654 in chips)
Seat 4: weichushy (185951 in chips)
Seat 5: ALLILS (164914 in chips)
Seat 6: EZCoinFlip (94009 in chips)
Seat 7: hichnick777 (148302 in chips)
Seat 8: lalalaurens (54561 in chips)
Seat 9: guirib8ir0 (90643 in chips)
zozitimo: posts the ante 280
jesuismary: posts the ante 280
CaioCapT: posts the ante 280
weichushy: posts the ante 280
ALLILS: posts the ante 280
EZCoinFlip: posts the ante 280
hichnick777: posts the ante 280
lalalaurens: posts the ante 280
guirib8ir0: posts the ante 280
EZCoinFlip: posts small blind 1400
hichnick777: posts big blind 2800
*** HOLE CARDS ***
Dealt to hichnick777 [3c 3d]
lalalaurens: folds
guirib8ir0: folds
zozitimo: folds
jesuismary: folds
CaioCapT: raises 2800 to 5600
weichushy: folds
ALLILS: folds
EZCoinFlip: folds
hichnick777: calls 2800
*** FLOP *** [Ac 8c 2s]
hichnick777: checks
CaioCapT: bets 4200
hichnick777: calls 4200
*** TURN *** [Ac 8c 2s] [6c]
hichnick777: checks
CaioCapT: checks
*** RIVER *** [Ac 8c 2s 6c] [5d]
hichnick777: checks
CaioCapT: checks
*** SHOW DOWN ***
hichnick777: shows [3c 3d] (a pair of Threes)
CaioCapT: mucks hand
hichnick777 collected 23520 from pot
*** SUMMARY ***
Total pot 23520 | Rake 0
Board [Ac 8c 2s 6c 5d]
Seat 1: zozitimo folded before Flop (didn't bet)
Seat 2: jesuismary folded before Flop (didn't bet)
Seat 3: CaioCapT mucked [Jd Ks]
Seat 4: weichushy folded before Flop (didn't bet)
Seat 5: ALLILS (button) folded before Flop (didn't bet)
Seat 6: EZCoinFlip (small blind) folded before Flop
Seat 7: hichnick777 (big blind) showed [3c 3d] and won (23520) with a pair of Threes
Seat 8: lalalaurens folded before Flop (didn't bet)
Seat 9: guirib8ir0 folded before Flop (didn't bet)


*********** # 138 **************
PokerStars Hand #176674662374: Tournament #2054568934, $20+$2 USD Hold'em No Limit - Level XX (1600/3200) - 2017/10/09 2:20:04 MSK [2017/10/08 19:20:04 ET]
Table '2054568934 506' 9-max Seat #6 is the button
Seat 1: zozitimo (98672 in chips)
Seat 2: jesuismary (143291 in chips)
Seat 3: CaioCapT (58574 in chips)
Seat 4: weichushy (185671 in chips)
Seat 5: ALLILS (164634 in chips)
Seat 6: EZCoinFlip (92329 in chips)
Seat 7: hichnick777 (161742 in chips)
Seat 8: lalalaurens (54281 in chips)
Seat 9: guirib8ir0 (90363 in chips)
zozitimo: posts the ante 320
jesuismary: posts the ante 320
CaioCapT: posts the ante 320
weichushy: posts the ante 320
ALLILS: posts the ante 320
EZCoinFlip: posts the ante 320
hichnick777: posts the ante 320
lalalaurens: posts the ante 320
guirib8ir0: posts the ante 320
hichnick777: posts small blind 1600
lalalaurens: posts big blind 3200
*** HOLE CARDS ***
Dealt to hichnick777 [Ks Qs]
guirib8ir0: folds
zozitimo: folds
jesuismary: folds
CaioCapT: folds
weichushy: raises 3680 to 6880
ALLILS: folds
EZCoinFlip: folds
hichnick777: raises 12320 to 19200
lalalaurens: folds
weichushy: folds
Uncalled bet (12320) returned to hichnick777
hichnick777 collected 19840 from pot
hichnick777: doesn't show hand
*** SUMMARY ***
Total pot 19840 | Rake 0
Seat 1: zozitimo folded before Flop (didn't bet)
Seat 2: jesuismary folded before Flop (didn't bet)
Seat 3: CaioCapT folded before Flop (didn't bet)
Seat 4: weichushy folded before Flop
Seat 5: ALLILS folded before Flop (didn't bet)
Seat 6: EZCoinFlip (button) folded before Flop (didn't bet)
Seat 7: hichnick777 (small blind) collected (19840)
Seat 8: lalalaurens (big blind) folded before Flop
Seat 9: guirib8ir0 folded before Flop (didn't bet)


*********** # 139 **************
PokerStars Hand #176674700455: Tournament #2054568934, $20+$2 USD Hold'em No Limit - Level XX (1600/3200) - 2017/10/09 2:21:13 MSK [2017/10/08 19:21:13 ET]
Table '2054568934 506' 9-max Seat #7 is the button
Seat 1: zozitimo (98352 in chips)
Seat 2: jesuismary (142971 in chips)
Seat 3: CaioCapT (58254 in chips)
Seat 4: weichushy (178471 in chips)
Seat 5: ALLILS (164314 in chips)
Seat 6: EZCoinFlip (92009 in chips)
Seat 7: hichnick777 (174382 in chips)
Seat 8: lalalaurens (50761 in chips)
Seat 9: guirib8ir0 (90043 in chips)
zozitimo: posts the ante 320
jesuismary: posts the ante 320
CaioCapT: posts the ante 320
weichushy: posts the ante 320
ALLILS: posts the ante 320
EZCoinFlip: posts the ante 320
hichnick777: posts the ante 320
lalalaurens: posts the ante 320
guirib8ir0: posts the ante 320
lalalaurens: posts small blind 1600
guirib8ir0: posts big blind 3200
*** HOLE CARDS ***
Dealt to hichnick777 [Ks 3s]
zozitimo: raises 4000 to 7200
jesuismary: folds
CaioCapT: folds
weichushy: folds
ALLILS: folds
EZCoinFlip: folds
hichnick777: folds
lalalaurens: folds
guirib8ir0: calls 4000
*** FLOP *** [8c 5d 2h]
guirib8ir0: checks
zozitimo: checks
*** TURN *** [8c 5d 2h] [9s]
guirib8ir0: checks
zozitimo: bets 9600
guirib8ir0: calls 9600
*** RIVER *** [8c 5d 2h 9s] [4c]
guirib8ir0: checks
zozitimo: checks
*** SHOW DOWN ***
guirib8ir0: shows [Tc 9c] (a pair of Nines)
zozitimo: mucks hand
guirib8ir0 collected 38080 from pot
*** SUMMARY ***
Total pot 38080 | Rake 0
Board [8c 5d 2h 9s 4c]
Seat 1: zozitimo mucked [Qc Js]
Seat 2: jesuismary folded before Flop (didn't bet)
Seat 3: CaioCapT folded before Flop (didn't bet)
Seat 4: weichushy folded before Flop (didn't bet)
Seat 5: ALLILS folded before Flop (didn't bet)
Seat 6: EZCoinFlip folded before Flop (didn't bet)
Seat 7: hichnick777 (button) folded before Flop (didn't bet)
Seat 8: lalalaurens (small blind) folded before Flop
Seat 9: guirib8ir0 (big blind) showed [Tc 9c] and won (38080) with a pair of Nines


*********** # 140 **************
PokerStars Hand #176674742341: Tournament #2054568934, $20+$2 USD Hold'em No Limit - Level XX (1600/3200) - 2017/10/09 2:22:29 MSK [2017/10/08 19:22:29 ET]
Table '2054568934 506' 9-max Seat #8 is the button
Seat 1: zozitimo (81232 in chips)
Seat 2: jesuismary (142651 in chips)
Seat 3: CaioCapT (57934 in chips)
Seat 4: weichushy (178151 in chips)
Seat 5: ALLILS (163994 in chips)
Seat 6: EZCoinFlip (91689 in chips)
Seat 7: hichnick777 (174062 in chips)
Seat 8: lalalaurens (48841 in chips)
Seat 9: guirib8ir0 (111003 in chips)
zozitimo: posts the ante 320
jesuismary: posts the ante 320
CaioCapT: posts the ante 320
weichushy: posts the ante 320
ALLILS: posts the ante 320
EZCoinFlip: posts the ante 320
hichnick777: posts the ante 320
lalalaurens: posts the ante 320
guirib8ir0: posts the ante 320
guirib8ir0: posts small blind 1600
zozitimo: posts big blind 3200
*** HOLE CARDS ***
Dealt to hichnick777 [7c Ts]
jesuismary: raises 3200 to 6400
CaioCapT: folds
weichushy: folds
ALLILS: folds
EZCoinFlip: calls 6400
hichnick777: folds
lalalaurens: folds
guirib8ir0: folds
zozitimo: folds
*** FLOP *** [6c Ks As]
jesuismary: bets 6349
EZCoinFlip: calls 6349
*** TURN *** [6c Ks As] [6s]
jesuismary: bets 13230
EZCoinFlip: calls 13230
*** RIVER *** [6c Ks As 6s] [8s]
jesuismary: checks
EZCoinFlip: checks
*** SHOW DOWN ***
jesuismary: shows [Kd Ac] (two pair, Aces and Kings)
EZCoinFlip: mucks hand
jesuismary collected 59638 from pot
*** SUMMARY ***
Total pot 59638 | Rake 0
Board [6c Ks As 6s 8s]
Seat 1: zozitimo (big blind) folded before Flop
Seat 2: jesuismary showed [Kd Ac] and won (59638) with two pair, Aces and Kings
Seat 3: CaioCapT folded before Flop (didn't bet)
Seat 4: weichushy folded before Flop (didn't bet)
Seat 5: ALLILS folded before Flop (didn't bet)
Seat 6: EZCoinFlip mucked [Qc Ad]
Seat 7: hichnick777 folded before Flop (didn't bet)
Seat 8: lalalaurens (button) folded before Flop (didn't bet)
Seat 9: guirib8ir0 (small blind) folded before Flop


*********** # 141 **************
PokerStars Hand #176674781118: Tournament #2054568934, $20+$2 USD Hold'em No Limit - Level XX (1600/3200) - 2017/10/09 2:23:40 MSK [2017/10/08 19:23:40 ET]
Table '2054568934 506' 9-max Seat #9 is the button
Seat 1: zozitimo (77712 in chips)
Seat 2: jesuismary (175990 in chips)
Seat 3: CaioCapT (57614 in chips)
Seat 4: weichushy (177831 in chips)
Seat 5: ALLILS (163674 in chips)
Seat 6: EZCoinFlip (65390 in chips)
Seat 7: hichnick777 (173742 in chips)
Seat 8: lalalaurens (48521 in chips)
Seat 9: guirib8ir0 (109083 in chips)
zozitimo: posts the ante 320
jesuismary: posts the ante 320
CaioCapT: posts the ante 320
weichushy: posts the ante 320
ALLILS: posts the ante 320
EZCoinFlip: posts the ante 320
hichnick777: posts the ante 320
lalalaurens: posts the ante 320
guirib8ir0: posts the ante 320
zozitimo: posts small blind 1600
jesuismary: posts big blind 3200
*** HOLE CARDS ***
Dealt to hichnick777 [8c Ad]
CaioCapT: folds
weichushy: folds
ALLILS: folds
EZCoinFlip: folds
hichnick777: folds
lalalaurens: folds
guirib8ir0: raises 3200 to 6400
zozitimo: raises 70992 to 77392 and is all-in
jesuismary: folds
guirib8ir0: folds
Uncalled bet (70992) returned to zozitimo
zozitimo collected 18880 from pot
*** SUMMARY ***
Total pot 18880 | Rake 0
Seat 1: zozitimo (small blind) collected (18880)
Seat 2: jesuismary (big blind) folded before Flop
Seat 3: CaioCapT folded before Flop (didn't bet)
Seat 4: weichushy folded before Flop (didn't bet)
Seat 5: ALLILS folded before Flop (didn't bet)
Seat 6: EZCoinFlip folded before Flop (didn't bet)
Seat 7: hichnick777 folded before Flop (didn't bet)
Seat 8: lalalaurens folded before Flop (didn't bet)
Seat 9: guirib8ir0 (button) folded before Flop


*********** # 142 **************
PokerStars Hand #176674801538: Tournament #2054568934, $20+$2 USD Hold'em No Limit - Level XX (1600/3200) - 2017/10/09 2:24:18 MSK [2017/10/08 19:24:18 ET]
Table '2054568934 506' 9-max Seat #1 is the button
Seat 1: zozitimo (89872 in chips)
Seat 2: jesuismary (172470 in chips)
Seat 3: CaioCapT (57294 in chips)
Seat 4: weichushy (177511 in chips)
Seat 5: ALLILS (163354 in chips)
Seat 6: EZCoinFlip (65070 in chips)
Seat 7: hichnick777 (173422 in chips)
Seat 8: lalalaurens (48201 in chips)
Seat 9: guirib8ir0 (102363 in chips)
zozitimo: posts the ante 320
jesuismary: posts the ante 320
CaioCapT: posts the ante 320
weichushy: posts the ante 320
ALLILS: posts the ante 320
EZCoinFlip: posts the ante 320
hichnick777: posts the ante 320
lalalaurens: posts the ante 320
guirib8ir0: posts the ante 320
jesuismary: posts small blind 1600
CaioCapT: posts big blind 3200
*** HOLE CARDS ***
Dealt to hichnick777 [Qc 3c]
weichushy: raises 3680 to 6880
ALLILS: folds
EZCoinFlip: folds
hichnick777: folds
lalalaurens: folds
guirib8ir0: calls 6880
zozitimo: folds
jesuismary: folds
CaioCapT: calls 3680
*** FLOP *** [3s 7c 7h]
CaioCapT: checks
weichushy: bets 10550
guirib8ir0: folds
CaioCapT: folds
Uncalled bet (10550) returned to weichushy
weichushy collected 25120 from pot
weichushy: doesn't show hand
*** SUMMARY ***
Total pot 25120 | Rake 0
Board [3s 7c 7h]
Seat 1: zozitimo (button) folded before Flop (didn't bet)
Seat 2: jesuismary (small blind) folded before Flop
Seat 3: CaioCapT (big blind) folded on the Flop
Seat 4: weichushy collected (25120)
Seat 5: ALLILS folded before Flop (didn't bet)
Seat 6: EZCoinFlip folded before Flop (didn't bet)
Seat 7: hichnick777 folded before Flop (didn't bet)
Seat 8: lalalaurens folded before Flop (didn't bet)
Seat 9: guirib8ir0 folded on the Flop


*********** # 143 **************
PokerStars Hand #176674845278: Tournament #2054568934, $20+$2 USD Hold'em No Limit - Level XX (1600/3200) - 2017/10/09 2:25:39 MSK [2017/10/08 19:25:39 ET]
Table '2054568934 506' 9-max Seat #2 is the button
Seat 1: zozitimo (89552 in chips)
Seat 2: jesuismary (170550 in chips)
Seat 3: CaioCapT (50094 in chips)
Seat 4: weichushy (195431 in chips)
Seat 5: ALLILS (163034 in chips)
Seat 6: EZCoinFlip (64750 in chips)
Seat 7: hichnick777 (173102 in chips)
Seat 8: lalalaurens (47881 in chips)
Seat 9: guirib8ir0 (95163 in chips)
zozitimo: posts the ante 320
jesuismary: posts the ante 320
CaioCapT: posts the ante 320
weichushy: posts the ante 320
ALLILS: posts the ante 320
EZCoinFlip: posts the ante 320
hichnick777: posts the ante 320
lalalaurens: posts the ante 320
guirib8ir0: posts the ante 320
CaioCapT: posts small blind 1600
weichushy: posts big blind 3200
*** HOLE CARDS ***
Dealt to hichnick777 [4h 8c]
ALLILS: folds
EZCoinFlip: folds
hichnick777: folds
lalalaurens: folds
guirib8ir0: raises 3200 to 6400
zozitimo: folds
jesuismary: folds
CaioCapT: folds
weichushy: folds
Uncalled bet (3200) returned to guirib8ir0
guirib8ir0 collected 10880 from pot
guirib8ir0: doesn't show hand
*** SUMMARY ***
Total pot 10880 | Rake 0
Seat 1: zozitimo folded before Flop (didn't bet)
Seat 2: jesuismary (button) folded before Flop (didn't bet)
Seat 3: CaioCapT (small blind) folded before Flop
Seat 4: weichushy (big blind) folded before Flop
Seat 5: ALLILS folded before Flop (didn't bet)
Seat 6: EZCoinFlip folded before Flop (didn't bet)
Seat 7: hichnick777 folded before Flop (didn't bet)
Seat 8: lalalaurens folded before Flop (didn't bet)
Seat 9: guirib8ir0 collected (10880)


*********** # 144 **************
PokerStars Hand #176674869109: Tournament #2054568934, $20+$2 USD Hold'em No Limit - Level XX (1600/3200) - 2017/10/09 2:26:16 MSK [2017/10/08 19:26:16 ET]
Table '2054568934 506' 9-max Seat #3 is the button
Seat 1: zozitimo (89232 in chips)
Seat 2: jesuismary (170230 in chips)
Seat 3: CaioCapT (48174 in chips)
Seat 4: weichushy (191911 in chips)
Seat 5: ALLILS (162714 in chips)
Seat 6: EZCoinFlip (64430 in chips)
Seat 7: hichnick777 (172782 in chips)
Seat 8: lalalaurens (47561 in chips)
Seat 9: guirib8ir0 (102523 in chips)
zozitimo: posts the ante 320
jesuismary: posts the ante 320
CaioCapT: posts the ante 320
weichushy: posts the ante 320
ALLILS: posts the ante 320
EZCoinFlip: posts the ante 320
hichnick777: posts the ante 320
lalalaurens: posts the ante 320
guirib8ir0: posts the ante 320
weichushy: posts small blind 1600
ALLILS: posts big blind 3200
*** HOLE CARDS ***
Dealt to hichnick777 [9h Ac]
EZCoinFlip: folds
hichnick777: folds
lalalaurens: raises 3200 to 6400
guirib8ir0: folds
zozitimo: folds
jesuismary: folds
CaioCapT: folds
weichushy: folds
ALLILS: calls 3200
*** FLOP *** [5h 2d 3c]
ALLILS: checks
lalalaurens: bets 9600
ALLILS: raises 146394 to 155994 and is all-in
lalalaurens: calls 31241 and is all-in
Uncalled bet (115153) returned to ALLILS
*** TURN *** [5h 2d 3c] [9d]
*** RIVER *** [5h 2d 3c 9d] [Ah]
*** SHOW DOWN ***
ALLILS: shows [Js As] (a pair of Aces)
lalalaurens: shows [6c 8c] (high card Ace)
ALLILS collected 98962 from pot
lalalaurens finished the tournament in 850th place and received $48.97.
*** SUMMARY ***
Total pot 98962 | Rake 0
Board [5h 2d 3c 9d Ah]
Seat 1: zozitimo folded before Flop (didn't bet)
Seat 2: jesuismary folded before Flop (didn't bet)
Seat 3: CaioCapT (button) folded before Flop (didn't bet)
Seat 4: weichushy (small blind) folded before Flop
Seat 5: ALLILS (big blind) showed [Js As] and won (98962) with a pair of Aces
Seat 6: EZCoinFlip folded before Flop (didn't bet)
Seat 7: hichnick777 folded before Flop (didn't bet)
Seat 8: lalalaurens showed [6c 8c] and lost with high card Ace
Seat 9: guirib8ir0 folded before Flop (didn't bet)


*********** # 145 **************
PokerStars Hand #176674906128: Tournament #2054568934, $20+$2 USD Hold'em No Limit - Level XX (1600/3200) - 2017/10/09 2:27:25 MSK [2017/10/08 19:27:25 ET]
Table '2054568934 506' 9-max Seat #4 is the button
Seat 1: zozitimo (88912 in chips)
Seat 2: jesuismary (169910 in chips)
Seat 3: CaioCapT (47854 in chips)
Seat 4: weichushy (189991 in chips)
Seat 5: ALLILS (214115 in chips)
Seat 6: EZCoinFlip (64110 in chips)
Seat 7: hichnick777 (172462 in chips)
Seat 9: guirib8ir0 (102203 in chips)
zozitimo: posts the ante 320
jesuismary: posts the ante 320
CaioCapT: posts the ante 320
weichushy: posts the ante 320
ALLILS: posts the ante 320
EZCoinFlip: posts the ante 320
hichnick777: posts the ante 320
guirib8ir0: posts the ante 320
ALLILS: posts small blind 1600
EZCoinFlip: posts big blind 3200
*** HOLE CARDS ***
Dealt to hichnick777 [Kh Qc]
hichnick777: raises 4000 to 7200
guirib8ir0: folds
zozitimo: folds
jesuismary: folds
CaioCapT: folds
weichushy: folds
ALLILS: folds
EZCoinFlip: raises 56590 to 63790 and is all-in
hichnick777: folds
Uncalled bet (56590) returned to EZCoinFlip
EZCoinFlip collected 18560 from pot
EZCoinFlip: doesn't show hand
*** SUMMARY ***
Total pot 18560 | Rake 0
Seat 1: zozitimo folded before Flop (didn't bet)
Seat 2: jesuismary folded before Flop (didn't bet)
Seat 3: CaioCapT folded before Flop (didn't bet)
Seat 4: weichushy (button) folded before Flop (didn't bet)
Seat 5: ALLILS (small blind) folded before Flop
Seat 6: EZCoinFlip (big blind) collected (18560)
Seat 7: hichnick777 folded before Flop
Seat 9: guirib8ir0 folded before Flop (didn't bet)


*********** # 146 **************
PokerStars Hand #176674923676: Tournament #2054568934, $20+$2 USD Hold'em No Limit - Level XX (1600/3200) - 2017/10/09 2:27:58 MSK [2017/10/08 19:27:58 ET]
Table '2054568934 506' 9-max Seat #5 is the button
Seat 1: zozitimo (88592 in chips)
Seat 2: jesuismary (169590 in chips)
Seat 3: CaioCapT (47534 in chips)
Seat 4: weichushy (189671 in chips)
Seat 5: ALLILS (212195 in chips)
Seat 6: EZCoinFlip (75150 in chips)
Seat 7: hichnick777 (164942 in chips)
Seat 8: Kepalas89 (26856 in chips)
Seat 9: guirib8ir0 (101883 in chips)
zozitimo: posts the ante 320
jesuismary: posts the ante 320
CaioCapT: posts the ante 320
weichushy: posts the ante 320
ALLILS: posts the ante 320
EZCoinFlip: posts the ante 320
hichnick777: posts the ante 320
Kepalas89: posts the ante 320
guirib8ir0: posts the ante 320
EZCoinFlip: posts small blind 1600
hichnick777: posts big blind 3200
*** HOLE CARDS ***
Dealt to hichnick777 [Ks 9s]
Kepalas89: folds
guirib8ir0: folds
zozitimo: folds
jesuismary: raises 3200 to 6400
CaioCapT: folds
weichushy: folds
ALLILS: folds
EZCoinFlip: folds
hichnick777: calls 3200
*** FLOP *** [Jc Qc 7c]
hichnick777: checks
jesuismary: bets 5357
hichnick777: folds
Uncalled bet (5357) returned to jesuismary
jesuismary collected 17280 from pot
jesuismary: doesn't show hand
*** SUMMARY ***
Total pot 17280 | Rake 0
Board [Jc Qc 7c]
Seat 1: zozitimo folded before Flop (didn't bet)
Seat 2: jesuismary collected (17280)
Seat 3: CaioCapT folded before Flop (didn't bet)
Seat 4: weichushy folded before Flop (didn't bet)
Seat 5: ALLILS (button) folded before Flop (didn't bet)
Seat 6: EZCoinFlip (small blind) folded before Flop
Seat 7: hichnick777 (big blind) folded on the Flop
Seat 8: Kepalas89 folded before Flop (didn't bet)
Seat 9: guirib8ir0 folded before Flop (didn't bet)


*********** # 147 **************
PokerStars Hand #176674961989: Tournament #2054568934, $20+$2 USD Hold'em No Limit - Level XX (1600/3200) - 2017/10/09 2:29:10 MSK [2017/10/08 19:29:10 ET]
Table '2054568934 506' 9-max Seat #6 is the button
Seat 1: zozitimo (88272 in chips)
Seat 2: jesuismary (180150 in chips)
Seat 3: CaioCapT (47214 in chips)
Seat 4: weichushy (189351 in chips)
Seat 5: ALLILS (211875 in chips)
Seat 6: EZCoinFlip (73230 in chips)
Seat 7: hichnick777 (158222 in chips)
Seat 8: Kepalas89 (26536 in chips)
Seat 9: guirib8ir0 (101563 in chips)
zozitimo: posts the ante 320
jesuismary: posts the ante 320
CaioCapT: posts the ante 320
weichushy: posts the ante 320
ALLILS: posts the ante 320
EZCoinFlip: posts the ante 320
hichnick777: posts the ante 320
Kepalas89: posts the ante 320
guirib8ir0: posts the ante 320
hichnick777: posts small blind 1600
Kepalas89: posts big blind 3200
*** HOLE CARDS ***
Dealt to hichnick777 [8d 8c]
guirib8ir0: raises 3200 to 6400
zozitimo: folds
jesuismary: folds
CaioCapT: folds
weichushy: folds
ALLILS: folds
EZCoinFlip: folds
hichnick777: calls 4800
Kepalas89: folds
*** FLOP *** [6s 3d Kc]
hichnick777: checks
guirib8ir0: bets 6230
hichnick777: calls 6230
*** TURN *** [6s 3d Kc] [9d]
hichnick777: checks
guirib8ir0: checks
*** RIVER *** [6s 3d Kc 9d] [Qc]
hichnick777: checks
guirib8ir0: checks
*** SHOW DOWN ***
hichnick777: shows [8d 8c] (a pair of Eights)
guirib8ir0: mucks hand
hichnick777 collected 31340 from pot
*** SUMMARY ***
Total pot 31340 | Rake 0
Board [6s 3d Kc 9d Qc]
Seat 1: zozitimo folded before Flop (didn't bet)
Seat 2: jesuismary folded before Flop (didn't bet)
Seat 3: CaioCapT folded before Flop (didn't bet)
Seat 4: weichushy folded before Flop (didn't bet)
Seat 5: ALLILS folded before Flop (didn't bet)
Seat 6: EZCoinFlip (button) folded before Flop (didn't bet)
Seat 7: hichnick777 (small blind) showed [8d 8c] and won (31340) with a pair of Eights
Seat 8: Kepalas89 (big blind) folded before Flop
Seat 9: guirib8ir0 mucked [Ac Ts]


*********** # 148 **************
PokerStars Hand #176675005629: Tournament #2054568934, $20+$2 USD Hold'em No Limit - Level XXI (1800/3600) - 2017/10/09 2:30:33 MSK [2017/10/08 19:30:33 ET]
Table '2054568934 506' 9-max Seat #7 is the button
Seat 1: zozitimo (87952 in chips)
Seat 2: jesuismary (179830 in chips)
Seat 3: CaioCapT (46894 in chips)
Seat 4: weichushy (189031 in chips)
Seat 5: ALLILS (211555 in chips)
Seat 6: EZCoinFlip (72910 in chips)
Seat 7: hichnick777 (176612 in chips)
Seat 8: Kepalas89 (23016 in chips)
Seat 9: guirib8ir0 (88613 in chips)
zozitimo: posts the ante 360
jesuismary: posts the ante 360
CaioCapT: posts the ante 360
weichushy: posts the ante 360
ALLILS: posts the ante 360
EZCoinFlip: posts the ante 360
hichnick777: posts the ante 360
Kepalas89: posts the ante 360
guirib8ir0: posts the ante 360
Kepalas89: posts small blind 1800
guirib8ir0: posts big blind 3600
*** HOLE CARDS ***
Dealt to hichnick777 [2d 9h]
zozitimo: folds
jesuismary: folds
CaioCapT: folds
weichushy: folds
ALLILS: folds
EZCoinFlip: folds
hichnick777: folds
Kepalas89: raises 19056 to 22656 and is all-in
guirib8ir0: calls 19056
*** FLOP *** [4s 2c 6c]
*** TURN *** [4s 2c 6c] [9s]
*** RIVER *** [4s 2c 6c 9s] [Ah]
*** SHOW DOWN ***
Kepalas89: shows [Tc 7d] (high card Ace)
guirib8ir0: shows [Qh Ks] (high card Ace - King kicker)
guirib8ir0 collected 48552 from pot
Kepalas89 finished the tournament in 806th place and received $48.97.
*** SUMMARY ***
Total pot 48552 | Rake 0
Board [4s 2c 6c 9s Ah]
Seat 1: zozitimo folded before Flop (didn't bet)
Seat 2: jesuismary folded before Flop (didn't bet)
Seat 3: CaioCapT folded before Flop (didn't bet)
Seat 4: weichushy folded before Flop (didn't bet)
Seat 5: ALLILS folded before Flop (didn't bet)
Seat 6: EZCoinFlip folded before Flop (didn't bet)
Seat 7: hichnick777 (button) folded before Flop (didn't bet)
Seat 8: Kepalas89 (small blind) showed [Tc 7d] and lost with high card Ace
Seat 9: guirib8ir0 (big blind) showed [Qh Ks] and won (48552) with high card Ace


*********** # 149 **************
PokerStars Hand #176675027561: Tournament #2054568934, $20+$2 USD Hold'em No Limit - Level XXI (1800/3600) - 2017/10/09 2:31:14 MSK [2017/10/08 19:31:14 ET]
Table '2054568934 506' 9-max Seat #9 is the button
Seat 1: zozitimo (87592 in chips)
Seat 2: jesuismary (179470 in chips)
Seat 3: CaioCapT (46534 in chips)
Seat 4: weichushy (188671 in chips)
Seat 5: ALLILS (211195 in chips)
Seat 6: EZCoinFlip (72550 in chips)
Seat 7: hichnick777 (176252 in chips)
Seat 9: guirib8ir0 (114149 in chips)
zozitimo: posts the ante 360
jesuismary: posts the ante 360
CaioCapT: posts the ante 360
weichushy: posts the ante 360
ALLILS: posts the ante 360
EZCoinFlip: posts the ante 360
hichnick777: posts the ante 360
guirib8ir0: posts the ante 360
zozitimo: posts small blind 1800
jesuismary: posts big blind 3600
*** HOLE CARDS ***
Dealt to hichnick777 [Ks 5h]
CaioCapT: folds
weichushy: folds
ALLILS: folds
EZCoinFlip: folds
hichnick777: folds
guirib8ir0: folds
zozitimo: raises 7200 to 10800
jesuismary: folds
Uncalled bet (7200) returned to zozitimo
zozitimo collected 10080 from pot
zozitimo: shows [As]
*** SUMMARY ***
Total pot 10080 | Rake 0
Seat 1: zozitimo (small blind) collected (10080)
Seat 2: jesuismary (big blind) folded before Flop
Seat 3: CaioCapT folded before Flop (didn't bet)
Seat 4: weichushy folded before Flop (didn't bet)
Seat 5: ALLILS folded before Flop (didn't bet)
Seat 6: EZCoinFlip folded before Flop (didn't bet)
Seat 7: hichnick777 folded before Flop (didn't bet)
Seat 9: guirib8ir0 (button) folded before Flop (didn't bet)


*********** # 150 **************
PokerStars Hand #176675038751: Tournament #2054568934, $20+$2 USD Hold'em No Limit - Level XXI (1800/3600) - 2017/10/09 2:31:36 MSK [2017/10/08 19:31:36 ET]
Table '2054568934 506' 9-max Seat #1 is the button
Seat 1: zozitimo (93712 in chips)
Seat 2: jesuismary (175510 in chips)
Seat 3: CaioCapT (46174 in chips)
Seat 4: weichushy (188311 in chips)
Seat 5: ALLILS (210835 in chips)
Seat 6: EZCoinFlip (72190 in chips)
Seat 7: hichnick777 (175892 in chips)
Seat 8: zafstop (348147 in chips)
Seat 9: guirib8ir0 (113789 in chips)
zozitimo: posts the ante 360
jesuismary: posts the ante 360
CaioCapT: posts the ante 360
weichushy: posts the ante 360
ALLILS: posts the ante 360
EZCoinFlip: posts the ante 360
hichnick777: posts the ante 360
zafstop: posts the ante 360
guirib8ir0: posts the ante 360
jesuismary: posts small blind 1800
CaioCapT: posts big blind 3600
*** HOLE CARDS ***
Dealt to hichnick777 [6s 2d]
weichushy: folds
ALLILS: raises 3780 to 7380
EZCoinFlip: folds
hichnick777: folds
zafstop: folds
guirib8ir0: calls 7380
zozitimo: folds
jesuismary: folds
CaioCapT: calls 3780
*** FLOP *** [2h Kd Ad]
CaioCapT: checks
ALLILS: checks
weichushy said, "allin  man..."
guirib8ir0: checks
*** TURN *** [2h Kd Ad] [4c]
CaioCapT: checks
ALLILS: checks
guirib8ir0: bets 13677
CaioCapT: folds
ALLILS: calls 13677
*** RIVER *** [2h Kd Ad 4c] [5d]
ALLILS: checks
guirib8ir0: bets 25086
ALLILS: folds
Uncalled bet (25086) returned to guirib8ir0
guirib8ir0 collected 54534 from pot
guirib8ir0: doesn't show hand
*** SUMMARY ***
Total pot 54534 | Rake 0
Board [2h Kd Ad 4c 5d]
Seat 1: zozitimo (button) folded before Flop (didn't bet)
Seat 2: jesuismary (small blind) folded before Flop
Seat 3: CaioCapT (big blind) folded on the Turn
Seat 4: weichushy folded before Flop (didn't bet)
Seat 5: ALLILS folded on the River
Seat 6: EZCoinFlip folded before Flop (didn't bet)
Seat 7: hichnick777 folded before Flop (didn't bet)
Seat 8: zafstop folded before Flop (didn't bet)
Seat 9: guirib8ir0 collected (54534)


*********** # 151 **************
PokerStars Hand #176675114053: Tournament #2054568934, $20+$2 USD Hold'em No Limit - Level XXI (1800/3600) - 2017/10/09 2:34:00 MSK [2017/10/08 19:34:00 ET]
Table '2054568934 506' 9-max Seat #2 is the button
Seat 1: zozitimo (93352 in chips)
Seat 2: jesuismary (173350 in chips)
Seat 3: CaioCapT (38434 in chips)
Seat 4: weichushy (187951 in chips)
Seat 5: ALLILS (189418 in chips)
Seat 6: EZCoinFlip (71830 in chips)
Seat 7: hichnick777 (175532 in chips)
Seat 8: zafstop (347787 in chips)
Seat 9: guirib8ir0 (146906 in chips)
zozitimo: posts the ante 360
jesuismary: posts the ante 360
CaioCapT: posts the ante 360
weichushy: posts the ante 360
ALLILS: posts the ante 360
EZCoinFlip: posts the ante 360
hichnick777: posts the ante 360
zafstop: posts the ante 360
guirib8ir0: posts the ante 360
CaioCapT: posts small blind 1800
weichushy: posts big blind 3600
*** HOLE CARDS ***
Dealt to hichnick777 [Qs 2s]
ALLILS: folds
EZCoinFlip: folds
hichnick777: folds
zafstop: raises 4320 to 7920
guirib8ir0: folds
zozitimo: folds
jesuismary: raises 17189 to 25109
CaioCapT: folds
weichushy: folds
zafstop: calls 17189
*** FLOP *** [Kd Ts 3d]
zafstop: checks
jesuismary: bets 26102
zafstop: calls 26102
*** TURN *** [Kd Ts 3d] [3h]
zafstop: checks
jesuismary: bets 121779 and is all-in
zafstop: calls 121779
*** RIVER *** [Kd Ts 3d 3h] [Jh]
*** SHOW DOWN ***
zafstop: shows [Ks 5s] (two pair, Kings and Threes)
jesuismary: shows [Td Qd] (two pair, Tens and Threes)
zafstop collected 354620 from pot
jesuismary finished the tournament in 760th place and received $48.97.
*** SUMMARY ***
Total pot 354620 | Rake 0
Board [Kd Ts 3d 3h Jh]
Seat 1: zozitimo folded before Flop (didn't bet)
Seat 2: jesuismary (button) showed [Td Qd] and lost with two pair, Tens and Threes
Seat 3: CaioCapT (small blind) folded before Flop
Seat 4: weichushy (big blind) folded before Flop
Seat 5: ALLILS folded before Flop (didn't bet)
Seat 6: EZCoinFlip folded before Flop (didn't bet)
Seat 7: hichnick777 folded before Flop (didn't bet)
Seat 8: zafstop showed [Ks 5s] and won (354620) with two pair, Kings and Threes
Seat 9: guirib8ir0 folded before Flop (didn't bet)


*********** # 152 **************
PokerStars Hand #176675172653: Tournament #2054568934, $20+$2 USD Hold'em No Limit - Level XXI (1800/3600) - 2017/10/09 2:35:52 MSK [2017/10/08 19:35:52 ET]
Table '2054568934 506' 9-max Seat #3 is the button
Seat 1: zozitimo (92992 in chips)
Seat 3: CaioCapT (36274 in chips)
Seat 4: weichushy (183991 in chips)
Seat 5: ALLILS (189058 in chips)
Seat 6: EZCoinFlip (71470 in chips)
Seat 7: hichnick777 (175172 in chips)
Seat 8: zafstop (529057 in chips)
Seat 9: guirib8ir0 (146546 in chips)
zozitimo: posts the ante 360
CaioCapT: posts the ante 360
weichushy: posts the ante 360
ALLILS: posts the ante 360
EZCoinFlip: posts the ante 360
hichnick777: posts the ante 360
zafstop: posts the ante 360
guirib8ir0: posts the ante 360
weichushy: posts small blind 1800
ALLILS: posts big blind 3600
*** HOLE CARDS ***
Dealt to hichnick777 [3h Ts]
EZCoinFlip: folds
hichnick777: folds
zafstop: folds
guirib8ir0: folds
zozitimo: folds
CaioCapT: raises 32314 to 35914 and is all-in
weichushy: folds
ALLILS: folds
Uncalled bet (32314) returned to CaioCapT
CaioCapT collected 11880 from pot
*** SUMMARY ***
Total pot 11880 | Rake 0
Seat 1: zozitimo folded before Flop (didn't bet)
Seat 3: CaioCapT (button) collected (11880)
Seat 4: weichushy (small blind) folded before Flop
Seat 5: ALLILS (big blind) folded before Flop
Seat 6: EZCoinFlip folded before Flop (didn't bet)
Seat 7: hichnick777 folded before Flop (didn't bet)
Seat 8: zafstop folded before Flop (didn't bet)
Seat 9: guirib8ir0 folded before Flop (didn't bet)


*********** # 153 **************
PokerStars Hand #176675193691: Tournament #2054568934, $20+$2 USD Hold'em No Limit - Level XXI (1800/3600) - 2017/10/09 2:36:33 MSK [2017/10/08 19:36:33 ET]
Table '2054568934 506' 9-max Seat #4 is the button
Seat 1: zozitimo (92632 in chips)
Seat 2: Perke0 (136642 in chips)
Seat 3: CaioCapT (44194 in chips)
Seat 4: weichushy (181831 in chips)
Seat 5: ALLILS (185098 in chips)
Seat 6: EZCoinFlip (71110 in chips)
Seat 7: hichnick777 (174812 in chips)
Seat 8: zafstop (528697 in chips)
Seat 9: guirib8ir0 (146186 in chips)
zozitimo: posts the ante 360
Perke0: posts the ante 360
CaioCapT: posts the ante 360
weichushy: posts the ante 360
ALLILS: posts the ante 360
EZCoinFlip: posts the ante 360
hichnick777: posts the ante 360
zafstop: posts the ante 360
guirib8ir0: posts the ante 360
ALLILS: posts small blind 1800
EZCoinFlip: posts big blind 3600
*** HOLE CARDS ***
Dealt to hichnick777 [7h 5c]
hichnick777: folds
zafstop: folds
guirib8ir0: folds
zozitimo: folds
Perke0: raises 4055 to 7655
CaioCapT: folds
weichushy: folds
ALLILS: raises 15470 to 23125
EZCoinFlip: folds
Perke0: folds
Uncalled bet (15470) returned to ALLILS
ALLILS collected 22150 from pot
*** SUMMARY ***
Total pot 22150 | Rake 0
Seat 1: zozitimo folded before Flop (didn't bet)
Seat 2: Perke0 folded before Flop
Seat 3: CaioCapT folded before Flop (didn't bet)
Seat 4: weichushy (button) folded before Flop (didn't bet)
Seat 5: ALLILS (small blind) collected (22150)
Seat 6: EZCoinFlip (big blind) folded before Flop
Seat 7: hichnick777 folded before Flop (didn't bet)
Seat 8: zafstop folded before Flop (didn't bet)
Seat 9: guirib8ir0 folded before Flop (didn't bet)


*********** # 154 **************
PokerStars Hand #176675218290: Tournament #2054568934, $20+$2 USD Hold'em No Limit - Level XXI (1800/3600) - 2017/10/09 2:37:20 MSK [2017/10/08 19:37:20 ET]
Table '2054568934 506' 9-max Seat #5 is the button
Seat 1: zozitimo (92272 in chips)
Seat 2: Perke0 (128627 in chips)
Seat 3: CaioCapT (43834 in chips)
Seat 4: weichushy (181471 in chips)
Seat 5: ALLILS (199233 in chips)
Seat 6: EZCoinFlip (67150 in chips)
Seat 7: hichnick777 (174452 in chips)
Seat 8: zafstop (528337 in chips)
Seat 9: guirib8ir0 (145826 in chips)
zozitimo: posts the ante 360
Perke0: posts the ante 360
CaioCapT: posts the ante 360
weichushy: posts the ante 360
ALLILS: posts the ante 360
EZCoinFlip: posts the ante 360
hichnick777: posts the ante 360
zafstop: posts the ante 360
guirib8ir0: posts the ante 360
EZCoinFlip: posts small blind 1800
hichnick777: posts big blind 3600
*** HOLE CARDS ***
Dealt to hichnick777 [Jc Ad]
zafstop: folds
guirib8ir0: folds
zozitimo: raises 6700 to 10300
Perke0: folds
CaioCapT: folds
weichushy: folds
ALLILS: calls 10300
EZCoinFlip: folds
hichnick777: calls 6700
*** FLOP *** [Ac As 2h]
hichnick777: checks
zozitimo: checks
ALLILS: checks
*** TURN *** [Ac As 2h] [6h]
hichnick777: bets 20845
zozitimo: folds
ALLILS: calls 20845
*** RIVER *** [Ac As 2h 6h] [Ks]
hichnick777: checks
ALLILS: bets 31052
hichnick777: calls 31052
*** SHOW DOWN ***
ALLILS: shows [Th Ah] (three of a kind, Aces)
hichnick777: shows [Jc Ad] (three of a kind, Aces - King+Jack kicker)
hichnick777 collected 139734 from pot
*** SUMMARY ***
Total pot 139734 | Rake 0
Board [Ac As 2h 6h Ks]
Seat 1: zozitimo folded on the Turn
Seat 2: Perke0 folded before Flop (didn't bet)
Seat 3: CaioCapT folded before Flop (didn't bet)
Seat 4: weichushy folded before Flop (didn't bet)
Seat 5: ALLILS (button) showed [Th Ah] and lost with three of a kind, Aces
Seat 6: EZCoinFlip (small blind) folded before Flop
Seat 7: hichnick777 (big blind) showed [Jc Ad] and won (139734) with three of a kind, Aces
Seat 8: zafstop folded before Flop (didn't bet)
Seat 9: guirib8ir0 folded before Flop (didn't bet)


*********** # 155 **************
PokerStars Hand #176675268171: Tournament #2054568934, $20+$2 USD Hold'em No Limit - Level XXI (1800/3600) - 2017/10/09 2:38:57 MSK [2017/10/08 19:38:57 ET]
Table '2054568934 506' 9-max Seat #6 is the button
Seat 1: zozitimo (81612 in chips)
Seat 2: Perke0 (128267 in chips)
Seat 3: CaioCapT (43474 in chips)
Seat 4: weichushy (181111 in chips)
Seat 5: ALLILS (136676 in chips)
Seat 6: EZCoinFlip (64990 in chips)
Seat 7: hichnick777 (251629 in chips)
Seat 8: zafstop (527977 in chips)
Seat 9: guirib8ir0 (145466 in chips)
zozitimo: posts the ante 360
Perke0: posts the ante 360
CaioCapT: posts the ante 360
weichushy: posts the ante 360
ALLILS: posts the ante 360
EZCoinFlip: posts the ante 360
hichnick777: posts the ante 360
zafstop: posts the ante 360
guirib8ir0: posts the ante 360
hichnick777: posts small blind 1800
zafstop: posts big blind 3600
*** HOLE CARDS ***
Dealt to hichnick777 [Tc 3h]
guirib8ir0: folds
zozitimo: folds
Perke0: folds
CaioCapT: folds
weichushy: raises 3600 to 7200
ALLILS: folds
EZCoinFlip: folds
hichnick777: folds
zafstop: folds
Uncalled bet (3600) returned to weichushy
weichushy collected 12240 from pot
weichushy: doesn't show hand
*** SUMMARY ***
Total pot 12240 | Rake 0
Seat 1: zozitimo folded before Flop (didn't bet)
Seat 2: Perke0 folded before Flop (didn't bet)
Seat 3: CaioCapT folded before Flop (didn't bet)
Seat 4: weichushy collected (12240)
Seat 5: ALLILS folded before Flop (didn't bet)
Seat 6: EZCoinFlip (button) folded before Flop (didn't bet)
Seat 7: hichnick777 (small blind) folded before Flop
Seat 8: zafstop (big blind) folded before Flop
Seat 9: guirib8ir0 folded before Flop (didn't bet)


*********** # 156 **************
PokerStars Hand #176675302203: Tournament #2054568934, $20+$2 USD Hold'em No Limit - Level XXI (1800/3600) - 2017/10/09 2:40:03 MSK [2017/10/08 19:40:03 ET]
Table '2054568934 506' 9-max Seat #7 is the button
Seat 1: zozitimo (81252 in chips)
Seat 2: Perke0 (127907 in chips)
Seat 3: CaioCapT (43114 in chips)
Seat 4: weichushy (189391 in chips)
Seat 5: ALLILS (136316 in chips)
Seat 6: EZCoinFlip (64630 in chips)
Seat 7: hichnick777 (249469 in chips)
Seat 8: zafstop (524017 in chips)
Seat 9: guirib8ir0 (145106 in chips)
zozitimo: posts the ante 360
Perke0: posts the ante 360
CaioCapT: posts the ante 360
weichushy: posts the ante 360
ALLILS: posts the ante 360
EZCoinFlip: posts the ante 360
hichnick777: posts the ante 360
zafstop: posts the ante 360
guirib8ir0: posts the ante 360
zafstop: posts small blind 1800
guirib8ir0: posts big blind 3600
*** HOLE CARDS ***
Dealt to hichnick777 [Jh 6h]
zozitimo: folds
Perke0: folds
CaioCapT: folds
weichushy: folds
ALLILS: folds
EZCoinFlip: folds
hichnick777: raises 4500 to 8100
zafstop: raises 18900 to 27000
guirib8ir0: folds
hichnick777: folds
Uncalled bet (18900) returned to zafstop
zafstop collected 23040 from pot
*** SUMMARY ***
Total pot 23040 | Rake 0
Seat 1: zozitimo folded before Flop (didn't bet)
Seat 2: Perke0 folded before Flop (didn't bet)
Seat 3: CaioCapT folded before Flop (didn't bet)
Seat 4: weichushy folded before Flop (didn't bet)
Seat 5: ALLILS folded before Flop (didn't bet)
Seat 6: EZCoinFlip folded before Flop (didn't bet)
Seat 7: hichnick777 (button) folded before Flop
Seat 8: zafstop (small blind) collected (23040)
Seat 9: guirib8ir0 (big blind) folded before Flop


*********** # 157 **************
PokerStars Hand #176675331268: Tournament #2054568934, $20+$2 USD Hold'em No Limit - Level XXI (1800/3600) - 2017/10/09 2:41:00 MSK [2017/10/08 19:41:00 ET]
Table '2054568934 506' 9-max Seat #8 is the button
Seat 1: zozitimo (80892 in chips)
Seat 2: Perke0 (127547 in chips)
Seat 3: CaioCapT (42754 in chips)
Seat 4: weichushy (189031 in chips)
Seat 5: ALLILS (135956 in chips)
Seat 6: EZCoinFlip (64270 in chips)
Seat 7: hichnick777 (241009 in chips)
Seat 8: zafstop (538597 in chips)
Seat 9: guirib8ir0 (141146 in chips)
zozitimo: posts the ante 360
Perke0: posts the ante 360
CaioCapT: posts the ante 360
weichushy: posts the ante 360
ALLILS: posts the ante 360
EZCoinFlip: posts the ante 360
hichnick777: posts the ante 360
zafstop: posts the ante 360
guirib8ir0: posts the ante 360
guirib8ir0: posts small blind 1800
zozitimo: posts big blind 3600
*** HOLE CARDS ***
Dealt to hichnick777 [2h Kh]
Perke0: folds
CaioCapT: folds
weichushy: folds
ALLILS: folds
EZCoinFlip: folds
hichnick777: raises 3888 to 7488
zafstop: calls 7488
guirib8ir0 is disconnected
guirib8ir0 has timed out while disconnected
guirib8ir0: folds
guirib8ir0 is sitting out
zozitimo: calls 3888
*** FLOP *** [8s 6h 9h]
zozitimo: checks
hichnick777: bets 15952
zafstop: calls 15952
zozitimo: folds
*** TURN *** [8s 6h 9h] [8d]
hichnick777: bets 34457
zafstop: calls 34457
*** RIVER *** [8s 6h 9h 8d] [6d]
hichnick777: checks
zafstop: bets 61595
hichnick777: folds
Uncalled bet (61595) returned to zafstop
zafstop collected 128322 from pot
*** SUMMARY ***
Total pot 128322 | Rake 0
Board [8s 6h 9h 8d 6d]
Seat 1: zozitimo (big blind) folded on the Flop
Seat 2: Perke0 folded before Flop (didn't bet)
Seat 3: CaioCapT folded before Flop (didn't bet)
Seat 4: weichushy folded before Flop (didn't bet)
Seat 5: ALLILS folded before Flop (didn't bet)
Seat 6: EZCoinFlip folded before Flop (didn't bet)
Seat 7: hichnick777 folded on the River
Seat 8: zafstop (button) collected (128322)
Seat 9: guirib8ir0 (small blind) folded before Flop


*********** # 158 **************
PokerStars Hand #176675416303: Tournament #2054568934, $20+$2 USD Hold'em No Limit - Level XXII (2000/4000) - 2017/10/09 2:43:40 MSK [2017/10/08 19:43:40 ET]
Table '2054568934 506' 9-max Seat #9 is the button
Seat 1: zozitimo (73044 in chips)
Seat 2: Perke0 (127187 in chips)
Seat 3: CaioCapT (42394 in chips)
Seat 4: weichushy (188671 in chips)
Seat 5: ALLILS (135596 in chips)
Seat 6: EZCoinFlip (63910 in chips)
Seat 7: hichnick777 (182752 in chips)
Seat 8: zafstop (608662 in chips)
Seat 9: guirib8ir0 (138986 in chips) is sitting out
zozitimo: posts the ante 400
Perke0: posts the ante 400
CaioCapT: posts the ante 400
weichushy: posts the ante 400
ALLILS: posts the ante 400
EZCoinFlip: posts the ante 400
hichnick777: posts the ante 400
zafstop: posts the ante 400
guirib8ir0: posts the ante 400
zozitimo: posts small blind 2000
Perke0: posts big blind 4000
*** HOLE CARDS ***
Dealt to hichnick777 [9h Ts]
CaioCapT: raises 37994 to 41994 and is all-in
weichushy: folds
ALLILS: folds
EZCoinFlip: folds
hichnick777: folds
zafstop: folds
guirib8ir0: folds
zozitimo: raises 30650 to 72644 and is all-in
Perke0: folds
Uncalled bet (30650) returned to zozitimo
*** FLOP *** [Jh 9d Ad]
*** TURN *** [Jh 9d Ad] [8s]
*** RIVER *** [Jh 9d Ad 8s] [Kc]
*** SHOW DOWN ***
zozitimo: shows [Kd As] (two pair, Aces and Kings)
CaioCapT: shows [8c Ac] (two pair, Aces and Eights)
zozitimo collected 91588 from pot
CaioCapT finished the tournament in 677th place and received $57.26.
*** SUMMARY ***
Total pot 91588 | Rake 0
Board [Jh 9d Ad 8s Kc]
Seat 1: zozitimo (small blind) showed [Kd As] and won (91588) with two pair, Aces and Kings
Seat 2: Perke0 (big blind) folded before Flop
Seat 3: CaioCapT showed [8c Ac] and lost with two pair, Aces and Eights
Seat 4: weichushy folded before Flop (didn't bet)
Seat 5: ALLILS folded before Flop (didn't bet)
Seat 6: EZCoinFlip folded before Flop (didn't bet)
Seat 7: hichnick777 folded before Flop (didn't bet)
Seat 8: zafstop folded before Flop (didn't bet)
Seat 9: guirib8ir0 (button) folded before Flop (didn't bet)


*********** # 159 **************
PokerStars Hand #176675431179: Tournament #2054568934, $20+$2 USD Hold'em No Limit - Level XXII (2000/4000) - 2017/10/09 2:44:09 MSK [2017/10/08 19:44:09 ET]
Table '2054568934 506' 9-max Seat #1 is the button
Seat 1: zozitimo (122238 in chips)
Seat 2: Perke0 (122787 in chips)
Seat 3: Jorio80 (81244 in chips)
Seat 4: weichushy (188271 in chips)
Seat 5: ALLILS (135196 in chips)
Seat 6: EZCoinFlip (63510 in chips)
Seat 7: hichnick777 (182352 in chips)
Seat 8: zafstop (608262 in chips)
Seat 9: guirib8ir0 (138586 in chips) is sitting out
zozitimo: posts the ante 400
Perke0: posts the ante 400
Jorio80: posts the ante 400
weichushy: posts the ante 400
ALLILS: posts the ante 400
EZCoinFlip: posts the ante 400
hichnick777: posts the ante 400
zafstop: posts the ante 400
guirib8ir0: posts the ante 400
Perke0: posts small blind 2000
Jorio80: posts big blind 4000
*** HOLE CARDS ***
Dealt to hichnick777 [Qs Qc]
weichushy: folds
ALLILS: folds
EZCoinFlip: folds
hichnick777: raises 5000 to 9000
zafstop: folds
guirib8ir0: folds
zozitimo: folds
Perke0: folds
Jorio80: folds
Uncalled bet (5000) returned to hichnick777
hichnick777 collected 13600 from pot
hichnick777: doesn't show hand
*** SUMMARY ***
Total pot 13600 | Rake 0
Seat 1: zozitimo (button) folded before Flop (didn't bet)
Seat 2: Perke0 (small blind) folded before Flop
Seat 3: Jorio80 (big blind) folded before Flop
Seat 4: weichushy folded before Flop (didn't bet)
Seat 5: ALLILS folded before Flop (didn't bet)
Seat 6: EZCoinFlip folded before Flop (didn't bet)
Seat 7: hichnick777 collected (13600)
Seat 8: zafstop folded before Flop (didn't bet)
Seat 9: guirib8ir0 folded before Flop (didn't bet)


*********** # 160 **************
PokerStars Hand #176675449045: Tournament #2054568934, $20+$2 USD Hold'em No Limit - Level XXII (2000/4000) - 2017/10/09 2:44:44 MSK [2017/10/08 19:44:44 ET]
Table '2054568934 506' 9-max Seat #2 is the button
Seat 1: zozitimo (121838 in chips)
Seat 2: Perke0 (120387 in chips)
Seat 3: Jorio80 (76844 in chips)
Seat 4: weichushy (187871 in chips)
Seat 5: ALLILS (134796 in chips)
Seat 6: EZCoinFlip (63110 in chips)
Seat 7: hichnick777 (191552 in chips)
Seat 8: zafstop (607862 in chips)
Seat 9: guirib8ir0 (138186 in chips) is sitting out
zozitimo: posts the ante 400
Perke0: posts the ante 400
Jorio80: posts the ante 400
weichushy: posts the ante 400
ALLILS: posts the ante 400
EZCoinFlip: posts the ante 400
hichnick777: posts the ante 400
zafstop: posts the ante 400
guirib8ir0: posts the ante 400
Jorio80: posts small blind 2000
weichushy: posts big blind 4000
*** HOLE CARDS ***
Dealt to hichnick777 [Th 6c]
ALLILS: folds
EZCoinFlip: raises 4000 to 8000
hichnick777: folds
zafstop: folds
guirib8ir0: folds
zozitimo: folds
Perke0: folds
Jorio80: folds
weichushy: folds
Uncalled bet (4000) returned to EZCoinFlip
EZCoinFlip collected 13600 from pot
EZCoinFlip: doesn't show hand
*** SUMMARY ***
Total pot 13600 | Rake 0
Seat 1: zozitimo folded before Flop (didn't bet)
Seat 2: Perke0 (button) folded before Flop (didn't bet)
Seat 3: Jorio80 (small blind) folded before Flop
Seat 4: weichushy (big blind) folded before Flop
Seat 5: ALLILS folded before Flop (didn't bet)
Seat 6: EZCoinFlip collected (13600)
Seat 7: hichnick777 folded before Flop (didn't bet)
Seat 8: zafstop folded before Flop (didn't bet)
Seat 9: guirib8ir0 folded before Flop (didn't bet)


*********** # 161 **************
PokerStars Hand #176675461324: Tournament #2054568934, $20+$2 USD Hold'em No Limit - Level XXII (2000/4000) - 2017/10/09 2:45:09 MSK [2017/10/08 19:45:09 ET]
Table '2054568934 506' 9-max Seat #3 is the button
Seat 1: zozitimo (121438 in chips)
Seat 2: Perke0 (119987 in chips)
Seat 3: Jorio80 (74444 in chips)
Seat 4: weichushy (183471 in chips)
Seat 5: ALLILS (134396 in chips)
Seat 6: EZCoinFlip (72310 in chips)
Seat 7: hichnick777 (191152 in chips)
Seat 8: zafstop (607462 in chips)
Seat 9: guirib8ir0 (137786 in chips) is sitting out
zozitimo: posts the ante 400
Perke0: posts the ante 400
Jorio80: posts the ante 400
weichushy: posts the ante 400
ALLILS: posts the ante 400
EZCoinFlip: posts the ante 400
hichnick777: posts the ante 400
zafstop: posts the ante 400
guirib8ir0: posts the ante 400
weichushy: posts small blind 2000
ALLILS: posts big blind 4000
*** HOLE CARDS ***
Dealt to hichnick777 [8c 5d]
EZCoinFlip: folds
hichnick777: folds
zafstop: folds
guirib8ir0: folds
zozitimo: folds
Perke0: raises 4755 to 8755
Jorio80: folds
weichushy: folds
ALLILS: calls 4755
*** FLOP *** [Jd 8h 7h]
ALLILS: checks
guirib8ir0 has returned
Perke0: bets 17588
ALLILS: folds
Uncalled bet (17588) returned to Perke0
Perke0 collected 23110 from pot
Perke0: doesn't show hand
*** SUMMARY ***
Total pot 23110 | Rake 0
Board [Jd 8h 7h]
Seat 1: zozitimo folded before Flop (didn't bet)
Seat 2: Perke0 collected (23110)
Seat 3: Jorio80 (button) folded before Flop (didn't bet)
Seat 4: weichushy (small blind) folded before Flop
Seat 5: ALLILS (big blind) folded on the Flop
Seat 6: EZCoinFlip folded before Flop (didn't bet)
Seat 7: hichnick777 folded before Flop (didn't bet)
Seat 8: zafstop folded before Flop (didn't bet)
Seat 9: guirib8ir0 folded before Flop (didn't bet)


*********** # 162 **************
PokerStars Hand #176675496192: Tournament #2054568934, $20+$2 USD Hold'em No Limit - Level XXII (2000/4000) - 2017/10/09 2:46:17 MSK [2017/10/08 19:46:17 ET]
Table '2054568934 506' 9-max Seat #4 is the button
Seat 1: zozitimo (121038 in chips)
Seat 2: Perke0 (133942 in chips)
Seat 3: Jorio80 (74044 in chips)
Seat 4: weichushy (181071 in chips)
Seat 5: ALLILS (125241 in chips)
Seat 6: EZCoinFlip (71910 in chips)
Seat 7: hichnick777 (190752 in chips)
Seat 8: zafstop (607062 in chips)
Seat 9: guirib8ir0 (137386 in chips)
zozitimo: posts the ante 400
Perke0: posts the ante 400
Jorio80: posts the ante 400
weichushy: posts the ante 400
ALLILS: posts the ante 400
EZCoinFlip: posts the ante 400
hichnick777: posts the ante 400
zafstop: posts the ante 400
guirib8ir0: posts the ante 400
ALLILS: posts small blind 2000
EZCoinFlip: posts big blind 4000
*** HOLE CARDS ***
Dealt to hichnick777 [3h 7c]
hichnick777: folds
zafstop: folds
guirib8ir0: folds
zozitimo: folds
Perke0: folds
Jorio80: folds
weichushy: folds
ALLILS: folds
Uncalled bet (2000) returned to EZCoinFlip
EZCoinFlip collected 7600 from pot
EZCoinFlip: doesn't show hand
*** SUMMARY ***
Total pot 7600 | Rake 0
Seat 1: zozitimo folded before Flop (didn't bet)
Seat 2: Perke0 folded before Flop (didn't bet)
Seat 3: Jorio80 folded before Flop (didn't bet)
Seat 4: weichushy (button) folded before Flop (didn't bet)
Seat 5: ALLILS (small blind) folded before Flop
Seat 6: EZCoinFlip (big blind) collected (7600)
Seat 7: hichnick777 folded before Flop (didn't bet)
Seat 8: zafstop folded before Flop (didn't bet)
Seat 9: guirib8ir0 folded before Flop (didn't bet)


*********** # 163 **************
PokerStars Hand #176675507929: Tournament #2054568934, $20+$2 USD Hold'em No Limit - Level XXII (2000/4000) - 2017/10/09 2:46:40 MSK [2017/10/08 19:46:40 ET]
Table '2054568934 506' 9-max Seat #5 is the button
Seat 1: zozitimo (120638 in chips)
Seat 2: Perke0 (133542 in chips)
Seat 3: Jorio80 (73644 in chips)
Seat 4: weichushy (180671 in chips)
Seat 5: ALLILS (122841 in chips)
Seat 6: EZCoinFlip (77110 in chips)
Seat 7: hichnick777 (190352 in chips)
Seat 8: zafstop (606662 in chips)
Seat 9: guirib8ir0 (136986 in chips)
zozitimo: posts the ante 400
Perke0: posts the ante 400
Jorio80: posts the ante 400
weichushy: posts the ante 400
ALLILS: posts the ante 400
EZCoinFlip: posts the ante 400
hichnick777: posts the ante 400
zafstop: posts the ante 400
guirib8ir0: posts the ante 400
EZCoinFlip: posts small blind 2000
hichnick777: posts big blind 4000
*** HOLE CARDS ***
Dealt to hichnick777 [Ac 8d]
zafstop: raises 4000 to 8000
guirib8ir0: folds
zozitimo: folds
Perke0: folds
Jorio80: folds
weichushy: folds
ALLILS: folds
EZCoinFlip: folds
hichnick777: calls 4000
*** FLOP *** [6c Qs 5c]
hichnick777: checks
zafstop: bets 7128
hichnick777: calls 7128
*** TURN *** [6c Qs 5c] [Td]
hichnick777: checks
zafstop: bets 24024
hichnick777: folds
Uncalled bet (24024) returned to zafstop
zafstop collected 35856 from pot
*** SUMMARY ***
Total pot 35856 | Rake 0
Board [6c Qs 5c Td]
Seat 1: zozitimo folded before Flop (didn't bet)
Seat 2: Perke0 folded before Flop (didn't bet)
Seat 3: Jorio80 folded before Flop (didn't bet)
Seat 4: weichushy folded before Flop (didn't bet)
Seat 5: ALLILS (button) folded before Flop (didn't bet)
Seat 6: EZCoinFlip (small blind) folded before Flop
Seat 7: hichnick777 (big blind) folded on the Turn
Seat 8: zafstop collected (35856)
Seat 9: guirib8ir0 folded before Flop (didn't bet)


*********** # 164 **************
PokerStars Hand #176675541708: Tournament #2054568934, $20+$2 USD Hold'em No Limit - Level XXII (2000/4000) - 2017/10/09 2:47:48 MSK [2017/10/08 19:47:48 ET]
Table '2054568934 506' 9-max Seat #6 is the button
Seat 1: zozitimo (120238 in chips)
Seat 2: Perke0 (133142 in chips)
Seat 3: Jorio80 (73244 in chips)
Seat 4: weichushy (180271 in chips)
Seat 5: ALLILS (122441 in chips)
Seat 6: EZCoinFlip (74710 in chips)
Seat 7: hichnick777 (174824 in chips)
Seat 8: zafstop (626990 in chips)
Seat 9: guirib8ir0 (136586 in chips)
zozitimo: posts the ante 400
Perke0: posts the ante 400
Jorio80: posts the ante 400
weichushy: posts the ante 400
ALLILS: posts the ante 400
EZCoinFlip: posts the ante 400
hichnick777: posts the ante 400
zafstop: posts the ante 400
guirib8ir0: posts the ante 400
hichnick777: posts small blind 2000
zafstop: posts big blind 4000
*** HOLE CARDS ***
Dealt to hichnick777 [7d 4s]
guirib8ir0: folds
zozitimo: folds
Perke0: folds
Jorio80: folds
weichushy: folds
ALLILS: folds
EZCoinFlip: raises 4000 to 8000
hichnick777: folds
zafstop: raises 618590 to 626590 and is all-in
EZCoinFlip: folds
Uncalled bet (618590) returned to zafstop
zafstop collected 21600 from pot
*** SUMMARY ***
Total pot 21600 | Rake 0
Seat 1: zozitimo folded before Flop (didn't bet)
Seat 2: Perke0 folded before Flop (didn't bet)
Seat 3: Jorio80 folded before Flop (didn't bet)
Seat 4: weichushy folded before Flop (didn't bet)
Seat 5: ALLILS folded before Flop (didn't bet)
Seat 6: EZCoinFlip (button) folded before Flop
Seat 7: hichnick777 (small blind) folded before Flop
Seat 8: zafstop (big blind) collected (21600)
Seat 9: guirib8ir0 folded before Flop (didn't bet)


*********** # 165 **************
PokerStars Hand #176675560120: Tournament #2054568934, $20+$2 USD Hold'em No Limit - Level XXII (2000/4000) - 2017/10/09 2:48:26 MSK [2017/10/08 19:48:26 ET]
Table '2054568934 506' 9-max Seat #7 is the button
Seat 1: zozitimo (119838 in chips)
Seat 2: Perke0 (132742 in chips)
Seat 3: Jorio80 (72844 in chips)
Seat 4: weichushy (179871 in chips)
Seat 5: ALLILS (122041 in chips)
Seat 6: EZCoinFlip (66310 in chips)
Seat 7: hichnick777 (172424 in chips)
Seat 8: zafstop (640190 in chips)
Seat 9: guirib8ir0 (136186 in chips)
zozitimo: posts the ante 400
Perke0: posts the ante 400
Jorio80: posts the ante 400
weichushy: posts the ante 400
ALLILS: posts the ante 400
EZCoinFlip: posts the ante 400
hichnick777: posts the ante 400
zafstop: posts the ante 400
guirib8ir0: posts the ante 400
zafstop: posts small blind 2000
guirib8ir0: posts big blind 4000
*** HOLE CARDS ***
Dealt to hichnick777 [Kc 4s]
zozitimo: folds
Perke0: folds
Jorio80: folds
weichushy: folds
ALLILS: folds
EZCoinFlip: folds
hichnick777: folds
zafstop: raises 4800 to 8800
guirib8ir0: calls 4800
*** FLOP *** [8s Kd 6h]
zafstop: checks
guirib8ir0: checks
*** TURN *** [8s Kd 6h] [3c]
zafstop: bets 16000
guirib8ir0: folds
Uncalled bet (16000) returned to zafstop
zafstop collected 21200 from pot
*** SUMMARY ***
Total pot 21200 | Rake 0
Board [8s Kd 6h 3c]
Seat 1: zozitimo folded before Flop (didn't bet)
Seat 2: Perke0 folded before Flop (didn't bet)
Seat 3: Jorio80 folded before Flop (didn't bet)
Seat 4: weichushy folded before Flop (didn't bet)
Seat 5: ALLILS folded before Flop (didn't bet)
Seat 6: EZCoinFlip folded before Flop (didn't bet)
Seat 7: hichnick777 (button) folded before Flop (didn't bet)
Seat 8: zafstop (small blind) collected (21200)
Seat 9: guirib8ir0 (big blind) folded on the Turn


*********** # 166 **************
PokerStars Hand #176675613342: Tournament #2054568934, $20+$2 USD Hold'em No Limit - Level XXII (2000/4000) - 2017/10/09 2:50:13 MSK [2017/10/08 19:50:13 ET]
Table '2054568934 506' 9-max Seat #8 is the button
Seat 1: zozitimo (119438 in chips)
Seat 2: Perke0 (132342 in chips)
Seat 3: Jorio80 (72444 in chips)
Seat 4: weichushy (179471 in chips)
Seat 5: ALLILS (121641 in chips)
Seat 6: EZCoinFlip (65910 in chips)
Seat 7: hichnick777 (172024 in chips)
Seat 8: zafstop (652190 in chips)
Seat 9: guirib8ir0 (126986 in chips)
zozitimo: posts the ante 400
Perke0: posts the ante 400
Jorio80: posts the ante 400
weichushy: posts the ante 400
ALLILS: posts the ante 400
EZCoinFlip: posts the ante 400
hichnick777: posts the ante 400
zafstop: posts the ante 400
guirib8ir0: posts the ante 400
guirib8ir0: posts small blind 2000
zozitimo: posts big blind 4000
*** HOLE CARDS ***
Dealt to hichnick777 [9d 4d]
Perke0: folds
Jorio80: folds
weichushy: folds
ALLILS: folds
EZCoinFlip: folds
hichnick777: folds
zafstop: raises 4800 to 8800
guirib8ir0: folds
zozitimo: raises 31200 to 40000
zafstop: raises 611790 to 651790 and is all-in
zozitimo: folds
Uncalled bet (611790) returned to zafstop
zafstop collected 85600 from pot
zafstop: shows [As]
*** SUMMARY ***
Total pot 85600 | Rake 0
Seat 1: zozitimo (big blind) folded before Flop
Seat 2: Perke0 folded before Flop (didn't bet)
Seat 3: Jorio80 folded before Flop (didn't bet)
Seat 4: weichushy folded before Flop (didn't bet)
Seat 5: ALLILS folded before Flop (didn't bet)
Seat 6: EZCoinFlip folded before Flop (didn't bet)
Seat 7: hichnick777 folded before Flop (didn't bet)
Seat 8: zafstop (button) collected (85600)
Seat 9: guirib8ir0 (small blind) folded before Flop


*********** # 167 **************
PokerStars Hand #176675647135: Tournament #2054568934, $20+$2 USD Hold'em No Limit - Level XXII (2000/4000) - 2017/10/09 2:51:22 MSK [2017/10/08 19:51:22 ET]
Table '2054568934 506' 9-max Seat #9 is the button
Seat 1: zozitimo (79038 in chips)
Seat 2: Perke0 (131942 in chips)
Seat 3: Jorio80 (72044 in chips)
Seat 4: weichushy (179071 in chips)
Seat 5: ALLILS (121241 in chips)
Seat 6: EZCoinFlip (65510 in chips)
Seat 7: hichnick777 (171624 in chips)
Seat 8: zafstop (697390 in chips)
Seat 9: guirib8ir0 (124586 in chips)
zozitimo: posts the ante 400
Perke0: posts the ante 400
Jorio80: posts the ante 400
weichushy: posts the ante 400
ALLILS: posts the ante 400
EZCoinFlip: posts the ante 400
hichnick777: posts the ante 400
zafstop: posts the ante 400
guirib8ir0: posts the ante 400
zozitimo: posts small blind 2000
Perke0: posts big blind 4000
*** HOLE CARDS ***
Dealt to hichnick777 [Jc Ah]
Jorio80: folds
weichushy: folds
ALLILS: raises 4200 to 8200
EZCoinFlip: folds
hichnick777: raises 13800 to 22000
zafstop: folds
guirib8ir0: folds
zozitimo: folds
Perke0: folds
ALLILS: folds
Uncalled bet (13800) returned to hichnick777
hichnick777 collected 26000 from pot
hichnick777: doesn't show hand
*** SUMMARY ***
Total pot 26000 | Rake 0
Seat 1: zozitimo (small blind) folded before Flop
Seat 2: Perke0 (big blind) folded before Flop
Seat 3: Jorio80 folded before Flop (didn't bet)
Seat 4: weichushy folded before Flop (didn't bet)
Seat 5: ALLILS folded before Flop
Seat 6: EZCoinFlip folded before Flop (didn't bet)
Seat 7: hichnick777 collected (26000)
Seat 8: zafstop folded before Flop (didn't bet)
Seat 9: guirib8ir0 (button) folded before Flop (didn't bet)


*********** # 168 **************
PokerStars Hand #176675668210: Tournament #2054568934, $20+$2 USD Hold'em No Limit - Level XXII (2000/4000) - 2017/10/09 2:52:05 MSK [2017/10/08 19:52:05 ET]
Table '2054568934 506' 9-max Seat #1 is the button
Seat 1: zozitimo (76638 in chips)
Seat 2: Perke0 (127542 in chips)
Seat 3: Jorio80 (71644 in chips)
Seat 4: weichushy (178671 in chips)
Seat 5: ALLILS (112641 in chips)
Seat 6: EZCoinFlip (65110 in chips)
Seat 7: hichnick777 (189024 in chips)
Seat 8: zafstop (696990 in chips)
Seat 9: guirib8ir0 (124186 in chips)
zozitimo: posts the ante 400
Perke0: posts the ante 400
Jorio80: posts the ante 400
weichushy: posts the ante 400
ALLILS: posts the ante 400
EZCoinFlip: posts the ante 400
hichnick777: posts the ante 400
zafstop: posts the ante 400
guirib8ir0: posts the ante 400
Perke0: posts small blind 2000
Jorio80: posts big blind 4000
*** HOLE CARDS ***
Dealt to hichnick777 [2d Ad]
weichushy: folds
ALLILS: folds
EZCoinFlip: raises 4000 to 8000
hichnick777: folds
zafstop: folds
guirib8ir0: folds
zozitimo: folds
Perke0: calls 6000
Jorio80: raises 63244 to 71244 and is all-in
EZCoinFlip: folds
Perke0: folds
Uncalled bet (63244) returned to Jorio80
Jorio80 collected 27600 from pot
Jorio80: doesn't show hand
*** SUMMARY ***
Total pot 27600 | Rake 0
Seat 1: zozitimo (button) folded before Flop (didn't bet)
Seat 2: Perke0 (small blind) folded before Flop
Seat 3: Jorio80 (big blind) collected (27600)
Seat 4: weichushy folded before Flop (didn't bet)
Seat 5: ALLILS folded before Flop (didn't bet)
Seat 6: EZCoinFlip folded before Flop
Seat 7: hichnick777 folded before Flop (didn't bet)
Seat 8: zafstop folded before Flop (didn't bet)
Seat 9: guirib8ir0 folded before Flop (didn't bet)


*********** # 169 **************
PokerStars Hand #176675694253: Tournament #2054568934, $20+$2 USD Hold'em No Limit - Level XXII (2000/4000) - 2017/10/09 2:52:59 MSK [2017/10/08 19:52:59 ET]
Table '2054568934 506' 9-max Seat #2 is the button
Seat 1: zozitimo (76238 in chips)
Seat 2: Perke0 (119142 in chips)
Seat 3: Jorio80 (90844 in chips)
Seat 4: weichushy (178271 in chips)
Seat 5: ALLILS (112241 in chips)
Seat 6: EZCoinFlip (56710 in chips)
Seat 7: hichnick777 (188624 in chips)
Seat 8: zafstop (696590 in chips)
Seat 9: guirib8ir0 (123786 in chips)
zozitimo: posts the ante 400
Perke0: posts the ante 400
Jorio80: posts the ante 400
weichushy: posts the ante 400
ALLILS: posts the ante 400
EZCoinFlip: posts the ante 400
hichnick777: posts the ante 400
zafstop: posts the ante 400
guirib8ir0: posts the ante 400
Jorio80: posts small blind 2000
weichushy: posts big blind 4000
*** HOLE CARDS ***
Dealt to hichnick777 [6s Kc]
ALLILS: folds
EZCoinFlip: folds
hichnick777: folds
zafstop: folds
guirib8ir0: folds
zozitimo: raises 8000 to 12000
Perke0: folds
Jorio80: raises 78444 to 90444 and is all-in
weichushy: folds
zozitimo: folds
Uncalled bet (78444) returned to Jorio80
Jorio80 collected 31600 from pot
Jorio80: doesn't show hand
*** SUMMARY ***
Total pot 31600 | Rake 0
Seat 1: zozitimo folded before Flop
Seat 2: Perke0 (button) folded before Flop (didn't bet)
Seat 3: Jorio80 (small blind) collected (31600)
Seat 4: weichushy (big blind) folded before Flop
Seat 5: ALLILS folded before Flop (didn't bet)
Seat 6: EZCoinFlip folded before Flop (didn't bet)
Seat 7: hichnick777 folded before Flop (didn't bet)
Seat 8: zafstop folded before Flop (didn't bet)
Seat 9: guirib8ir0 folded before Flop (didn't bet)


*********** # 170 **************
PokerStars Hand #176675718024: Tournament #2054568934, $20+$2 USD Hold'em No Limit - Level XXII (2000/4000) - 2017/10/09 2:53:47 MSK [2017/10/08 19:53:47 ET]
Table '2054568934 506' 9-max Seat #3 is the button
Seat 1: zozitimo (63838 in chips)
Seat 2: Perke0 (118742 in chips)
Seat 3: Jorio80 (110044 in chips)
Seat 4: weichushy (173871 in chips)
Seat 5: ALLILS (111841 in chips)
Seat 6: EZCoinFlip (56310 in chips)
Seat 7: hichnick777 (188224 in chips)
Seat 8: zafstop (696190 in chips)
Seat 9: guirib8ir0 (123386 in chips)
zozitimo: posts the ante 400
Perke0: posts the ante 400
Jorio80: posts the ante 400
weichushy: posts the ante 400
ALLILS: posts the ante 400
EZCoinFlip: posts the ante 400
hichnick777: posts the ante 400
zafstop: posts the ante 400
guirib8ir0: posts the ante 400
weichushy: posts small blind 2000
ALLILS: posts big blind 4000
*** HOLE CARDS ***
Dealt to hichnick777 [Qs Jd]
weichushy said, "(y)"
EZCoinFlip: folds
hichnick777: raises 5000 to 9000
zafstop: folds
guirib8ir0: folds
zozitimo: folds
Perke0: folds
Jorio80: folds
weichushy: folds
ALLILS: folds
Uncalled bet (5000) returned to hichnick777
hichnick777 collected 13600 from pot
hichnick777: doesn't show hand
*** SUMMARY ***
Total pot 13600 | Rake 0
Seat 1: zozitimo folded before Flop (didn't bet)
Seat 2: Perke0 folded before Flop (didn't bet)
Seat 3: Jorio80 (button) folded before Flop (didn't bet)
Seat 4: weichushy (small blind) folded before Flop
Seat 5: ALLILS (big blind) folded before Flop
Seat 6: EZCoinFlip folded before Flop (didn't bet)
Seat 7: hichnick777 collected (13600)
Seat 8: zafstop folded before Flop (didn't bet)
Seat 9: guirib8ir0 folded before Flop (didn't bet)


*********** # 171 **************
PokerStars Hand #176675726349: Tournament #2054568934, $20+$2 USD Hold'em No Limit - Level XXII (2000/4000) - 2017/10/09 2:54:05 MSK [2017/10/08 19:54:05 ET]
Table '2054568934 506' 9-max Seat #4 is the button
Seat 1: zozitimo (63438 in chips)
Seat 2: Perke0 (118342 in chips)
Seat 3: Jorio80 (109644 in chips)
Seat 4: weichushy (171471 in chips)
Seat 5: ALLILS (107441 in chips)
Seat 6: EZCoinFlip (55910 in chips)
Seat 7: hichnick777 (197424 in chips)
Seat 8: zafstop (695790 in chips)
Seat 9: guirib8ir0 (122986 in chips)
zozitimo: posts the ante 400
Perke0: posts the ante 400
Jorio80: posts the ante 400
weichushy: posts the ante 400
ALLILS: posts the ante 400
EZCoinFlip: posts the ante 400
hichnick777: posts the ante 400
zafstop: posts the ante 400
guirib8ir0: posts the ante 400
ALLILS: posts small blind 2000
EZCoinFlip: posts big blind 4000
*** HOLE CARDS ***
Dealt to hichnick777 [6c Js]
hichnick777: folds
zafstop: folds
guirib8ir0: folds
zozitimo: folds
Perke0: raises 5000 to 9000
Jorio80: folds
weichushy: raises 15000 to 24000
ALLILS: folds
EZCoinFlip: folds
Perke0: folds
Uncalled bet (15000) returned to weichushy
weichushy collected 27600 from pot
weichushy: doesn't show hand
*** SUMMARY ***
Total pot 27600 | Rake 0
Seat 1: zozitimo folded before Flop (didn't bet)
Seat 2: Perke0 folded before Flop
Seat 3: Jorio80 folded before Flop (didn't bet)
Seat 4: weichushy (button) collected (27600)
Seat 5: ALLILS (small blind) folded before Flop
Seat 6: EZCoinFlip (big blind) folded before Flop
Seat 7: hichnick777 folded before Flop (didn't bet)
Seat 8: zafstop folded before Flop (didn't bet)
Seat 9: guirib8ir0 folded before Flop (didn't bet)


*********** # 172 **************
PokerStars Hand #176675753984: Tournament #2054568934, $20+$2 USD Hold'em No Limit - Level XXIII (2500/5000) - 2017/10/09 2:54:44 MSK [2017/10/08 19:54:44 ET]
Table '2054568934 506' 9-max Seat #5 is the button
Seat 1: zozitimo (63038 in chips)
Seat 2: Perke0 (108942 in chips)
Seat 3: Jorio80 (109244 in chips)
Seat 4: weichushy (189671 in chips)
Seat 5: ALLILS (105041 in chips)
Seat 6: EZCoinFlip (51510 in chips)
Seat 7: hichnick777 (197024 in chips)
Seat 8: zafstop (695390 in chips)
Seat 9: guirib8ir0 (122586 in chips)
zozitimo: posts the ante 500
Perke0: posts the ante 500
Jorio80: posts the ante 500
weichushy: posts the ante 500
ALLILS: posts the ante 500
EZCoinFlip: posts the ante 500
hichnick777: posts the ante 500
zafstop: posts the ante 500
guirib8ir0: posts the ante 500
EZCoinFlip: posts small blind 2500
hichnick777: posts big blind 5000
*** HOLE CARDS ***
Dealt to hichnick777 [Jc 7s]
zafstop: raises 6000 to 11000
guirib8ir0: folds
zozitimo: folds
Perke0: folds
Jorio80: folds
weichushy: folds
ALLILS: folds
EZCoinFlip: folds
hichnick777: folds
Uncalled bet (6000) returned to zafstop
zafstop collected 17000 from pot
*** SUMMARY ***
Total pot 17000 | Rake 0
Seat 1: zozitimo folded before Flop (didn't bet)
Seat 2: Perke0 folded before Flop (didn't bet)
Seat 3: Jorio80 folded before Flop (didn't bet)
Seat 4: weichushy folded before Flop (didn't bet)
Seat 5: ALLILS (button) folded before Flop (didn't bet)
Seat 6: EZCoinFlip (small blind) folded before Flop
Seat 7: hichnick777 (big blind) folded before Flop
Seat 8: zafstop collected (17000)
Seat 9: guirib8ir0 folded before Flop (didn't bet)


*********** # 173 **************
PokerStars Hand #176675762477: Tournament #2054568934, $20+$2 USD Hold'em No Limit - Level XXIII (2500/5000) - 2017/10/09 2:55:02 MSK [2017/10/08 19:55:02 ET]
Table '2054568934 506' 9-max Seat #6 is the button
Seat 1: zozitimo (62538 in chips)
Seat 2: Perke0 (108442 in chips)
Seat 3: Jorio80 (108744 in chips)
Seat 4: weichushy (189171 in chips)
Seat 6: EZCoinFlip (48510 in chips)
Seat 7: hichnick777 (191524 in chips)
Seat 8: zafstop (706890 in chips)
Seat 9: guirib8ir0 (122086 in chips)
zozitimo: posts the ante 500
Perke0: posts the ante 500
Jorio80: posts the ante 500
weichushy: posts the ante 500
EZCoinFlip: posts the ante 500
hichnick777: posts the ante 500
zafstop: posts the ante 500
guirib8ir0: posts the ante 500
hichnick777: posts small blind 2500
zafstop: posts big blind 5000
*** HOLE CARDS ***
Dealt to hichnick777 [6d 3h]
guirib8ir0: folds
zozitimo: folds
Perke0: raises 7000 to 12000
Jorio80: folds
weichushy: folds
EZCoinFlip: folds
hichnick777: folds
zafstop: folds
Uncalled bet (7000) returned to Perke0
Perke0 collected 16500 from pot
Perke0: doesn't show hand
*** SUMMARY ***
Total pot 16500 | Rake 0
Seat 1: zozitimo folded before Flop (didn't bet)
Seat 2: Perke0 collected (16500)
Seat 3: Jorio80 folded before Flop (didn't bet)
Seat 4: weichushy folded before Flop (didn't bet)
Seat 6: EZCoinFlip (button) folded before Flop (didn't bet)
Seat 7: hichnick777 (small blind) folded before Flop
Seat 8: zafstop (big blind) folded before Flop
Seat 9: guirib8ir0 folded before Flop (didn't bet)


*********** # 174 **************
PokerStars Hand #176675924119: Tournament #2054568934, $20+$2 USD Hold'em No Limit - Level XXIII (2500/5000) - 2017/10/09 3:01:38 MSK [2017/10/08 20:01:38 ET]
Table '2054568934 506' 9-max Seat #7 is the button
Seat 1: zozitimo (62038 in chips)
Seat 2: Perke0 (119442 in chips)
Seat 3: Jorio80 (108244 in chips)
Seat 4: weichushy (188671 in chips)
Seat 5: welcat (106309 in chips)
Seat 6: EZCoinFlip (48010 in chips)
Seat 7: hichnick777 (188524 in chips)
Seat 8: zafstop (701390 in chips)
Seat 9: guirib8ir0 (121586 in chips)
zozitimo: posts the ante 500
Perke0: posts the ante 500
Jorio80: posts the ante 500
weichushy: posts the ante 500
welcat: posts the ante 500
EZCoinFlip: posts the ante 500
hichnick777: posts the ante 500
zafstop: posts the ante 500
guirib8ir0: posts the ante 500
zafstop: posts small blind 2500
guirib8ir0: posts big blind 5000
*** HOLE CARDS ***
Dealt to hichnick777 [Ts Tc]
zozitimo: folds
Perke0: folds
Jorio80: raises 5000 to 10000
weichushy: folds
welcat: folds
EZCoinFlip: folds
hichnick777: raises 13333 to 23333
zafstop: folds
guirib8ir0: folds
Jorio80: raises 84411 to 107744 and is all-in
hichnick777: calls 84411
*** FLOP *** [5d 5s 7d]
*** TURN *** [5d 5s 7d] [4h]
*** RIVER *** [5d 5s 7d 4h] [6d]
*** SHOW DOWN ***
Jorio80: shows [Kd As] (a pair of Fives)
hichnick777: shows [Ts Tc] (two pair, Tens and Fives)
hichnick777 collected 227488 from pot
Jorio80 finished the tournament in 553rd place and received $57.26.
*** SUMMARY ***
Total pot 227488 | Rake 0
Board [5d 5s 7d 4h 6d]
Seat 1: zozitimo folded before Flop (didn't bet)
Seat 2: Perke0 folded before Flop (didn't bet)
Seat 3: Jorio80 showed [Kd As] and lost with a pair of Fives
Seat 4: weichushy folded before Flop (didn't bet)
Seat 5: welcat folded before Flop (didn't bet)
Seat 6: EZCoinFlip folded before Flop (didn't bet)
Seat 7: hichnick777 (button) showed [Ts Tc] and won (227488) with two pair, Tens and Fives
Seat 8: zafstop (small blind) folded before Flop
Seat 9: guirib8ir0 (big blind) folded before Flop


*********** # 175 **************
PokerStars Hand #176675951677: Tournament #2054568934, $20+$2 USD Hold'em No Limit - Level XXIII (2500/5000) - 2017/10/09 3:02:38 MSK [2017/10/08 20:02:38 ET]
Table '2054568934 506' 9-max Seat #8 is the button
Seat 1: zozitimo (61538 in chips)
Seat 2: Perke0 (118942 in chips)
Seat 4: weichushy (188171 in chips)
Seat 5: welcat (105809 in chips)
Seat 6: EZCoinFlip (47510 in chips)
Seat 7: hichnick777 (307768 in chips)
Seat 8: zafstop (698390 in chips)
Seat 9: guirib8ir0 (116086 in chips)
zozitimo: posts the ante 500
Perke0: posts the ante 500
weichushy: posts the ante 500
welcat: posts the ante 500
EZCoinFlip: posts the ante 500
hichnick777: posts the ante 500
zafstop: posts the ante 500
guirib8ir0: posts the ante 500
guirib8ir0: posts small blind 2500
zozitimo: posts big blind 5000
*** HOLE CARDS ***
Dealt to hichnick777 [Ah 6d]
Perke0: folds
weichushy: folds
welcat: folds
EZCoinFlip: folds
hichnick777: raises 5400 to 10400
zafstop: folds
guirib8ir0: folds
zozitimo: folds
Uncalled bet (5400) returned to hichnick777
hichnick777 collected 16500 from pot
hichnick777: doesn't show hand
*** SUMMARY ***
Total pot 16500 | Rake 0
Seat 1: zozitimo (big blind) folded before Flop
Seat 2: Perke0 folded before Flop (didn't bet)
Seat 4: weichushy folded before Flop (didn't bet)
Seat 5: welcat folded before Flop (didn't bet)
Seat 6: EZCoinFlip folded before Flop (didn't bet)
Seat 7: hichnick777 collected (16500)
Seat 8: zafstop (button) folded before Flop (didn't bet)
Seat 9: guirib8ir0 (small blind) folded before Flop


*********** # 176 **************
PokerStars Hand #176675964551: Tournament #2054568934, $20+$2 USD Hold'em No Limit - Level XXIII (2500/5000) - 2017/10/09 3:03:05 MSK [2017/10/08 20:03:05 ET]
Table '2054568934 506' 9-max Seat #9 is the button
Seat 1: zozitimo (56038 in chips)
Seat 2: Perke0 (118442 in chips)
Seat 3: romk@vip (298821 in chips)
Seat 4: weichushy (187671 in chips)
Seat 5: welcat (105309 in chips)
Seat 6: EZCoinFlip (47010 in chips)
Seat 7: hichnick777 (318768 in chips)
Seat 8: zafstop (697890 in chips)
Seat 9: guirib8ir0 (113086 in chips)
zozitimo: posts the ante 500
Perke0: posts the ante 500
romk@vip: posts the ante 500
weichushy: posts the ante 500
welcat: posts the ante 500
EZCoinFlip: posts the ante 500
hichnick777: posts the ante 500
zafstop: posts the ante 500
guirib8ir0: posts the ante 500
zozitimo: posts small blind 2500
Perke0: posts big blind 5000
*** HOLE CARDS ***
Dealt to hichnick777 [Qs Qc]
romk@vip: folds
weichushy: folds
welcat: folds
EZCoinFlip: folds
hichnick777: raises 6250 to 11250
zafstop: folds
guirib8ir0: folds
zozitimo: folds
Perke0: folds
Uncalled bet (6250) returned to hichnick777
hichnick777 collected 17000 from pot
hichnick777: doesn't show hand
*** SUMMARY ***
Total pot 17000 | Rake 0
Seat 1: zozitimo (small blind) folded before Flop
Seat 2: Perke0 (big blind) folded before Flop
Seat 3: romk@vip folded before Flop (didn't bet)
Seat 4: weichushy folded before Flop (didn't bet)
Seat 5: welcat folded before Flop (didn't bet)
Seat 6: EZCoinFlip folded before Flop (didn't bet)
Seat 7: hichnick777 collected (17000)
Seat 8: zafstop folded before Flop (didn't bet)
Seat 9: guirib8ir0 (button) folded before Flop (didn't bet)


*********** # 177 **************
PokerStars Hand #176675979441: Tournament #2054568934, $20+$2 USD Hold'em No Limit - Level XXIII (2500/5000) - 2017/10/09 3:03:36 MSK [2017/10/08 20:03:36 ET]
Table '2054568934 506' 9-max Seat #1 is the button
Seat 1: zozitimo (53038 in chips)
Seat 2: Perke0 (112942 in chips)
Seat 3: romk@vip (298321 in chips)
Seat 4: weichushy (187171 in chips)
Seat 5: welcat (104809 in chips)
Seat 6: EZCoinFlip (46510 in chips)
Seat 7: hichnick777 (330268 in chips)
Seat 8: zafstop (697390 in chips)
Seat 9: guirib8ir0 (112586 in chips)
zozitimo: posts the ante 500
Perke0: posts the ante 500
romk@vip: posts the ante 500
weichushy: posts the ante 500
welcat: posts the ante 500
EZCoinFlip: posts the ante 500
hichnick777: posts the ante 500
zafstop: posts the ante 500
guirib8ir0: posts the ante 500
Perke0: posts small blind 2500
romk@vip: posts big blind 5000
*** HOLE CARDS ***
Dealt to hichnick777 [Ks 9h]
weichushy: folds
welcat: folds
EZCoinFlip: folds
hichnick777: folds
zafstop: raises 6000 to 11000
guirib8ir0: folds
zozitimo: folds
Perke0: raises 101442 to 112442 and is all-in
romk@vip: folds
zafstop: folds
Uncalled bet (101442) returned to Perke0
Perke0 collected 31500 from pot
Perke0: doesn't show hand
*** SUMMARY ***
Total pot 31500 | Rake 0
Seat 1: zozitimo (button) folded before Flop (didn't bet)
Seat 2: Perke0 (small blind) collected (31500)
Seat 3: romk@vip (big blind) folded before Flop
Seat 4: weichushy folded before Flop (didn't bet)
Seat 5: welcat folded before Flop (didn't bet)
Seat 6: EZCoinFlip folded before Flop (didn't bet)
Seat 7: hichnick777 folded before Flop (didn't bet)
Seat 8: zafstop folded before Flop
Seat 9: guirib8ir0 folded before Flop (didn't bet)


*********** # 178 **************
PokerStars Hand #176675999458: Tournament #2054568934, $20+$2 USD Hold'em No Limit - Level XXIII (2500/5000) - 2017/10/09 3:04:19 MSK [2017/10/08 20:04:19 ET]
Table '2054568934 506' 9-max Seat #2 is the button
Seat 1: zozitimo (52538 in chips)
Seat 2: Perke0 (132942 in chips)
Seat 3: romk@vip (292821 in chips)
Seat 4: weichushy (186671 in chips)
Seat 5: welcat (104309 in chips)
Seat 6: EZCoinFlip (46010 in chips)
Seat 7: hichnick777 (329768 in chips)
Seat 8: zafstop (685890 in chips)
Seat 9: guirib8ir0 (112086 in chips)
zozitimo: posts the ante 500
Perke0: posts the ante 500
romk@vip: posts the ante 500
weichushy: posts the ante 500
welcat: posts the ante 500
EZCoinFlip: posts the ante 500
hichnick777: posts the ante 500
zafstop: posts the ante 500
guirib8ir0: posts the ante 500
romk@vip: posts small blind 2500
weichushy: posts big blind 5000
*** HOLE CARDS ***
Dealt to hichnick777 [7c Ts]
welcat: folds
EZCoinFlip: folds
hichnick777: folds
zafstop: folds
guirib8ir0: folds
zozitimo: raises 47038 to 52038 and is all-in
Perke0: folds
romk@vip: folds
weichushy: calls 47038
*** FLOP *** [Tc 3h Ad]
*** TURN *** [Tc 3h Ad] [Kd]
*** RIVER *** [Tc 3h Ad Kd] [Qs]
*** SHOW DOWN ***
weichushy: shows [Qd Ah] (two pair, Aces and Queens)
zozitimo: shows [Ks Jh] (a straight, Ten to Ace)
zozitimo collected 111076 from pot
*** SUMMARY ***
Total pot 111076 | Rake 0
Board [Tc 3h Ad Kd Qs]
Seat 1: zozitimo showed [Ks Jh] and won (111076) with a straight, Ten to Ace
Seat 2: Perke0 (button) folded before Flop (didn't bet)
Seat 3: romk@vip (small blind) folded before Flop
Seat 4: weichushy (big blind) showed [Qd Ah] and lost with two pair, Aces and Queens
Seat 5: welcat folded before Flop (didn't bet)
Seat 6: EZCoinFlip folded before Flop (didn't bet)
Seat 7: hichnick777 folded before Flop (didn't bet)
Seat 8: zafstop folded before Flop (didn't bet)
Seat 9: guirib8ir0 folded before Flop (didn't bet)


*********** # 179 **************
PokerStars Hand #176676020221: Tournament #2054568934, $20+$2 USD Hold'em No Limit - Level XXIII (2500/5000) - 2017/10/09 3:05:02 MSK [2017/10/08 20:05:02 ET]
Table '2054568934 506' 9-max Seat #3 is the button
Seat 1: zozitimo (111076 in chips)
Seat 2: Perke0 (132442 in chips)
Seat 3: romk@vip (289821 in chips)
Seat 4: weichushy (134133 in chips)
Seat 5: welcat (103809 in chips)
Seat 6: EZCoinFlip (45510 in chips)
Seat 7: hichnick777 (329268 in chips)
Seat 8: zafstop (685390 in chips)
Seat 9: guirib8ir0 (111586 in chips)
zozitimo: posts the ante 500
Perke0: posts the ante 500
romk@vip: posts the ante 500
weichushy: posts the ante 500
welcat: posts the ante 500
EZCoinFlip: posts the ante 500
hichnick777: posts the ante 500
zafstop: posts the ante 500
guirib8ir0: posts the ante 500
weichushy: posts small blind 2500
welcat: posts big blind 5000
*** HOLE CARDS ***
Dealt to hichnick777 [Ah Tc]
EZCoinFlip: folds
hichnick777: raises 6250 to 11250
zafstop: folds
guirib8ir0: folds
zozitimo: folds
Perke0: folds
romk@vip: folds
weichushy: folds
welcat: folds
Uncalled bet (6250) returned to hichnick777
hichnick777 collected 17000 from pot
hichnick777: doesn't show hand
*** SUMMARY ***
Total pot 17000 | Rake 0
Seat 1: zozitimo folded before Flop (didn't bet)
Seat 2: Perke0 folded before Flop (didn't bet)
Seat 3: romk@vip (button) folded before Flop (didn't bet)
Seat 4: weichushy (small blind) folded before Flop
Seat 5: welcat (big blind) folded before Flop
Seat 6: EZCoinFlip folded before Flop (didn't bet)
Seat 7: hichnick777 collected (17000)
Seat 8: zafstop folded before Flop (didn't bet)
Seat 9: guirib8ir0 folded before Flop (didn't bet)


*********** # 180 **************
PokerStars Hand #176676035456: Tournament #2054568934, $20+$2 USD Hold'em No Limit - Level XXIII (2500/5000) - 2017/10/09 3:05:34 MSK [2017/10/08 20:05:34 ET]
Table '2054568934 506' 9-max Seat #4 is the button
Seat 1: zozitimo (110576 in chips)
Seat 2: Perke0 (131942 in chips)
Seat 3: romk@vip (289321 in chips)
Seat 4: weichushy (131133 in chips)
Seat 5: welcat (98309 in chips)
Seat 6: EZCoinFlip (45010 in chips)
Seat 7: hichnick777 (340768 in chips)
Seat 8: zafstop (684890 in chips)
Seat 9: guirib8ir0 (111086 in chips)
zozitimo: posts the ante 500
Perke0: posts the ante 500
romk@vip: posts the ante 500
weichushy: posts the ante 500
welcat: posts the ante 500
EZCoinFlip: posts the ante 500
hichnick777: posts the ante 500
zafstop: posts the ante 500
guirib8ir0: posts the ante 500
welcat: posts small blind 2500
EZCoinFlip: posts big blind 5000
*** HOLE CARDS ***
Dealt to hichnick777 [6s 2c]
hichnick777: folds
zafstop: folds
guirib8ir0: raises 5000 to 10000
zozitimo: folds
Perke0: folds
romk@vip: folds
weichushy: calls 10000
welcat: folds
EZCoinFlip: folds
*** FLOP *** [5s 4s Td]
guirib8ir0: bets 14720
weichushy: calls 14720
*** TURN *** [5s 4s Td] [3h]
guirib8ir0: bets 28262
weichushy: raises 77651 to 105913 and is all-in
guirib8ir0: calls 57604 and is all-in
Uncalled bet (20047) returned to weichushy
*** RIVER *** [5s 4s Td 3h] [6c]
*** SHOW DOWN ***
guirib8ir0: shows [Ad Tc] (a pair of Tens)
weichushy: shows [Ah 6h] (a pair of Sixes)
guirib8ir0 collected 233172 from pot
*** SUMMARY ***
Total pot 233172 | Rake 0
Board [5s 4s Td 3h 6c]
Seat 1: zozitimo folded before Flop (didn't bet)
Seat 2: Perke0 folded before Flop (didn't bet)
Seat 3: romk@vip folded before Flop (didn't bet)
Seat 4: weichushy (button) showed [Ah 6h] and lost with a pair of Sixes
Seat 5: welcat (small blind) folded before Flop
Seat 6: EZCoinFlip (big blind) folded before Flop
Seat 7: hichnick777 folded before Flop (didn't bet)
Seat 8: zafstop folded before Flop (didn't bet)
Seat 9: guirib8ir0 showed [Ad Tc] and won (233172) with a pair of Tens


*********** # 181 **************
PokerStars Hand #176676082156: Tournament #2054568934, $20+$2 USD Hold'em No Limit - Level XXIII (2500/5000) - 2017/10/09 3:07:12 MSK [2017/10/08 20:07:12 ET]
Table '2054568934 506' 9-max Seat #5 is the button
Seat 1: zozitimo (110076 in chips)
Seat 2: Perke0 (131442 in chips)
Seat 3: romk@vip (288821 in chips)
Seat 4: weichushy (20047 in chips)
Seat 5: welcat (95309 in chips)
Seat 6: EZCoinFlip (39510 in chips)
Seat 7: hichnick777 (340268 in chips)
Seat 8: zafstop (684390 in chips)
Seat 9: guirib8ir0 (233172 in chips)
zozitimo: posts the ante 500
Perke0: posts the ante 500
romk@vip: posts the ante 500
weichushy: posts the ante 500
welcat: posts the ante 500
EZCoinFlip: posts the ante 500
hichnick777: posts the ante 500
zafstop: posts the ante 500
guirib8ir0: posts the ante 500
EZCoinFlip: posts small blind 2500
hichnick777: posts big blind 5000
*** HOLE CARDS ***
Dealt to hichnick777 [7c 2s]
zafstop: folds
guirib8ir0: folds
zozitimo: folds
Perke0: folds
romk@vip: folds
weichushy: folds
welcat: folds
EZCoinFlip: raises 34010 to 39010 and is all-in
hichnick777: folds
Uncalled bet (34010) returned to EZCoinFlip
EZCoinFlip collected 14500 from pot
EZCoinFlip: doesn't show hand
*** SUMMARY ***
Total pot 14500 | Rake 0
Seat 1: zozitimo folded before Flop (didn't bet)
Seat 2: Perke0 folded before Flop (didn't bet)
Seat 3: romk@vip folded before Flop (didn't bet)
Seat 4: weichushy folded before Flop (didn't bet)
Seat 5: welcat (button) folded before Flop (didn't bet)
Seat 6: EZCoinFlip (small blind) collected (14500)
Seat 7: hichnick777 (big blind) folded before Flop
Seat 8: zafstop folded before Flop (didn't bet)
Seat 9: guirib8ir0 folded before Flop (didn't bet)


*********** # 182 **************
PokerStars Hand #176676115358: Tournament #2054568934, $20+$2 USD Hold'em No Limit - Level XXIII (2500/5000) - 2017/10/09 3:08:23 MSK [2017/10/08 20:08:23 ET]
Table '2054568934 506' 9-max Seat #6 is the button
Seat 1: zozitimo (109576 in chips)
Seat 2: Perke0 (130942 in chips)
Seat 3: romk@vip (288321 in chips)
Seat 4: weichushy (19547 in chips)
Seat 5: welcat (94809 in chips)
Seat 6: EZCoinFlip (48510 in chips)
Seat 7: hichnick777 (334768 in chips)
Seat 8: zafstop (683890 in chips)
Seat 9: guirib8ir0 (232672 in chips)
zozitimo: posts the ante 500
Perke0: posts the ante 500
romk@vip: posts the ante 500
weichushy: posts the ante 500
welcat: posts the ante 500
EZCoinFlip: posts the ante 500
hichnick777: posts the ante 500
zafstop: posts the ante 500
guirib8ir0: posts the ante 500
hichnick777: posts small blind 2500
zafstop: posts big blind 5000
*** HOLE CARDS ***
Dealt to hichnick777 [8h 3s]
guirib8ir0: folds
zozitimo: folds
Perke0: folds
romk@vip: raises 6000 to 11000
weichushy: raises 8047 to 19047 and is all-in
welcat: folds
EZCoinFlip: folds
hichnick777: folds
zafstop: folds
romk@vip: calls 8047
*** FLOP *** [Ah 8s 8d]
*** TURN *** [Ah 8s 8d] [6d]
*** RIVER *** [Ah 8s 8d 6d] [6s]
*** SHOW DOWN ***
romk@vip: shows [Ac Jh] (two pair, Aces and Eights)
weichushy: shows [9s Kc] (two pair, Eights and Sixes)
romk@vip collected 50094 from pot
weichushy finished the tournament in 506th place and received $66.95.
*** SUMMARY ***
Total pot 50094 | Rake 0
Board [Ah 8s 8d 6d 6s]
Seat 1: zozitimo folded before Flop (didn't bet)
Seat 2: Perke0 folded before Flop (didn't bet)
Seat 3: romk@vip showed [Ac Jh] and won (50094) with two pair, Aces and Eights
Seat 4: weichushy showed [9s Kc] and lost with two pair, Eights and Sixes
Seat 5: welcat folded before Flop (didn't bet)
Seat 6: EZCoinFlip (button) folded before Flop (didn't bet)
Seat 7: hichnick777 (small blind) folded before Flop
Seat 8: zafstop (big blind) folded before Flop
Seat 9: guirib8ir0 folded before Flop (didn't bet)


*********** # 183 **************
PokerStars Hand #176676133412: Tournament #2054568934, $20+$2 USD Hold'em No Limit - Level XXIII (2500/5000) - 2017/10/09 3:09:01 MSK [2017/10/08 20:09:01 ET]
Table '2054568934 506' 9-max Seat #7 is the button
Seat 1: zozitimo (109076 in chips)
Seat 2: Perke0 (130442 in chips)
Seat 3: romk@vip (318868 in chips)
Seat 5: welcat (94309 in chips)
Seat 6: EZCoinFlip (48010 in chips)
Seat 7: hichnick777 (331768 in chips)
Seat 8: zafstop (678390 in chips)
Seat 9: guirib8ir0 (232172 in chips)
zozitimo: posts the ante 500
Perke0: posts the ante 500
romk@vip: posts the ante 500
welcat: posts the ante 500
EZCoinFlip: posts the ante 500
hichnick777: posts the ante 500
zafstop: posts the ante 500
guirib8ir0: posts the ante 500
zafstop: posts small blind 2500
guirib8ir0: posts big blind 5000
*** HOLE CARDS ***
Dealt to hichnick777 [Qh 2h]
zozitimo: folds
Perke0: folds
romk@vip: folds
welcat: folds
EZCoinFlip: raises 42510 to 47510 and is all-in
hichnick777: folds
zafstop: folds
guirib8ir0: folds
Uncalled bet (42510) returned to EZCoinFlip
EZCoinFlip collected 16500 from pot
EZCoinFlip: doesn't show hand
*** SUMMARY ***
Total pot 16500 | Rake 0
Seat 1: zozitimo folded before Flop (didn't bet)
Seat 2: Perke0 folded before Flop (didn't bet)
Seat 3: romk@vip folded before Flop (didn't bet)
Seat 5: welcat folded before Flop (didn't bet)
Seat 6: EZCoinFlip collected (16500)
Seat 7: hichnick777 (button) folded before Flop (didn't bet)
Seat 8: zafstop (small blind) folded before Flop
Seat 9: guirib8ir0 (big blind) folded before Flop


*********** # 184 **************
PokerStars Hand #176676147122: Tournament #2054568934, $20+$2 USD Hold'em No Limit - Level XXIII (2500/5000) - 2017/10/09 3:09:30 MSK [2017/10/08 20:09:30 ET]
Table '2054568934 506' 9-max Seat #8 is the button
Seat 1: zozitimo (108576 in chips)
Seat 2: Perke0 (129942 in chips)
Seat 3: romk@vip (318368 in chips)
Seat 4: themasteryan (558285 in chips)
Seat 5: welcat (93809 in chips)
Seat 6: EZCoinFlip (59010 in chips)
Seat 7: hichnick777 (331268 in chips)
Seat 8: zafstop (675390 in chips)
Seat 9: guirib8ir0 (226672 in chips)
zozitimo: posts the ante 500
Perke0: posts the ante 500
romk@vip: posts the ante 500
themasteryan: posts the ante 500
welcat: posts the ante 500
EZCoinFlip: posts the ante 500
hichnick777: posts the ante 500
zafstop: posts the ante 500
guirib8ir0: posts the ante 500
guirib8ir0: posts small blind 2500
zozitimo: posts big blind 5000
*** HOLE CARDS ***
Dealt to hichnick777 [Ks 5s]
Perke0: folds
romk@vip: folds
themasteryan: folds
welcat: raises 5000 to 10000
EZCoinFlip: folds
hichnick777: folds
zafstop: folds
guirib8ir0: folds
zozitimo: folds
Uncalled bet (5000) returned to welcat
welcat collected 17000 from pot
welcat: doesn't show hand
*** SUMMARY ***
Total pot 17000 | Rake 0
Seat 1: zozitimo (big blind) folded before Flop
Seat 2: Perke0 folded before Flop (didn't bet)
Seat 3: romk@vip folded before Flop (didn't bet)
Seat 4: themasteryan folded before Flop (didn't bet)
Seat 5: welcat collected (17000)
Seat 6: EZCoinFlip folded before Flop (didn't bet)
Seat 7: hichnick777 folded before Flop (didn't bet)
Seat 8: zafstop (button) folded before Flop (didn't bet)
Seat 9: guirib8ir0 (small blind) folded before Flop


*********** # 185 **************
PokerStars Hand #176676165385: Tournament #2054568934, $20+$2 USD Hold'em No Limit - Level XXIII (2500/5000) - 2017/10/09 3:10:09 MSK [2017/10/08 20:10:09 ET]
Table '2054568934 506' 9-max Seat #9 is the button
Seat 1: zozitimo (103076 in chips)
Seat 2: Perke0 (129442 in chips)
Seat 3: romk@vip (317868 in chips)
Seat 4: themasteryan (557785 in chips)
Seat 5: welcat (105309 in chips)
Seat 6: EZCoinFlip (58510 in chips)
Seat 7: hichnick777 (330768 in chips)
Seat 8: zafstop (674890 in chips)
Seat 9: guirib8ir0 (223672 in chips)
zozitimo: posts the ante 500
Perke0: posts the ante 500
romk@vip: posts the ante 500
themasteryan: posts the ante 500
welcat: posts the ante 500
EZCoinFlip: posts the ante 500
hichnick777: posts the ante 500
zafstop: posts the ante 500
guirib8ir0: posts the ante 500
zozitimo: posts small blind 2500
Perke0: posts big blind 5000
*** HOLE CARDS ***
Dealt to hichnick777 [4c Ah]
romk@vip: folds
themasteryan: folds
welcat: folds
EZCoinFlip: folds
hichnick777: folds
zafstop: folds
guirib8ir0: raises 5000 to 10000
zozitimo: folds
Perke0: folds
Uncalled bet (5000) returned to guirib8ir0
guirib8ir0 collected 17000 from pot
guirib8ir0: doesn't show hand
*** SUMMARY ***
Total pot 17000 | Rake 0
Seat 1: zozitimo (small blind) folded before Flop
Seat 2: Perke0 (big blind) folded before Flop
Seat 3: romk@vip folded before Flop (didn't bet)
Seat 4: themasteryan folded before Flop (didn't bet)
Seat 5: welcat folded before Flop (didn't bet)
Seat 6: EZCoinFlip folded before Flop (didn't bet)
Seat 7: hichnick777 folded before Flop (didn't bet)
Seat 8: zafstop folded before Flop (didn't bet)
Seat 9: guirib8ir0 (button) collected (17000)


*********** # 186 **************
PokerStars Hand #176676184132: Tournament #2054568934, $20+$2 USD Hold'em No Limit - Level XXIII (2500/5000) - 2017/10/09 3:10:50 MSK [2017/10/08 20:10:50 ET]
Table '2054568934 506' 9-max Seat #1 is the button
Seat 1: zozitimo (100076 in chips)
Seat 2: Perke0 (123942 in chips)
Seat 3: romk@vip (317368 in chips)
Seat 4: themasteryan (557285 in chips)
Seat 5: welcat (104809 in chips)
Seat 6: EZCoinFlip (58010 in chips)
Seat 7: hichnick777 (330268 in chips)
Seat 8: zafstop (674390 in chips)
Seat 9: guirib8ir0 (235172 in chips)
zozitimo: posts the ante 500
Perke0: posts the ante 500
romk@vip: posts the ante 500
themasteryan: posts the ante 500
welcat: posts the ante 500
EZCoinFlip: posts the ante 500
hichnick777: posts the ante 500
zafstop: posts the ante 500
guirib8ir0: posts the ante 500
Perke0: posts small blind 2500
romk@vip: posts big blind 5000
*** HOLE CARDS ***
Dealt to hichnick777 [2d Kh]
themasteryan: folds
welcat: folds
EZCoinFlip: raises 52510 to 57510 and is all-in
hichnick777: folds
zafstop: folds
guirib8ir0: folds
zozitimo: folds
Perke0: folds
romk@vip: folds
Uncalled bet (52510) returned to EZCoinFlip
EZCoinFlip collected 17000 from pot
EZCoinFlip: doesn't show hand
*** SUMMARY ***
Total pot 17000 | Rake 0
Seat 1: zozitimo (button) folded before Flop (didn't bet)
Seat 2: Perke0 (small blind) folded before Flop
Seat 3: romk@vip (big blind) folded before Flop
Seat 4: themasteryan folded before Flop (didn't bet)
Seat 5: welcat folded before Flop (didn't bet)
Seat 6: EZCoinFlip collected (17000)
Seat 7: hichnick777 folded before Flop (didn't bet)
Seat 8: zafstop folded before Flop (didn't bet)
Seat 9: guirib8ir0 folded before Flop (didn't bet)


*********** # 187 **************
PokerStars Hand #176676198135: Tournament #2054568934, $20+$2 USD Hold'em No Limit - Level XXIII (2500/5000) - 2017/10/09 3:11:19 MSK [2017/10/08 20:11:19 ET]
Table '2054568934 506' 9-max Seat #2 is the button
Seat 1: zozitimo (99576 in chips)
Seat 2: Perke0 (120942 in chips)
Seat 3: romk@vip (311868 in chips)
Seat 4: themasteryan (556785 in chips)
Seat 5: welcat (104309 in chips)
Seat 6: EZCoinFlip (69510 in chips)
Seat 7: hichnick777 (329768 in chips)
Seat 8: zafstop (673890 in chips)
Seat 9: guirib8ir0 (234672 in chips)
zozitimo: posts the ante 500
Perke0: posts the ante 500
romk@vip: posts the ante 500
themasteryan: posts the ante 500
welcat: posts the ante 500
EZCoinFlip: posts the ante 500
hichnick777: posts the ante 500
zafstop: posts the ante 500
guirib8ir0: posts the ante 500
romk@vip: posts small blind 2500
themasteryan: posts big blind 5000
*** HOLE CARDS ***
Dealt to hichnick777 [7h Jh]
welcat: raises 5000 to 10000
EZCoinFlip: folds
hichnick777: folds
zafstop: folds
guirib8ir0: folds
zozitimo: folds
Perke0: folds
romk@vip: raises 17500 to 27500
themasteryan: folds
welcat: raises 76309 to 103809 and is all-in
romk@vip: folds
Uncalled bet (76309) returned to welcat
welcat collected 64500 from pot
welcat: doesn't show hand
*** SUMMARY ***
Total pot 64500 | Rake 0
Seat 1: zozitimo folded before Flop (didn't bet)
Seat 2: Perke0 (button) folded before Flop (didn't bet)
Seat 3: romk@vip (small blind) folded before Flop
Seat 4: themasteryan (big blind) folded before Flop
Seat 5: welcat collected (64500)
Seat 6: EZCoinFlip folded before Flop (didn't bet)
Seat 7: hichnick777 folded before Flop (didn't bet)
Seat 8: zafstop folded before Flop (didn't bet)
Seat 9: guirib8ir0 folded before Flop (didn't bet)


*********** # 188 **************
PokerStars Hand #176676229243: Tournament #2054568934, $20+$2 USD Hold'em No Limit - Level XXIII (2500/5000) - 2017/10/09 3:12:26 MSK [2017/10/08 20:12:26 ET]
Table '2054568934 506' 9-max Seat #3 is the button
Seat 1: zozitimo (99076 in chips)
Seat 2: Perke0 (120442 in chips)
Seat 3: romk@vip (283868 in chips)
Seat 4: themasteryan (551285 in chips)
Seat 5: welcat (140809 in chips)
Seat 6: EZCoinFlip (69010 in chips)
Seat 7: hichnick777 (329268 in chips)
Seat 8: zafstop (673390 in chips)
Seat 9: guirib8ir0 (234172 in chips)
zozitimo: posts the ante 500
Perke0: posts the ante 500
romk@vip: posts the ante 500
themasteryan: posts the ante 500
welcat: posts the ante 500
EZCoinFlip: posts the ante 500
hichnick777: posts the ante 500
zafstop: posts the ante 500
guirib8ir0: posts the ante 500
themasteryan: posts small blind 2500
welcat: posts big blind 5000
*** HOLE CARDS ***
Dealt to hichnick777 [6c 4d]
EZCoinFlip: folds
hichnick777: folds
zafstop: folds
guirib8ir0: raises 5000 to 10000
zozitimo: folds
Perke0: folds
romk@vip: folds
themasteryan: folds
welcat: calls 5000
*** FLOP *** [Ah As 3c]
welcat: checks
guirib8ir0: checks
*** TURN *** [Ah As 3c] [7h]
welcat: bets 13500
guirib8ir0: calls 13500
*** RIVER *** [Ah As 3c 7h] [6s]
welcat: bets 30000
guirib8ir0: calls 30000
*** SHOW DOWN ***
welcat: shows [3d Ad] (a full house, Aces full of Threes)
guirib8ir0: mucks hand
welcat collected 114000 from pot
*** SUMMARY ***
Total pot 114000 | Rake 0
Board [Ah As 3c 7h 6s]
Seat 1: zozitimo folded before Flop (didn't bet)
Seat 2: Perke0 folded before Flop (didn't bet)
Seat 3: romk@vip (button) folded before Flop (didn't bet)
Seat 4: themasteryan (small blind) folded before Flop
Seat 5: welcat (big blind) showed [3d Ad] and won (114000) with a full house, Aces full of Threes
Seat 6: EZCoinFlip folded before Flop (didn't bet)
Seat 7: hichnick777 folded before Flop (didn't bet)
Seat 8: zafstop folded before Flop (didn't bet)
Seat 9: guirib8ir0 mucked [Qc Qd]


*********** # 189 **************
PokerStars Hand #176676276879: Tournament #2054568934, $20+$2 USD Hold'em No Limit - Level XXIV (3000/6000) - 2017/10/09 3:14:09 MSK [2017/10/08 20:14:09 ET]
Table '2054568934 506' 9-max Seat #4 is the button
Seat 1: zozitimo (98576 in chips)
Seat 2: Perke0 (119942 in chips)
Seat 3: romk@vip (283368 in chips)
Seat 4: themasteryan (548285 in chips)
Seat 5: welcat (200809 in chips)
Seat 6: EZCoinFlip (68510 in chips)
Seat 7: hichnick777 (328768 in chips)
Seat 8: zafstop (672890 in chips)
Seat 9: guirib8ir0 (180172 in chips)
zozitimo: posts the ante 600
Perke0: posts the ante 600
romk@vip: posts the ante 600
themasteryan: posts the ante 600
welcat: posts the ante 600
EZCoinFlip: posts the ante 600
hichnick777: posts the ante 600
zafstop: posts the ante 600
guirib8ir0: posts the ante 600
welcat: posts small blind 3000
EZCoinFlip: posts big blind 6000
*** HOLE CARDS ***
Dealt to hichnick777 [8d Kh]
hichnick777: folds
zafstop: folds
guirib8ir0: folds
zozitimo: folds
Perke0: folds
romk@vip: folds
themasteryan: calls 6000
welcat: calls 3000
EZCoinFlip: checks
*** FLOP *** [Ah 5s 7c]
welcat: checks
EZCoinFlip: checks
themasteryan: bets 9285
welcat: folds
EZCoinFlip: folds
Uncalled bet (9285) returned to themasteryan
themasteryan collected 23400 from pot
themasteryan: doesn't show hand
*** SUMMARY ***
Total pot 23400 | Rake 0
Board [Ah 5s 7c]
Seat 1: zozitimo folded before Flop (didn't bet)
Seat 2: Perke0 folded before Flop (didn't bet)
Seat 3: romk@vip folded before Flop (didn't bet)
Seat 4: themasteryan (button) collected (23400)
Seat 5: welcat (small blind) folded on the Flop
Seat 6: EZCoinFlip (big blind) folded on the Flop
Seat 7: hichnick777 folded before Flop (didn't bet)
Seat 8: zafstop folded before Flop (didn't bet)
Seat 9: guirib8ir0 folded before Flop (didn't bet)


*********** # 190 **************
PokerStars Hand #176676303989: Tournament #2054568934, $20+$2 USD Hold'em No Limit - Level XXIV (3000/6000) - 2017/10/09 3:15:08 MSK [2017/10/08 20:15:08 ET]
Table '2054568934 506' 9-max Seat #5 is the button
Seat 1: zozitimo (97976 in chips)
Seat 2: Perke0 (119342 in chips)
Seat 3: romk@vip (282768 in chips)
Seat 4: themasteryan (565085 in chips)
Seat 5: welcat (194209 in chips)
Seat 6: EZCoinFlip (61910 in chips)
Seat 7: hichnick777 (328168 in chips)
Seat 8: zafstop (672290 in chips)
Seat 9: guirib8ir0 (179572 in chips)
zozitimo: posts the ante 600
Perke0: posts the ante 600
romk@vip: posts the ante 600
themasteryan: posts the ante 600
welcat: posts the ante 600
EZCoinFlip: posts the ante 600
hichnick777: posts the ante 600
zafstop: posts the ante 600
guirib8ir0: posts the ante 600
EZCoinFlip: posts small blind 3000
hichnick777: posts big blind 6000
*** HOLE CARDS ***
Dealt to hichnick777 [Ah Qh]
zafstop: folds
guirib8ir0: folds
zozitimo: folds
Perke0: folds
romk@vip: folds
themasteryan: folds
welcat: raises 6000 to 12000
EZCoinFlip: folds
hichnick777: raises 24000 to 36000
welcat: folds
Uncalled bet (24000) returned to hichnick777
hichnick777 collected 32400 from pot
hichnick777: doesn't show hand
*** SUMMARY ***
Total pot 32400 | Rake 0
Seat 1: zozitimo folded before Flop (didn't bet)
Seat 2: Perke0 folded before Flop (didn't bet)
Seat 3: romk@vip folded before Flop (didn't bet)
Seat 4: themasteryan folded before Flop (didn't bet)
Seat 5: welcat (button) folded before Flop
Seat 6: EZCoinFlip (small blind) folded before Flop
Seat 7: hichnick777 (big blind) collected (32400)
Seat 8: zafstop folded before Flop (didn't bet)
Seat 9: guirib8ir0 folded before Flop (didn't bet)


*********** # 191 **************
PokerStars Hand #176676327003: Tournament #2054568934, $20+$2 USD Hold'em No Limit - Level XXIV (3000/6000) - 2017/10/09 3:15:58 MSK [2017/10/08 20:15:58 ET]
Table '2054568934 506' 9-max Seat #6 is the button
Seat 1: zozitimo (97376 in chips)
Seat 2: Perke0 (118742 in chips)
Seat 3: romk@vip (282168 in chips)
Seat 4: themasteryan (564485 in chips)
Seat 5: welcat (181609 in chips)
Seat 6: EZCoinFlip (58310 in chips)
Seat 7: hichnick777 (347968 in chips)
Seat 8: zafstop (671690 in chips)
Seat 9: guirib8ir0 (178972 in chips)
zozitimo: posts the ante 600
Perke0: posts the ante 600
romk@vip: posts the ante 600
themasteryan: posts the ante 600
welcat: posts the ante 600
EZCoinFlip: posts the ante 600
hichnick777: posts the ante 600
zafstop: posts the ante 600
guirib8ir0: posts the ante 600
hichnick777: posts small blind 3000
zafstop: posts big blind 6000
*** HOLE CARDS ***
Dealt to hichnick777 [9s Ac]
guirib8ir0: folds
zozitimo: raises 9000 to 15000
Perke0: folds
romk@vip: calls 15000
themasteryan: folds
welcat: folds
EZCoinFlip: folds
hichnick777: folds
zafstop: calls 9000
*** FLOP *** [2h 2d Ts]
zafstop: checks
zozitimo: checks
romk@vip: bets 18000
zafstop: calls 18000
zozitimo: folds
*** TURN *** [2h 2d Ts] [3d]
zafstop: checks
romk@vip: checks
*** RIVER *** [2h 2d Ts 3d] [7c]
zafstop: bets 36000
romk@vip: calls 36000
*** SHOW DOWN ***
zafstop: shows [Js Th] (two pair, Tens and Deuces)
romk@vip: mucks hand
zafstop collected 161400 from pot
*** SUMMARY ***
Total pot 161400 | Rake 0
Board [2h 2d Ts 3d 7c]
Seat 1: zozitimo folded on the Flop
Seat 2: Perke0 folded before Flop (didn't bet)
Seat 3: romk@vip mucked [6c 6h]
Seat 4: themasteryan folded before Flop (didn't bet)
Seat 5: welcat folded before Flop (didn't bet)
Seat 6: EZCoinFlip (button) folded before Flop (didn't bet)
Seat 7: hichnick777 (small blind) folded before Flop
Seat 8: zafstop (big blind) showed [Js Th] and won (161400) with two pair, Tens and Deuces
Seat 9: guirib8ir0 folded before Flop (didn't bet)


*********** # 192 **************
PokerStars Hand #176676357928: Tournament #2054568934, $20+$2 USD Hold'em No Limit - Level XXIV (3000/6000) - 2017/10/09 3:17:05 MSK [2017/10/08 20:17:05 ET]
Table '2054568934 506' 9-max Seat #7 is the button
Seat 1: zozitimo (81776 in chips)
Seat 2: Perke0 (118142 in chips)
Seat 3: romk@vip (212568 in chips)
Seat 4: themasteryan (563885 in chips)
Seat 5: welcat (181009 in chips)
Seat 6: EZCoinFlip (57710 in chips)
Seat 7: hichnick777 (344368 in chips)
Seat 8: zafstop (763490 in chips)
Seat 9: guirib8ir0 (178372 in chips)
zozitimo: posts the ante 600
Perke0: posts the ante 600
romk@vip: posts the ante 600
themasteryan: posts the ante 600
welcat: posts the ante 600
EZCoinFlip: posts the ante 600
hichnick777: posts the ante 600
zafstop: posts the ante 600
guirib8ir0: posts the ante 600
zafstop: posts small blind 3000
guirib8ir0: posts big blind 6000
*** HOLE CARDS ***
Dealt to hichnick777 [Ah Jd]
zozitimo: raises 20400 to 26400
Perke0: folds
romk@vip: folds
themasteryan: folds
welcat: folds
EZCoinFlip: folds
hichnick777: folds
zafstop: folds
guirib8ir0: folds
Uncalled bet (20400) returned to zozitimo
zozitimo collected 20400 from pot
*** SUMMARY ***
Total pot 20400 | Rake 0
Seat 1: zozitimo collected (20400)
Seat 2: Perke0 folded before Flop (didn't bet)
Seat 3: romk@vip folded before Flop (didn't bet)
Seat 4: themasteryan folded before Flop (didn't bet)
Seat 5: welcat folded before Flop (didn't bet)
Seat 6: EZCoinFlip folded before Flop (didn't bet)
Seat 7: hichnick777 (button) folded before Flop (didn't bet)
Seat 8: zafstop (small blind) folded before Flop
Seat 9: guirib8ir0 (big blind) folded before Flop


*********** # 193 **************
PokerStars Hand #176676369881: Tournament #2054568934, $20+$2 USD Hold'em No Limit - Level XXIV (3000/6000) - 2017/10/09 3:17:31 MSK [2017/10/08 20:17:31 ET]
Table '2054568934 506' 9-max Seat #8 is the button
Seat 1: zozitimo (95576 in chips)
Seat 2: Perke0 (117542 in chips)
Seat 3: romk@vip (211968 in chips)
Seat 4: themasteryan (563285 in chips)
Seat 5: welcat (180409 in chips)
Seat 6: EZCoinFlip (57110 in chips)
Seat 7: hichnick777 (343768 in chips)
Seat 8: zafstop (759890 in chips)
Seat 9: guirib8ir0 (171772 in chips)
zozitimo: posts the ante 600
Perke0: posts the ante 600
romk@vip: posts the ante 600
themasteryan: posts the ante 600
welcat: posts the ante 600
EZCoinFlip: posts the ante 600
hichnick777: posts the ante 600
zafstop: posts the ante 600
guirib8ir0: posts the ante 600
guirib8ir0: posts small blind 3000
zozitimo: posts big blind 6000
*** HOLE CARDS ***
Dealt to hichnick777 [Jc 3s]
Perke0: raises 6000 to 12000
romk@vip: folds
themasteryan: folds
welcat: folds
EZCoinFlip: folds
hichnick777: folds
zafstop: folds
guirib8ir0: calls 9000
zozitimo: calls 6000
*** FLOP *** [Kd 6d 7c]
guirib8ir0: checks
zozitimo: checks
Perke0: bets 22700
guirib8ir0: folds
zozitimo: calls 22700
*** TURN *** [Kd 6d 7c] [Jh]
zozitimo: checks
Perke0: bets 82242 and is all-in
zozitimo: folds
Uncalled bet (82242) returned to Perke0
Perke0 collected 86800 from pot
Perke0: doesn't show hand
*** SUMMARY ***
Total pot 86800 | Rake 0
Board [Kd 6d 7c Jh]
Seat 1: zozitimo (big blind) folded on the Turn
Seat 2: Perke0 collected (86800)
Seat 3: romk@vip folded before Flop (didn't bet)
Seat 4: themasteryan folded before Flop (didn't bet)
Seat 5: welcat folded before Flop (didn't bet)
Seat 6: EZCoinFlip folded before Flop (didn't bet)
Seat 7: hichnick777 folded before Flop (didn't bet)
Seat 8: zafstop (button) folded before Flop (didn't bet)
Seat 9: guirib8ir0 (small blind) folded on the Flop


*********** # 194 **************
PokerStars Hand #176676410893: Tournament #2054568934, $20+$2 USD Hold'em No Limit - Level XXIV (3000/6000) - 2017/10/09 3:19:01 MSK [2017/10/08 20:19:01 ET]
Table '2054568934 506' 9-max Seat #9 is the button
Seat 1: zozitimo (60276 in chips)
Seat 2: Perke0 (169042 in chips)
Seat 3: romk@vip (211368 in chips)
Seat 4: themasteryan (562685 in chips)
Seat 5: welcat (179809 in chips)
Seat 6: EZCoinFlip (56510 in chips)
Seat 7: hichnick777 (343168 in chips)
Seat 8: zafstop (759290 in chips)
Seat 9: guirib8ir0 (159172 in chips)
zozitimo: posts the ante 600
Perke0: posts the ante 600
romk@vip: posts the ante 600
themasteryan: posts the ante 600
welcat: posts the ante 600
EZCoinFlip: posts the ante 600
hichnick777: posts the ante 600
zafstop: posts the ante 600
guirib8ir0: posts the ante 600
zozitimo: posts small blind 3000
Perke0: posts big blind 6000
*** HOLE CARDS ***
Dealt to hichnick777 [8h Qs]
romk@vip: folds
themasteryan: folds
welcat: folds
EZCoinFlip: folds
hichnick777: folds
zafstop: folds
guirib8ir0: raises 6000 to 12000
zozitimo: calls 9000
Perke0: raises 27577 to 39577
guirib8ir0: folds
zozitimo: calls 27577
*** FLOP *** [6h 4d 5h]
zozitimo: bets 20099 and is all-in
Perke0: calls 20099
*** TURN *** [6h 4d 5h] [As]
*** RIVER *** [6h 4d 5h As] [Ad]
*** SHOW DOWN ***
zozitimo: shows [7d 6c] (two pair, Aces and Sixes)
Perke0: shows [9h Ah] (three of a kind, Aces)
Perke0 collected 136752 from pot
zozitimo finished the tournament in 425th place and received $66.95.
*** SUMMARY ***
Total pot 136752 | Rake 0
Board [6h 4d 5h As Ad]
Seat 1: zozitimo (small blind) showed [7d 6c] and lost with two pair, Aces and Sixes
Seat 2: Perke0 (big blind) showed [9h Ah] and won (136752) with three of a kind, Aces
Seat 3: romk@vip folded before Flop (didn't bet)
Seat 4: themasteryan folded before Flop (didn't bet)
Seat 5: welcat folded before Flop (didn't bet)
Seat 6: EZCoinFlip folded before Flop (didn't bet)
Seat 7: hichnick777 folded before Flop (didn't bet)
Seat 8: zafstop folded before Flop (didn't bet)
Seat 9: guirib8ir0 (button) folded before Flop


*********** # 195 **************
PokerStars Hand #176676440140: Tournament #2054568934, $20+$2 USD Hold'em No Limit - Level XXIV (3000/6000) - 2017/10/09 3:20:06 MSK [2017/10/08 20:20:06 ET]
Table '2054568934 506' 9-max Seat #2 is the button
Seat 1: wesol05 (264212 in chips)
Seat 2: Perke0 (245518 in chips)
Seat 3: romk@vip (210768 in chips)
Seat 4: themasteryan (562085 in chips)
Seat 5: welcat (179209 in chips)
Seat 6: EZCoinFlip (55910 in chips)
Seat 7: hichnick777 (342568 in chips)
Seat 8: zafstop (758690 in chips)
Seat 9: guirib8ir0 (146572 in chips)
wesol05: posts the ante 600
Perke0: posts the ante 600
romk@vip: posts the ante 600
themasteryan: posts the ante 600
welcat: posts the ante 600
EZCoinFlip: posts the ante 600
hichnick777: posts the ante 600
zafstop: posts the ante 600
guirib8ir0: posts the ante 600
romk@vip: posts small blind 3000
themasteryan: posts big blind 6000
*** HOLE CARDS ***
Dealt to hichnick777 [8d Ks]
welcat: folds
EZCoinFlip: raises 49310 to 55310 and is all-in
hichnick777: folds
zafstop: folds
guirib8ir0: folds
wesol05 is connected
wesol05: folds
Perke0: folds
romk@vip: folds
themasteryan: folds
Uncalled bet (49310) returned to EZCoinFlip
EZCoinFlip collected 20400 from pot
EZCoinFlip: doesn't show hand
*** SUMMARY ***
Total pot 20400 | Rake 0
Seat 1: wesol05 folded before Flop (didn't bet)
Seat 2: Perke0 (button) folded before Flop (didn't bet)
Seat 3: romk@vip (small blind) folded before Flop
Seat 4: themasteryan (big blind) folded before Flop
Seat 5: welcat folded before Flop (didn't bet)
Seat 6: EZCoinFlip collected (20400)
Seat 7: hichnick777 folded before Flop (didn't bet)
Seat 8: zafstop folded before Flop (didn't bet)
Seat 9: guirib8ir0 folded before Flop (didn't bet)


*********** # 196 **************
PokerStars Hand #176676459194: Tournament #2054568934, $20+$2 USD Hold'em No Limit - Level XXIV (3000/6000) - 2017/10/09 3:20:49 MSK [2017/10/08 20:20:49 ET]
Table '2054568934 506' 9-max Seat #3 is the button
Seat 1: wesol05 (263612 in chips)
Seat 2: Perke0 (244918 in chips)
Seat 3: romk@vip (207168 in chips)
Seat 4: themasteryan (555485 in chips)
Seat 5: welcat (178609 in chips)
Seat 6: EZCoinFlip (69710 in chips)
Seat 7: hichnick777 (341968 in chips)
Seat 8: zafstop (758090 in chips)
Seat 9: guirib8ir0 (145972 in chips)
wesol05: posts the ante 600
Perke0: posts the ante 600
romk@vip: posts the ante 600
themasteryan: posts the ante 600
welcat: posts the ante 600
EZCoinFlip: posts the ante 600
hichnick777: posts the ante 600
zafstop: posts the ante 600
guirib8ir0: posts the ante 600
themasteryan: posts small blind 3000
welcat: posts big blind 6000
*** HOLE CARDS ***
Dealt to hichnick777 [7c 5h]
EZCoinFlip: folds
hichnick777: folds
zafstop: folds
guirib8ir0: folds
wesol05: raises 9000 to 15000
Perke0: folds
romk@vip: calls 15000
themasteryan: folds
welcat: folds
*** FLOP *** [Kh 2d As]
wesol05: checks
romk@vip: checks
*** TURN *** [Kh 2d As] [9d]
wesol05: checks
romk@vip: checks
*** RIVER *** [Kh 2d As 9d] [Th]
wesol05: bets 22200
romk@vip: folds
Uncalled bet (22200) returned to wesol05
wesol05 collected 44400 from pot
wesol05: doesn't show hand
*** SUMMARY ***
Total pot 44400 | Rake 0
Board [Kh 2d As 9d Th]
Seat 1: wesol05 collected (44400)
Seat 2: Perke0 folded before Flop (didn't bet)
Seat 3: romk@vip (button) folded on the River
Seat 4: themasteryan (small blind) folded before Flop
Seat 5: welcat (big blind) folded before Flop
Seat 6: EZCoinFlip folded before Flop (didn't bet)
Seat 7: hichnick777 folded before Flop (didn't bet)
Seat 8: zafstop folded before Flop (didn't bet)
Seat 9: guirib8ir0 folded before Flop (didn't bet)


*********** # 197 **************
PokerStars Hand #176676490348: Tournament #2054568934, $20+$2 USD Hold'em No Limit - Level XXIV (3000/6000) - 2017/10/09 3:21:58 MSK [2017/10/08 20:21:58 ET]
Table '2054568934 506' 9-max Seat #4 is the button
Seat 1: wesol05 (292412 in chips)
Seat 2: Perke0 (244318 in chips)
Seat 3: romk@vip (191568 in chips)
Seat 4: themasteryan (551885 in chips)
Seat 5: welcat (172009 in chips)
Seat 6: EZCoinFlip (69110 in chips)
Seat 7: hichnick777 (341368 in chips)
Seat 8: zafstop (757490 in chips)
Seat 9: guirib8ir0 (145372 in chips)
wesol05: posts the ante 600
Perke0: posts the ante 600
romk@vip: posts the ante 600
themasteryan: posts the ante 600
welcat: posts the ante 600
EZCoinFlip: posts the ante 600
hichnick777: posts the ante 600
zafstop: posts the ante 600
guirib8ir0: posts the ante 600
welcat: posts small blind 3000
EZCoinFlip: posts big blind 6000
*** HOLE CARDS ***
Dealt to hichnick777 [6d 7c]
hichnick777: folds
zafstop: folds
guirib8ir0: folds
wesol05: folds
Perke0: raises 6000 to 12000
romk@vip: folds
themasteryan: folds
welcat: folds
EZCoinFlip: calls 6000
*** FLOP *** [8s Ts 9h]
EZCoinFlip: checks
Perke0: bets 18000
EZCoinFlip: raises 38510 to 56510 and is all-in
Perke0: calls 38510
*** TURN *** [8s Ts 9h] [2c]
*** RIVER *** [8s Ts 9h 2c] [Js]
*** SHOW DOWN ***
EZCoinFlip: shows [Jh Tc] (two pair, Jacks and Tens)
Perke0: shows [7h 7s] (a straight, Seven to Jack)
Perke0 collected 145420 from pot
EZCoinFlip finished the tournament in 410th place and received $66.95.
*** SUMMARY ***
Total pot 145420 | Rake 0
Board [8s Ts 9h 2c Js]
Seat 1: wesol05 folded before Flop (didn't bet)
Seat 2: Perke0 showed [7h 7s] and won (145420) with a straight, Seven to Jack
Seat 3: romk@vip folded before Flop (didn't bet)
Seat 4: themasteryan (button) folded before Flop (didn't bet)
Seat 5: welcat (small blind) folded before Flop
Seat 6: EZCoinFlip (big blind) showed [Jh Tc] and lost with two pair, Jacks and Tens
Seat 7: hichnick777 folded before Flop (didn't bet)
Seat 8: zafstop folded before Flop (didn't bet)
Seat 9: guirib8ir0 folded before Flop (didn't bet)


*********** # 198 **************
PokerStars Hand #176676510244: Tournament #2054568934, $20+$2 USD Hold'em No Limit - Level XXIV (3000/6000) - 2017/10/09 3:22:43 MSK [2017/10/08 20:22:43 ET]
Table '2054568934 506' 9-max Seat #5 is the button
Seat 1: wesol05 (291812 in chips)
Seat 2: Perke0 (320628 in chips)
Seat 3: romk@vip (190968 in chips)
Seat 4: themasteryan (551285 in chips)
Seat 5: welcat (168409 in chips)
Seat 7: hichnick777 (340768 in chips)
Seat 8: zafstop (756890 in chips)
Seat 9: guirib8ir0 (144772 in chips)
wesol05: posts the ante 600
Perke0: posts the ante 600
romk@vip: posts the ante 600
themasteryan: posts the ante 600
welcat: posts the ante 600
hichnick777: posts the ante 600
zafstop: posts the ante 600
guirib8ir0: posts the ante 600
hichnick777: posts small blind 3000
zafstop: posts big blind 6000
*** HOLE CARDS ***
Dealt to hichnick777 [9c Qh]
guirib8ir0: raises 6000 to 12000
wesol05: calls 12000
Perke0: folds
romk@vip: folds
themasteryan: folds
welcat: folds
hichnick777: folds
zafstop: folds
*** FLOP *** [8d 9s 6h]
guirib8ir0: bets 17388
wesol05: calls 17388
*** TURN *** [8d 9s 6h] [8s]
guirib8ir0: checks
wesol05: bets 36288
guirib8ir0: folds
Uncalled bet (36288) returned to wesol05
wesol05 collected 72576 from pot
wesol05: doesn't show hand
*** SUMMARY ***
Total pot 72576 | Rake 0
Board [8d 9s 6h 8s]
Seat 1: wesol05 collected (72576)
Seat 2: Perke0 folded before Flop (didn't bet)
Seat 3: romk@vip folded before Flop (didn't bet)
Seat 4: themasteryan folded before Flop (didn't bet)
Seat 5: welcat (button) folded before Flop (didn't bet)
Seat 7: hichnick777 (small blind) folded before Flop
Seat 8: zafstop (big blind) folded before Flop
Seat 9: guirib8ir0 folded on the Turn


*********** # 199 **************
PokerStars Hand #176676549782: Tournament #2054568934, $20+$2 USD Hold'em No Limit - Level XXIV (3000/6000) - 2017/10/09 3:24:11 MSK [2017/10/08 20:24:11 ET]
Table '2054568934 506' 9-max Seat #7 is the button
Seat 1: wesol05 (334400 in chips)
Seat 2: Perke0 (320028 in chips)
Seat 3: romk@vip (190368 in chips)
Seat 4: themasteryan (550685 in chips)
Seat 5: welcat (167809 in chips)
Seat 6: marval231 (252328 in chips)
Seat 7: hichnick777 (337168 in chips)
Seat 8: zafstop (750290 in chips)
Seat 9: guirib8ir0 (114784 in chips)
wesol05: posts the ante 600
Perke0: posts the ante 600
romk@vip: posts the ante 600
themasteryan: posts the ante 600
welcat: posts the ante 600
marval231: posts the ante 600
hichnick777: posts the ante 600
zafstop: posts the ante 600
guirib8ir0: posts the ante 600
zafstop: posts small blind 3000
guirib8ir0: posts big blind 6000
*** HOLE CARDS ***
Dealt to hichnick777 [6c 9s]
wesol05: raises 9000 to 15000
Perke0: folds
romk@vip: folds
themasteryan: folds
welcat: folds
marval231: folds
hichnick777: folds
zafstop: folds
guirib8ir0: calls 9000
*** FLOP *** [Jd 5h Tc]
guirib8ir0: checks
wesol05: checks
*** TURN *** [Jd 5h Tc] [Jh]
guirib8ir0: checks
wesol05: bets 19200
guirib8ir0: folds
Uncalled bet (19200) returned to wesol05
wesol05 collected 38400 from pot
wesol05: doesn't show hand
*** SUMMARY ***
Total pot 38400 | Rake 0
Board [Jd 5h Tc Jh]
Seat 1: wesol05 collected (38400)
Seat 2: Perke0 folded before Flop (didn't bet)
Seat 3: romk@vip folded before Flop (didn't bet)
Seat 4: themasteryan folded before Flop (didn't bet)
Seat 5: welcat folded before Flop (didn't bet)
Seat 6: marval231 folded before Flop (didn't bet)
Seat 7: hichnick777 (button) folded before Flop (didn't bet)
Seat 8: zafstop (small blind) folded before Flop
Seat 9: guirib8ir0 (big blind) folded on the Turn


*********** # 200 **************
PokerStars Hand #176676578505: Tournament #2054568934, $20+$2 USD Hold'em No Limit - Level XXV (3500/7000) - 2017/10/09 3:25:15 MSK [2017/10/08 20:25:15 ET]
Table '2054568934 506' 9-max Seat #8 is the button
Seat 1: wesol05 (357200 in chips)
Seat 2: Perke0 (319428 in chips)
Seat 3: romk@vip (189768 in chips)
Seat 4: themasteryan (550085 in chips)
Seat 5: welcat (167209 in chips)
Seat 6: marval231 (251728 in chips)
Seat 7: hichnick777 (336568 in chips)
Seat 8: zafstop (746690 in chips)
Seat 9: guirib8ir0 (99184 in chips)
wesol05: posts the ante 700
Perke0: posts the ante 700
romk@vip: posts the ante 700
themasteryan: posts the ante 700
welcat: posts the ante 700
marval231: posts the ante 700
hichnick777: posts the ante 700
zafstop: posts the ante 700
guirib8ir0: posts the ante 700
guirib8ir0: posts small blind 3500
wesol05: posts big blind 7000
*** HOLE CARDS ***
Dealt to hichnick777 [9h Ad]
Perke0: folds
romk@vip: folds
themasteryan: raises 8185 to 15185
welcat: folds
marval231: folds
hichnick777: folds
zafstop: calls 15185
guirib8ir0: raises 83299 to 98484 and is all-in
wesol05: folds
themasteryan: folds
zafstop: calls 83299
*** FLOP *** [Qc 6h 6c]
*** TURN *** [Qc 6h 6c] [7d]
*** RIVER *** [Qc 6h 6c 7d] [8d]
*** SHOW DOWN ***
guirib8ir0: shows [Qs Qh] (a full house, Queens full of Sixes)
zafstop: shows [4c Ac] (a pair of Sixes)
guirib8ir0 collected 225453 from pot
*** SUMMARY ***
Total pot 225453 | Rake 0
Board [Qc 6h 6c 7d 8d]
Seat 1: wesol05 (big blind) folded before Flop
Seat 2: Perke0 folded before Flop (didn't bet)
Seat 3: romk@vip folded before Flop (didn't bet)
Seat 4: themasteryan folded before Flop
Seat 5: welcat folded before Flop (didn't bet)
Seat 6: marval231 folded before Flop (didn't bet)
Seat 7: hichnick777 folded before Flop (didn't bet)
Seat 8: zafstop (button) showed [4c Ac] and lost with a pair of Sixes
Seat 9: guirib8ir0 (small blind) showed [Qs Qh] and won (225453) with a full house, Queens full of Sixes


*********** # 201 **************
PokerStars Hand #176676603977: Tournament #2054568934, $20+$2 USD Hold'em No Limit - Level XXV (3500/7000) - 2017/10/09 3:26:13 MSK [2017/10/08 20:26:13 ET]
Table '2054568934 506' 9-max Seat #9 is the button
Seat 1: wesol05 (349500 in chips)
Seat 2: Perke0 (318728 in chips)
Seat 3: romk@vip (189068 in chips)
Seat 4: themasteryan (534200 in chips)
Seat 5: welcat (166509 in chips)
Seat 6: marval231 (251028 in chips)
Seat 7: hichnick777 (335868 in chips)
Seat 8: zafstop (647506 in chips)
Seat 9: guirib8ir0 (225453 in chips)
wesol05: posts the ante 700
Perke0: posts the ante 700
romk@vip: posts the ante 700
themasteryan: posts the ante 700
welcat: posts the ante 700
marval231: posts the ante 700
hichnick777: posts the ante 700
zafstop: posts the ante 700
guirib8ir0: posts the ante 700
wesol05: posts small blind 3500
Perke0: posts big blind 7000
*** HOLE CARDS ***
Dealt to hichnick777 [9d Js]
romk@vip: folds
themasteryan: folds
welcat: folds
marval231: folds
hichnick777: folds
zafstop: folds
guirib8ir0: raises 7000 to 14000
wesol05: folds
Perke0: folds
Uncalled bet (7000) returned to guirib8ir0
guirib8ir0 collected 23800 from pot
guirib8ir0: doesn't show hand
*** SUMMARY ***
Total pot 23800 | Rake 0
Seat 1: wesol05 (small blind) folded before Flop
Seat 2: Perke0 (big blind) folded before Flop
Seat 3: romk@vip folded before Flop (didn't bet)
Seat 4: themasteryan folded before Flop (didn't bet)
Seat 5: welcat folded before Flop (didn't bet)
Seat 6: marval231 folded before Flop (didn't bet)
Seat 7: hichnick777 folded before Flop (didn't bet)
Seat 8: zafstop folded before Flop (didn't bet)
Seat 9: guirib8ir0 (button) collected (23800)


*********** # 202 **************
PokerStars Hand #176676617754: Tournament #2054568934, $20+$2 USD Hold'em No Limit - Level XXV (3500/7000) - 2017/10/09 3:26:44 MSK [2017/10/08 20:26:44 ET]
Table '2054568934 506' 9-max Seat #1 is the button
Seat 1: wesol05 (345300 in chips)
Seat 2: Perke0 (311028 in chips)
Seat 3: romk@vip (188368 in chips)
Seat 4: themasteryan (533500 in chips)
Seat 5: welcat (165809 in chips)
Seat 6: marval231 (250328 in chips)
Seat 7: hichnick777 (335168 in chips)
Seat 8: zafstop (646806 in chips)
Seat 9: guirib8ir0 (241553 in chips)
wesol05: posts the ante 700
Perke0: posts the ante 700
romk@vip: posts the ante 700
themasteryan: posts the ante 700
welcat: posts the ante 700
marval231: posts the ante 700
hichnick777: posts the ante 700
zafstop: posts the ante 700
guirib8ir0: posts the ante 700
Perke0: posts small blind 3500
romk@vip: posts big blind 7000
*** HOLE CARDS ***
Dealt to hichnick777 [4d Jc]
themasteryan: folds
welcat: folds
marval231: folds
hichnick777: folds
zafstop: folds
guirib8ir0: raises 7000 to 14000
wesol05: folds
Perke0: raises 31500 to 45500
romk@vip: folds
guirib8ir0: folds
Uncalled bet (31500) returned to Perke0
Perke0 collected 41300 from pot
Perke0: doesn't show hand
*** SUMMARY ***
Total pot 41300 | Rake 0
Seat 1: wesol05 (button) folded before Flop (didn't bet)
Seat 2: Perke0 (small blind) collected (41300)
Seat 3: romk@vip (big blind) folded before Flop
Seat 4: themasteryan folded before Flop (didn't bet)
Seat 5: welcat folded before Flop (didn't bet)
Seat 6: marval231 folded before Flop (didn't bet)
Seat 7: hichnick777 folded before Flop (didn't bet)
Seat 8: zafstop folded before Flop (didn't bet)
Seat 9: guirib8ir0 folded before Flop


*********** # 203 **************
PokerStars Hand #176676650328: Tournament #2054568934, $20+$2 USD Hold'em No Limit - Level XXV (3500/7000) - 2017/10/09 3:27:54 MSK [2017/10/08 20:27:54 ET]
Table '2054568934 506' 9-max Seat #2 is the button
Seat 1: wesol05 (344600 in chips)
Seat 2: Perke0 (337628 in chips)
Seat 3: romk@vip (180668 in chips)
Seat 4: themasteryan (532800 in chips)
Seat 5: welcat (165109 in chips)
Seat 6: marval231 (249628 in chips)
Seat 7: hichnick777 (334468 in chips)
Seat 8: zafstop (646106 in chips)
Seat 9: guirib8ir0 (226853 in chips)
wesol05: posts the ante 700
Perke0: posts the ante 700
romk@vip: posts the ante 700
themasteryan: posts the ante 700
welcat: posts the ante 700
marval231: posts the ante 700
hichnick777: posts the ante 700
zafstop: posts the ante 700
guirib8ir0: posts the ante 700
romk@vip: posts small blind 3500
themasteryan: posts big blind 7000
*** HOLE CARDS ***
Dealt to hichnick777 [Qs 2h]
welcat: folds
marval231: folds
hichnick777: folds
zafstop: folds
guirib8ir0: folds
wesol05: raises 10500 to 17500
Perke0: folds
romk@vip: folds
themasteryan: calls 10500
*** FLOP *** [5d 4s Kh]
themasteryan: checks
wesol05: bets 22400
themasteryan: folds
Uncalled bet (22400) returned to wesol05
wesol05 collected 44800 from pot
wesol05: doesn't show hand
*** SUMMARY ***
Total pot 44800 | Rake 0
Board [5d 4s Kh]
Seat 1: wesol05 collected (44800)
Seat 2: Perke0 (button) folded before Flop (didn't bet)
Seat 3: romk@vip (small blind) folded before Flop
Seat 4: themasteryan (big blind) folded on the Flop
Seat 5: welcat folded before Flop (didn't bet)
Seat 6: marval231 folded before Flop (didn't bet)
Seat 7: hichnick777 folded before Flop (didn't bet)
Seat 8: zafstop folded before Flop (didn't bet)
Seat 9: guirib8ir0 folded before Flop (didn't bet)


*********** # 204 **************
PokerStars Hand #176676673262: Tournament #2054568934, $20+$2 USD Hold'em No Limit - Level XXV (3500/7000) - 2017/10/09 3:28:46 MSK [2017/10/08 20:28:46 ET]
Table '2054568934 506' 9-max Seat #3 is the button
Seat 1: wesol05 (371200 in chips)
Seat 2: Perke0 (336928 in chips)
Seat 3: romk@vip (176468 in chips)
Seat 4: themasteryan (514600 in chips)
Seat 5: welcat (164409 in chips)
Seat 6: marval231 (248928 in chips)
Seat 7: hichnick777 (333768 in chips)
Seat 8: zafstop (645406 in chips)
Seat 9: guirib8ir0 (226153 in chips)
wesol05: posts the ante 700
Perke0: posts the ante 700
romk@vip: posts the ante 700
themasteryan: posts the ante 700
welcat: posts the ante 700
marval231: posts the ante 700
hichnick777: posts the ante 700
zafstop: posts the ante 700
guirib8ir0: posts the ante 700
themasteryan: posts small blind 3500
welcat: posts big blind 7000
*** HOLE CARDS ***
Dealt to hichnick777 [Qs 9s]
marval231: raises 7000 to 14000
hichnick777: folds
zafstop: folds
guirib8ir0: calls 14000
wesol05: raises 38858 to 52858
Perke0: folds
romk@vip: folds
themasteryan: folds
welcat: folds
marval231: folds
guirib8ir0: folds
Uncalled bet (38858) returned to wesol05
wesol05 collected 58800 from pot
wesol05: doesn't show hand
*** SUMMARY ***
Total pot 58800 | Rake 0
Seat 1: wesol05 collected (58800)
Seat 2: Perke0 folded before Flop (didn't bet)
Seat 3: romk@vip (button) folded before Flop (didn't bet)
Seat 4: themasteryan (small blind) folded before Flop
Seat 5: welcat (big blind) folded before Flop
Seat 6: marval231 folded before Flop
Seat 7: hichnick777 folded before Flop (didn't bet)
Seat 8: zafstop folded before Flop (didn't bet)
Seat 9: guirib8ir0 folded before Flop


*********** # 205 **************
PokerStars Hand #176676702104: Tournament #2054568934, $20+$2 USD Hold'em No Limit - Level XXV (3500/7000) - 2017/10/09 3:29:51 MSK [2017/10/08 20:29:51 ET]
Table '2054568934 506' 9-max Seat #4 is the button
Seat 1: wesol05 (415300 in chips)
Seat 2: Perke0 (336228 in chips)
Seat 3: romk@vip (175768 in chips)
Seat 4: themasteryan (510400 in chips)
Seat 5: welcat (156709 in chips)
Seat 6: marval231 (234228 in chips)
Seat 7: hichnick777 (333068 in chips)
Seat 8: zafstop (644706 in chips)
Seat 9: guirib8ir0 (211453 in chips)
wesol05: posts the ante 700
Perke0: posts the ante 700
romk@vip: posts the ante 700
themasteryan: posts the ante 700
welcat: posts the ante 700
marval231: posts the ante 700
hichnick777: posts the ante 700
zafstop: posts the ante 700
guirib8ir0: posts the ante 700
welcat: posts small blind 3500
marval231: posts big blind 7000
*** HOLE CARDS ***
Dealt to hichnick777 [Jh Qc]
hichnick777: raises 8750 to 15750
zafstop: folds
guirib8ir0: folds
wesol05: folds
Perke0: calls 15750
romk@vip: raises 159318 to 175068 and is all-in
themasteryan: folds
welcat: folds
marval231: folds
hichnick777: folds
Perke0: folds
Uncalled bet (159318) returned to romk@vip
romk@vip collected 64050 from pot
*** SUMMARY ***
Total pot 64050 | Rake 0
Seat 1: wesol05 folded before Flop (didn't bet)
Seat 2: Perke0 folded before Flop
Seat 3: romk@vip collected (64050)
Seat 4: themasteryan (button) folded before Flop (didn't bet)
Seat 5: welcat (small blind) folded before Flop
Seat 6: marval231 (big blind) folded before Flop
Seat 7: hichnick777 folded before Flop
Seat 8: zafstop folded before Flop (didn't bet)
Seat 9: guirib8ir0 folded before Flop (didn't bet)


*********** # 206 **************
PokerStars Hand #176676729809: Tournament #2054568934, $20+$2 USD Hold'em No Limit - Level XXV (3500/7000) - 2017/10/09 3:30:54 MSK [2017/10/08 20:30:54 ET]
Table '2054568934 506' 9-max Seat #5 is the button
Seat 1: wesol05 (414600 in chips)
Seat 2: Perke0 (319778 in chips)
Seat 3: romk@vip (223368 in chips)
Seat 4: themasteryan (509700 in chips)
Seat 5: welcat (152509 in chips)
Seat 6: marval231 (226528 in chips)
Seat 7: hichnick777 (316618 in chips)
Seat 8: zafstop (644006 in chips)
Seat 9: guirib8ir0 (210753 in chips)
wesol05: posts the ante 700
Perke0: posts the ante 700
romk@vip: posts the ante 700
themasteryan: posts the ante 700
welcat: posts the ante 700
marval231: posts the ante 700
hichnick777: posts the ante 700
zafstop: posts the ante 700
guirib8ir0: posts the ante 700
marval231: posts small blind 3500
hichnick777: posts big blind 7000
*** HOLE CARDS ***
Dealt to hichnick777 [Qc 3d]
zafstop: folds
guirib8ir0: raises 7000 to 14000
wesol05: folds
Perke0: folds
romk@vip: folds
themasteryan: folds
welcat: folds
marval231: folds
hichnick777: folds
Uncalled bet (7000) returned to guirib8ir0
guirib8ir0 collected 23800 from pot
guirib8ir0: doesn't show hand
*** SUMMARY ***
Total pot 23800 | Rake 0
Seat 1: wesol05 folded before Flop (didn't bet)
Seat 2: Perke0 folded before Flop (didn't bet)
Seat 3: romk@vip folded before Flop (didn't bet)
Seat 4: themasteryan folded before Flop (didn't bet)
Seat 5: welcat (button) folded before Flop (didn't bet)
Seat 6: marval231 (small blind) folded before Flop
Seat 7: hichnick777 (big blind) folded before Flop
Seat 8: zafstop folded before Flop (didn't bet)
Seat 9: guirib8ir0 collected (23800)


*********** # 207 **************
PokerStars Hand #176676753750: Tournament #2054568934, $20+$2 USD Hold'em No Limit - Level XXV (3500/7000) - 2017/10/09 3:31:48 MSK [2017/10/08 20:31:48 ET]
Table '2054568934 506' 9-max Seat #6 is the button
Seat 1: wesol05 (413900 in chips)
Seat 2: Perke0 (319078 in chips)
Seat 3: romk@vip (222668 in chips)
Seat 4: themasteryan (509000 in chips)
Seat 5: welcat (151809 in chips)
Seat 6: marval231 (222328 in chips)
Seat 7: hichnick777 (308918 in chips)
Seat 8: zafstop (643306 in chips)
Seat 9: guirib8ir0 (226853 in chips)
wesol05: posts the ante 700
Perke0: posts the ante 700
romk@vip: posts the ante 700
themasteryan: posts the ante 700
welcat: posts the ante 700
marval231: posts the ante 700
hichnick777: posts the ante 700
zafstop: posts the ante 700
guirib8ir0: posts the ante 700
hichnick777: posts small blind 3500
zafstop: posts big blind 7000
*** HOLE CARDS ***
Dealt to hichnick777 [8h 3h]
guirib8ir0: folds
wesol05: raises 10500 to 17500
Perke0: folds
romk@vip: folds
themasteryan: calls 17500
welcat: folds
marval231 has timed out
marval231: folds
marval231 is sitting out
hichnick777: folds
marval231 has returned
zafstop: calls 10500
*** FLOP *** [Ad 6h 7h]
zafstop: checks
wesol05: checks
themasteryan: bets 24585
zafstop: calls 24585
wesol05: folds
*** TURN *** [Ad 6h 7h] [Jd]
zafstop: checks
themasteryan: bets 46285
zafstop: calls 46285
*** RIVER *** [Ad 6h 7h Jd] [4h]
zafstop: checks
themasteryan: checks
*** SHOW DOWN ***
zafstop: shows [Ah Tc] (a pair of Aces)
themasteryan: shows [6d 7d] (two pair, Sevens and Sixes)
themasteryan collected 204040 from pot
*** SUMMARY ***
Total pot 204040 | Rake 0
Board [Ad 6h 7h Jd 4h]
Seat 1: wesol05 folded on the Flop
Seat 2: Perke0 folded before Flop (didn't bet)
Seat 3: romk@vip folded before Flop (didn't bet)
Seat 4: themasteryan showed [6d 7d] and won (204040) with two pair, Sevens and Sixes
Seat 5: welcat folded before Flop (didn't bet)
Seat 6: marval231 (button) folded before Flop (didn't bet)
Seat 7: hichnick777 (small blind) folded before Flop
Seat 8: zafstop (big blind) showed [Ah Tc] and lost with a pair of Aces
Seat 9: guirib8ir0 folded before Flop (didn't bet)


*********** # 208 **************
PokerStars Hand #176676817460: Tournament #2054568934, $20+$2 USD Hold'em No Limit - Level XXV (3500/7000) - 2017/10/09 3:34:05 MSK [2017/10/08 20:34:05 ET]
Table '2054568934 506' 9-max Seat #7 is the button
Seat 1: wesol05 (395700 in chips)
Seat 2: Perke0 (318378 in chips)
Seat 3: romk@vip (221968 in chips)
Seat 4: themasteryan (623970 in chips)
Seat 5: welcat (151109 in chips)
Seat 6: marval231 (221628 in chips)
Seat 7: hichnick777 (304718 in chips)
Seat 8: zafstop (554236 in chips)
Seat 9: guirib8ir0 (226153 in chips)
wesol05: posts the ante 700
Perke0: posts the ante 700
romk@vip: posts the ante 700
themasteryan: posts the ante 700
welcat: posts the ante 700
marval231: posts the ante 700
hichnick777: posts the ante 700
zafstop: posts the ante 700
guirib8ir0: posts the ante 700
zafstop: posts small blind 3500
guirib8ir0: posts big blind 7000
*** HOLE CARDS ***
Dealt to hichnick777 [9c 7s]
wesol05: folds
Perke0: folds
romk@vip: folds
themasteryan: raises 8085 to 15085
welcat: folds
marval231: folds
hichnick777: folds
zafstop: raises 32585 to 47670
guirib8ir0: folds
themasteryan: calls 32585
*** FLOP *** [Jh 4h Qd]
zafstop: bets 35851
themasteryan: folds
Uncalled bet (35851) returned to zafstop
zafstop collected 108640 from pot
*** SUMMARY ***
Total pot 108640 | Rake 0
Board [Jh 4h Qd]
Seat 1: wesol05 folded before Flop (didn't bet)
Seat 2: Perke0 folded before Flop (didn't bet)
Seat 3: romk@vip folded before Flop (didn't bet)
Seat 4: themasteryan folded on the Flop
Seat 5: welcat folded before Flop (didn't bet)
Seat 6: marval231 folded before Flop (didn't bet)
Seat 7: hichnick777 (button) folded before Flop (didn't bet)
Seat 8: zafstop (small blind) collected (108640)
Seat 9: guirib8ir0 (big blind) folded before Flop


*********** # 209 **************
PokerStars Hand #176676851824: Tournament #2054568934, $20+$2 USD Hold'em No Limit - Level XXV (3500/7000) - 2017/10/09 3:35:24 MSK [2017/10/08 20:35:24 ET]
Table '2054568934 506' 9-max Seat #8 is the button
Seat 1: wesol05 (395000 in chips)
Seat 2: Perke0 (317678 in chips)
Seat 3: romk@vip (221268 in chips)
Seat 4: themasteryan (575600 in chips)
Seat 5: welcat (150409 in chips)
Seat 6: marval231 (220928 in chips)
Seat 7: hichnick777 (304018 in chips)
Seat 8: zafstop (614506 in chips)
Seat 9: guirib8ir0 (218453 in chips)
wesol05: posts the ante 700
Perke0: posts the ante 700
romk@vip: posts the ante 700
themasteryan: posts the ante 700
welcat: posts the ante 700
marval231: posts the ante 700
hichnick777: posts the ante 700
zafstop: posts the ante 700
guirib8ir0: posts the ante 700
guirib8ir0: posts small blind 3500
wesol05: posts big blind 7000
*** HOLE CARDS ***
Dealt to hichnick777 [9c Ah]
Perke0: folds
romk@vip: folds
themasteryan: folds
welcat: folds
marval231: folds
hichnick777: raises 8750 to 15750
zafstop: folds
guirib8ir0: folds
wesol05: calls 8750
*** FLOP *** [Ts 5s 7s]
wesol05: checks
hichnick777: checks
*** TURN *** [Ts 5s 7s] [5d]
wesol05: checks
hichnick777: checks
*** RIVER *** [Ts 5s 7s 5d] [4d]
wesol05: checks
hichnick777: checks
*** SHOW DOWN ***
wesol05: shows [6d 6h] (two pair, Sixes and Fives)
hichnick777: mucks hand
wesol05 collected 41300 from pot
*** SUMMARY ***
Total pot 41300 | Rake 0
Board [Ts 5s 7s 5d 4d]
Seat 1: wesol05 (big blind) showed [6d 6h] and won (41300) with two pair, Sixes and Fives
Seat 2: Perke0 folded before Flop (didn't bet)
Seat 3: romk@vip folded before Flop (didn't bet)
Seat 4: themasteryan folded before Flop (didn't bet)
Seat 5: welcat folded before Flop (didn't bet)
Seat 6: marval231 folded before Flop (didn't bet)
Seat 7: hichnick777 mucked [9c Ah]
Seat 8: zafstop (button) folded before Flop (didn't bet)
Seat 9: guirib8ir0 (small blind) folded before Flop


*********** # 210 **************
PokerStars Hand #176676888288: Tournament #2054568934, $20+$2 USD Hold'em No Limit - Level XXVI (4000/8000) - 2017/10/09 3:36:48 MSK [2017/10/08 20:36:48 ET]
Table '2054568934 506' 9-max Seat #9 is the button
Seat 1: wesol05 (419850 in chips)
Seat 2: Perke0 (316978 in chips)
Seat 3: romk@vip (220568 in chips)
Seat 4: themasteryan (574900 in chips)
Seat 5: welcat (149709 in chips)
Seat 6: marval231 (220228 in chips)
Seat 7: hichnick777 (287568 in chips)
Seat 8: zafstop (613806 in chips)
Seat 9: guirib8ir0 (214253 in chips)
wesol05: posts the ante 800
Perke0: posts the ante 800
romk@vip: posts the ante 800
themasteryan: posts the ante 800
welcat: posts the ante 800
marval231: posts the ante 800
hichnick777: posts the ante 800
zafstop: posts the ante 800
guirib8ir0: posts the ante 800
wesol05: posts small blind 4000
Perke0: posts big blind 8000
*** HOLE CARDS ***
Dealt to hichnick777 [6d 8c]
romk@vip: folds
themasteryan: folds
welcat: folds
marval231: folds
hichnick777: folds
zafstop: raises 12000 to 20000
guirib8ir0: folds
wesol05: calls 16000
Perke0: folds
*** FLOP *** [3d 6s Ts]
wesol05: checks
zafstop: bets 18216
wesol05: folds
Uncalled bet (18216) returned to zafstop
zafstop collected 55200 from pot
*** SUMMARY ***
Total pot 55200 | Rake 0
Board [3d 6s Ts]
Seat 1: wesol05 (small blind) folded on the Flop
Seat 2: Perke0 (big blind) folded before Flop
Seat 3: romk@vip folded before Flop (didn't bet)
Seat 4: themasteryan folded before Flop (didn't bet)
Seat 5: welcat folded before Flop (didn't bet)
Seat 6: marval231 folded before Flop (didn't bet)
Seat 7: hichnick777 folded before Flop (didn't bet)
Seat 8: zafstop collected (55200)
Seat 9: guirib8ir0 (button) folded before Flop (didn't bet)


*********** # 211 **************
PokerStars Hand #176676909217: Tournament #2054568934, $20+$2 USD Hold'em No Limit - Level XXVI (4000/8000) - 2017/10/09 3:37:36 MSK [2017/10/08 20:37:36 ET]
Table '2054568934 506' 9-max Seat #1 is the button
Seat 1: wesol05 (399050 in chips)
Seat 2: Perke0 (308178 in chips)
Seat 3: romk@vip (219768 in chips)
Seat 4: themasteryan (574100 in chips)
Seat 5: welcat (148909 in chips)
Seat 6: marval231 (219428 in chips)
Seat 7: hichnick777 (286768 in chips)
Seat 8: zafstop (648206 in chips)
Seat 9: guirib8ir0 (213453 in chips)
wesol05: posts the ante 800
Perke0: posts the ante 800
romk@vip: posts the ante 800
themasteryan: posts the ante 800
welcat: posts the ante 800
marval231: posts the ante 800
hichnick777: posts the ante 800
zafstop: posts the ante 800
guirib8ir0: posts the ante 800
Perke0: posts small blind 4000
romk@vip: posts big blind 8000
*** HOLE CARDS ***
Dealt to hichnick777 [Qc Ac]
themasteryan: folds
welcat: folds
marval231: folds
hichnick777: raises 10000 to 18000
zafstop: folds
guirib8ir0: raises 23000 to 41000
wesol05: folds
Perke0: folds
romk@vip: folds
hichnick777: calls 23000
*** FLOP *** [Ah 5s 6h]
hichnick777: checks
guirib8ir0: checks
*** TURN *** [Ah 5s 6h] [6d]
hichnick777: bets 58696
guirib8ir0: calls 58696
*** RIVER *** [Ah 5s 6h 6d] [Kd]
hichnick777: checks
guirib8ir0: checks
*** SHOW DOWN ***
hichnick777: shows [Qc Ac] (two pair, Aces and Sixes)
guirib8ir0: shows [Ad Th] (two pair, Aces and Sixes)
hichnick777 collected 109296 from pot
guirib8ir0 collected 109296 from pot
*** SUMMARY ***
Total pot 218592 | Rake 0
Board [Ah 5s 6h 6d Kd]
Seat 1: wesol05 (button) folded before Flop (didn't bet)
Seat 2: Perke0 (small blind) folded before Flop
Seat 3: romk@vip (big blind) folded before Flop
Seat 4: themasteryan folded before Flop (didn't bet)
Seat 5: welcat folded before Flop (didn't bet)
Seat 6: marval231 folded before Flop (didn't bet)
Seat 7: hichnick777 showed [Qc Ac] and won (109296) with two pair, Aces and Sixes
Seat 8: zafstop folded before Flop (didn't bet)
Seat 9: guirib8ir0 showed [Ad Th] and won (109296) with two pair, Aces and Sixes


*********** # 212 **************
PokerStars Hand #176676972530: Tournament #2054568934, $20+$2 USD Hold'em No Limit - Level XXVI (4000/8000) - 2017/10/09 3:40:03 MSK [2017/10/08 20:40:03 ET]
Table '2054568934 506' 9-max Seat #2 is the button
Seat 1: wesol05 (398250 in chips)
Seat 2: Perke0 (303378 in chips)
Seat 3: romk@vip (210968 in chips)
Seat 4: themasteryan (573300 in chips)
Seat 5: welcat (148109 in chips)
Seat 6: marval231 (218628 in chips)
Seat 7: hichnick777 (295568 in chips)
Seat 8: zafstop (647406 in chips)
Seat 9: guirib8ir0 (222253 in chips)
wesol05: posts the ante 800
Perke0: posts the ante 800
romk@vip: posts the ante 800
themasteryan: posts the ante 800
welcat: posts the ante 800
marval231: posts the ante 800
hichnick777: posts the ante 800
zafstop: posts the ante 800
guirib8ir0: posts the ante 800
romk@vip: posts small blind 4000
themasteryan: posts big blind 8000
*** HOLE CARDS ***
Dealt to hichnick777 [9c 8h]
welcat: folds
marval231: folds
hichnick777: folds
zafstop: raises 9600 to 17600
guirib8ir0: raises 24400 to 42000
wesol05: folds
Perke0: folds
romk@vip: folds
themasteryan: folds
zafstop: raises 604606 to 646606 and is all-in
guirib8ir0: calls 179453 and is all-in
Uncalled bet (425153) returned to zafstop
*** FLOP *** [5d 8c Qh]
*** TURN *** [5d 8c Qh] [As]
*** RIVER *** [5d 8c Qh As] [2c]
*** SHOW DOWN ***
zafstop: shows [Js Jd] (a pair of Jacks)
guirib8ir0: shows [Qd Qc] (three of a kind, Queens)
guirib8ir0 collected 462106 from pot
*** SUMMARY ***
Total pot 462106 | Rake 0
Board [5d 8c Qh As 2c]
Seat 1: wesol05 folded before Flop (didn't bet)
Seat 2: Perke0 (button) folded before Flop (didn't bet)
Seat 3: romk@vip (small blind) folded before Flop
Seat 4: themasteryan (big blind) folded before Flop
Seat 5: welcat folded before Flop (didn't bet)
Seat 6: marval231 folded before Flop (didn't bet)
Seat 7: hichnick777 folded before Flop (didn't bet)
Seat 8: zafstop showed [Js Jd] and lost with a pair of Jacks
Seat 9: guirib8ir0 showed [Qd Qc] and won (462106) with three of a kind, Queens


*********** # 213 **************
PokerStars Hand #176676999475: Tournament #2054568934, $20+$2 USD Hold'em No Limit - Level XXVI (4000/8000) - 2017/10/09 3:41:06 MSK [2017/10/08 20:41:06 ET]
Table '2054568934 506' 9-max Seat #3 is the button
Seat 1: wesol05 (397450 in chips)
Seat 2: Perke0 (302578 in chips)
Seat 3: romk@vip (206168 in chips)
Seat 4: themasteryan (564500 in chips)
Seat 5: welcat (147309 in chips)
Seat 6: marval231 (217828 in chips)
Seat 7: hichnick777 (294768 in chips)
Seat 8: zafstop (425153 in chips)
Seat 9: guirib8ir0 (462106 in chips)
wesol05: posts the ante 800
Perke0: posts the ante 800
romk@vip: posts the ante 800
themasteryan: posts the ante 800
welcat: posts the ante 800
marval231: posts the ante 800
hichnick777: posts the ante 800
zafstop: posts the ante 800
guirib8ir0: posts the ante 800
themasteryan: posts small blind 4000
welcat: posts big blind 8000
*** HOLE CARDS ***
Dealt to hichnick777 [Jc 8s]
marval231: folds
hichnick777: folds
zafstop: folds
guirib8ir0: folds
wesol05: folds
Perke0: raises 8000 to 16000
romk@vip: folds
themasteryan: raises 22985 to 38985
welcat: folds
Perke0: folds
Uncalled bet (22985) returned to themasteryan
themasteryan collected 47200 from pot
themasteryan: doesn't show hand
*** SUMMARY ***
Total pot 47200 | Rake 0
Seat 1: wesol05 folded before Flop (didn't bet)
Seat 2: Perke0 folded before Flop
Seat 3: romk@vip (button) folded before Flop (didn't bet)
Seat 4: themasteryan (small blind) collected (47200)
Seat 5: welcat (big blind) folded before Flop
Seat 6: marval231 folded before Flop (didn't bet)
Seat 7: hichnick777 folded before Flop (didn't bet)
Seat 8: zafstop folded before Flop (didn't bet)
Seat 9: guirib8ir0 folded before Flop (didn't bet)


*********** # 214 **************
PokerStars Hand #176677023589: Tournament #2054568934, $20+$2 USD Hold'em No Limit - Level XXVI (4000/8000) - 2017/10/09 3:42:02 MSK [2017/10/08 20:42:02 ET]
Table '2054568934 506' 9-max Seat #4 is the button
Seat 1: wesol05 (396650 in chips)
Seat 2: Perke0 (285778 in chips)
Seat 3: romk@vip (205368 in chips)
Seat 4: themasteryan (594900 in chips)
Seat 5: welcat (138509 in chips)
Seat 6: marval231 (217028 in chips)
Seat 7: hichnick777 (293968 in chips)
Seat 8: zafstop (424353 in chips)
Seat 9: guirib8ir0 (461306 in chips)
wesol05: posts the ante 800
Perke0: posts the ante 800
romk@vip: posts the ante 800
themasteryan: posts the ante 800
welcat: posts the ante 800
marval231: posts the ante 800
hichnick777: posts the ante 800
zafstop: posts the ante 800
guirib8ir0: posts the ante 800
welcat: posts small blind 4000
marval231: posts big blind 8000
*** HOLE CARDS ***
Dealt to hichnick777 [3d 6h]
hichnick777: folds
zafstop: folds
guirib8ir0: folds
wesol05: folds
Perke0: folds
romk@vip: folds
themasteryan: raises 8000 to 16000
welcat: raises 121709 to 137709 and is all-in
marval231: folds
themasteryan: calls 121709
*** FLOP *** [Td Kd 4d]
*** TURN *** [Td Kd 4d] [Ah]
*** RIVER *** [Td Kd 4d Ah] [8c]
*** SHOW DOWN ***
welcat: shows [Js As] (a pair of Aces)
themasteryan: shows [9c 9s] (a pair of Nines)
welcat collected 290618 from pot
*** SUMMARY ***
Total pot 290618 | Rake 0
Board [Td Kd 4d Ah 8c]
Seat 1: wesol05 folded before Flop (didn't bet)
Seat 2: Perke0 folded before Flop (didn't bet)
Seat 3: romk@vip folded before Flop (didn't bet)
Seat 4: themasteryan (button) showed [9c 9s] and lost with a pair of Nines
Seat 5: welcat (small blind) showed [Js As] and won (290618) with a pair of Aces
Seat 6: marval231 (big blind) folded before Flop
Seat 7: hichnick777 folded before Flop (didn't bet)
Seat 8: zafstop folded before Flop (didn't bet)
Seat 9: guirib8ir0 folded before Flop (didn't bet)


*********** # 215 **************
PokerStars Hand #176677040527: Tournament #2054568934, $20+$2 USD Hold'em No Limit - Level XXVI (4000/8000) - 2017/10/09 3:42:42 MSK [2017/10/08 20:42:42 ET]
Table '2054568934 506' 9-max Seat #5 is the button
Seat 1: wesol05 (395850 in chips)
Seat 2: Perke0 (284978 in chips)
Seat 3: romk@vip (204568 in chips)
Seat 4: themasteryan (456391 in chips)
Seat 5: welcat (290618 in chips)
Seat 6: marval231 (208228 in chips)
Seat 7: hichnick777 (293168 in chips)
Seat 8: zafstop (423553 in chips)
Seat 9: guirib8ir0 (460506 in chips)
wesol05: posts the ante 800
Perke0: posts the ante 800
romk@vip: posts the ante 800
themasteryan: posts the ante 800
welcat: posts the ante 800
marval231: posts the ante 800
hichnick777: posts the ante 800
zafstop: posts the ante 800
guirib8ir0: posts the ante 800
marval231: posts small blind 4000
hichnick777: posts big blind 8000
*** HOLE CARDS ***
Dealt to hichnick777 [8h 2c]
zafstop: raises 8000 to 16000
guirib8ir0: folds
wesol05: folds
Perke0: folds
romk@vip: folds
themasteryan: folds
welcat: folds
marval231: folds
hichnick777: folds
Uncalled bet (8000) returned to zafstop
zafstop collected 27200 from pot
*** SUMMARY ***
Total pot 27200 | Rake 0
Seat 1: wesol05 folded before Flop (didn't bet)
Seat 2: Perke0 folded before Flop (didn't bet)
Seat 3: romk@vip folded before Flop (didn't bet)
Seat 4: themasteryan folded before Flop (didn't bet)
Seat 5: welcat (button) folded before Flop (didn't bet)
Seat 6: marval231 (small blind) folded before Flop
Seat 7: hichnick777 (big blind) folded before Flop
Seat 8: zafstop collected (27200)
Seat 9: guirib8ir0 folded before Flop (didn't bet)


*********** # 216 **************
PokerStars Hand #176677051645: Tournament #2054568934, $20+$2 USD Hold'em No Limit - Level XXVI (4000/8000) - 2017/10/09 3:43:08 MSK [2017/10/08 20:43:08 ET]
Table '2054568934 506' 9-max Seat #6 is the button
Seat 1: wesol05 (395050 in chips)
Seat 2: Perke0 (284178 in chips)
Seat 3: romk@vip (203768 in chips)
Seat 4: themasteryan (455591 in chips)
Seat 5: welcat (289818 in chips)
Seat 6: marval231 (203428 in chips)
Seat 7: hichnick777 (284368 in chips)
Seat 8: zafstop (441953 in chips)
Seat 9: guirib8ir0 (459706 in chips)
wesol05: posts the ante 800
Perke0: posts the ante 800
romk@vip: posts the ante 800
themasteryan: posts the ante 800
welcat: posts the ante 800
marval231: posts the ante 800
hichnick777: posts the ante 800
zafstop: posts the ante 800
guirib8ir0: posts the ante 800
hichnick777: posts small blind 4000
zafstop: posts big blind 8000
*** HOLE CARDS ***
Dealt to hichnick777 [8s Jc]
guirib8ir0: folds
wesol05: raises 12000 to 20000
Perke0: folds
romk@vip: raises 32000 to 52000
themasteryan: folds
welcat: folds
marval231: folds
hichnick777: folds
zafstop: folds
wesol05: raises 342250 to 394250 and is all-in
romk@vip: folds
Uncalled bet (342250) returned to wesol05
wesol05 collected 123200 from pot
wesol05: doesn't show hand
*** SUMMARY ***
Total pot 123200 | Rake 0
Seat 1: wesol05 collected (123200)
Seat 2: Perke0 folded before Flop (didn't bet)
Seat 3: romk@vip folded before Flop
Seat 4: themasteryan folded before Flop (didn't bet)
Seat 5: welcat folded before Flop (didn't bet)
Seat 6: marval231 (button) folded before Flop (didn't bet)
Seat 7: hichnick777 (small blind) folded before Flop
Seat 8: zafstop (big blind) folded before Flop
Seat 9: guirib8ir0 folded before Flop (didn't bet)


*********** # 217 **************
PokerStars Hand #176677067036: Tournament #2054568934, $20+$2 USD Hold'em No Limit - Level XXVI (4000/8000) - 2017/10/09 3:43:43 MSK [2017/10/08 20:43:43 ET]
Table '2054568934 506' 9-max Seat #7 is the button
Seat 1: wesol05 (465450 in chips)
Seat 2: Perke0 (283378 in chips)
Seat 3: romk@vip (150968 in chips)
Seat 4: themasteryan (454791 in chips)
Seat 5: welcat (289018 in chips)
Seat 6: marval231 (202628 in chips)
Seat 7: hichnick777 (279568 in chips)
Seat 8: zafstop (433153 in chips)
Seat 9: guirib8ir0 (458906 in chips)
wesol05: posts the ante 800
Perke0: posts the ante 800
romk@vip: posts the ante 800
themasteryan: posts the ante 800
welcat: posts the ante 800
marval231: posts the ante 800
hichnick777: posts the ante 800
zafstop: posts the ante 800
guirib8ir0: posts the ante 800
zafstop: posts small blind 4000
guirib8ir0: posts big blind 8000
*** HOLE CARDS ***
Dealt to hichnick777 [8c 6h]
wesol05: folds
Perke0: folds
romk@vip: folds
themasteryan: folds
welcat: folds
marval231: folds
hichnick777: folds
zafstop: raises 8000 to 16000
guirib8ir0: calls 8000
*** FLOP *** [9d Qc Ad]
zafstop: checks
guirib8ir0: checks
*** TURN *** [9d Qc Ad] [6s]
zafstop: bets 12936
guirib8ir0: folds
Uncalled bet (12936) returned to zafstop
zafstop collected 39200 from pot
*** SUMMARY ***
Total pot 39200 | Rake 0
Board [9d Qc Ad 6s]
Seat 1: wesol05 folded before Flop (didn't bet)
Seat 2: Perke0 folded before Flop (didn't bet)
Seat 3: romk@vip folded before Flop (didn't bet)
Seat 4: themasteryan folded before Flop (didn't bet)
Seat 5: welcat folded before Flop (didn't bet)
Seat 6: marval231 folded before Flop (didn't bet)
Seat 7: hichnick777 (button) folded before Flop (didn't bet)
Seat 8: zafstop (small blind) collected (39200)
Seat 9: guirib8ir0 (big blind) folded on the Turn


*********** # 218 **************
PokerStars Hand #176677099084: Tournament #2054568934, $20+$2 USD Hold'em No Limit - Level XXVI (4000/8000) - 2017/10/09 3:44:59 MSK [2017/10/08 20:44:59 ET]
Table '2054568934 506' 9-max Seat #8 is the button
Seat 1: wesol05 (464650 in chips)
Seat 2: Perke0 (282578 in chips)
Seat 3: romk@vip (150168 in chips)
Seat 4: themasteryan (453991 in chips)
Seat 5: welcat (288218 in chips)
Seat 6: marval231 (201828 in chips)
Seat 7: hichnick777 (278768 in chips)
Seat 8: zafstop (455553 in chips)
Seat 9: guirib8ir0 (442106 in chips)
wesol05: posts the ante 800
Perke0: posts the ante 800
romk@vip: posts the ante 800
themasteryan: posts the ante 800
welcat: posts the ante 800
marval231: posts the ante 800
hichnick777: posts the ante 800
zafstop: posts the ante 800
guirib8ir0: posts the ante 800
guirib8ir0: posts small blind 4000
wesol05: posts big blind 8000
*** HOLE CARDS ***
Dealt to hichnick777 [Td 8s]
Perke0: folds
romk@vip: folds
themasteryan: raises 9785 to 17785
welcat: folds
marval231: folds
hichnick777: folds
zafstop: folds
guirib8ir0: calls 13785
wesol05: folds
*** FLOP *** [Tc 9h Jd]
guirib8ir0: checks
themasteryan: bets 20985
guirib8ir0: calls 20985
*** TURN *** [Tc 9h Jd] [9s]
guirib8ir0: checks
themasteryan: bets 51285
guirib8ir0: calls 51285
*** RIVER *** [Tc 9h Jd 9s] [Qh]
guirib8ir0: checks
themasteryan: bets 88985
guirib8ir0: folds
Uncalled bet (88985) returned to themasteryan
themasteryan collected 195310 from pot
themasteryan: doesn't show hand
*** SUMMARY ***
Total pot 195310 | Rake 0
Board [Tc 9h Jd 9s Qh]
Seat 1: wesol05 (big blind) folded before Flop
Seat 2: Perke0 folded before Flop (didn't bet)
Seat 3: romk@vip folded before Flop (didn't bet)
Seat 4: themasteryan collected (195310)
Seat 5: welcat folded before Flop (didn't bet)
Seat 6: marval231 folded before Flop (didn't bet)
Seat 7: hichnick777 folded before Flop (didn't bet)
Seat 8: zafstop (button) folded before Flop (didn't bet)
Seat 9: guirib8ir0 (small blind) folded on the River


*********** # 219 **************
PokerStars Hand #176677165471: Tournament #2054568934, $20+$2 USD Hold'em No Limit - Level XXVI (4000/8000) - 2017/10/09 3:47:29 MSK [2017/10/08 20:47:29 ET]
Table '2054568934 506' 9-max Seat #9 is the button
Seat 1: wesol05 (455850 in chips)
Seat 2: Perke0 (281778 in chips)
Seat 3: romk@vip (149368 in chips)
Seat 4: themasteryan (558446 in chips)
Seat 5: welcat (287418 in chips)
Seat 6: marval231 (201028 in chips)
Seat 7: hichnick777 (277968 in chips)
Seat 8: zafstop (454753 in chips)
Seat 9: guirib8ir0 (351251 in chips)
wesol05: posts the ante 800
Perke0: posts the ante 800
romk@vip: posts the ante 800
themasteryan: posts the ante 800
welcat: posts the ante 800
marval231: posts the ante 800
hichnick777: posts the ante 800
zafstop: posts the ante 800
guirib8ir0: posts the ante 800
wesol05: posts small blind 4000
Perke0: posts big blind 8000
*** HOLE CARDS ***
Dealt to hichnick777 [Qc 2d]
romk@vip: folds
themasteryan: folds
welcat: folds
marval231: folds
hichnick777: folds
zafstop: folds
guirib8ir0: raises 8000 to 16000
wesol05: folds
Perke0: folds
Uncalled bet (8000) returned to guirib8ir0
guirib8ir0 collected 27200 from pot
guirib8ir0: doesn't show hand
*** SUMMARY ***
Total pot 27200 | Rake 0
Seat 1: wesol05 (small blind) folded before Flop
Seat 2: Perke0 (big blind) folded before Flop
Seat 3: romk@vip folded before Flop (didn't bet)
Seat 4: themasteryan folded before Flop (didn't bet)
Seat 5: welcat folded before Flop (didn't bet)
Seat 6: marval231 folded before Flop (didn't bet)
Seat 7: hichnick777 folded before Flop (didn't bet)
Seat 8: zafstop folded before Flop (didn't bet)
Seat 9: guirib8ir0 (button) collected (27200)


*********** # 220 **************
PokerStars Hand #176677174761: Tournament #2054568934, $20+$2 USD Hold'em No Limit - Level XXVI (4000/8000) - 2017/10/09 3:47:51 MSK [2017/10/08 20:47:51 ET]
Table '2054568934 506' 9-max Seat #1 is the button
Seat 1: wesol05 (451050 in chips)
Seat 2: Perke0 (272978 in chips)
Seat 3: romk@vip (148568 in chips)
Seat 4: themasteryan (557646 in chips)
Seat 5: welcat (286618 in chips)
Seat 6: marval231 (200228 in chips)
Seat 7: hichnick777 (277168 in chips)
Seat 8: zafstop (453953 in chips)
Seat 9: guirib8ir0 (369651 in chips)
wesol05: posts the ante 800
Perke0: posts the ante 800
romk@vip: posts the ante 800
themasteryan: posts the ante 800
welcat: posts the ante 800
marval231: posts the ante 800
hichnick777: posts the ante 800
zafstop: posts the ante 800
guirib8ir0: posts the ante 800
Perke0: posts small blind 4000
romk@vip: posts big blind 8000
*** HOLE CARDS ***
Dealt to hichnick777 [Js 8h]
themasteryan: folds
welcat: folds
marval231: folds
hichnick777: folds
zafstop: folds
guirib8ir0: raises 8000 to 16000
wesol05: folds
Perke0: folds
romk@vip: folds
Uncalled bet (8000) returned to guirib8ir0
guirib8ir0 collected 27200 from pot
guirib8ir0: doesn't show hand
*** SUMMARY ***
Total pot 27200 | Rake 0
Seat 1: wesol05 (button) folded before Flop (didn't bet)
Seat 2: Perke0 (small blind) folded before Flop
Seat 3: romk@vip (big blind) folded before Flop
Seat 4: themasteryan folded before Flop (didn't bet)
Seat 5: welcat folded before Flop (didn't bet)
Seat 6: marval231 folded before Flop (didn't bet)
Seat 7: hichnick777 folded before Flop (didn't bet)
Seat 8: zafstop folded before Flop (didn't bet)
Seat 9: guirib8ir0 collected (27200)


*********** # 221 **************
PokerStars Hand #176677189613: Tournament #2054568934, $20+$2 USD Hold'em No Limit - Level XXVI (4000/8000) - 2017/10/09 3:48:26 MSK [2017/10/08 20:48:26 ET]
Table '2054568934 506' 9-max Seat #2 is the button
Seat 1: wesol05 (450250 in chips)
Seat 2: Perke0 (268178 in chips)
Seat 3: romk@vip (139768 in chips)
Seat 4: themasteryan (556846 in chips)
Seat 5: welcat (285818 in chips)
Seat 6: marval231 (199428 in chips)
Seat 7: hichnick777 (276368 in chips)
Seat 8: zafstop (453153 in chips)
Seat 9: guirib8ir0 (388051 in chips)
wesol05: posts the ante 800
Perke0: posts the ante 800
romk@vip: posts the ante 800
themasteryan: posts the ante 800
welcat: posts the ante 800
marval231: posts the ante 800
hichnick777: posts the ante 800
zafstop: posts the ante 800
guirib8ir0: posts the ante 800
romk@vip: posts small blind 4000
themasteryan: posts big blind 8000
*** HOLE CARDS ***
Dealt to hichnick777 [8h 7h]
welcat: raises 8000 to 16000
marval231: folds
hichnick777: folds
zafstop: folds
guirib8ir0: folds
wesol05: folds
Perke0: folds
romk@vip: folds
themasteryan: folds [2h 9c]
Uncalled bet (8000) returned to welcat
welcat collected 27200 from pot
welcat: doesn't show hand
*** SUMMARY ***
Total pot 27200 | Rake 0
Seat 1: wesol05 folded before Flop (didn't bet)
Seat 2: Perke0 (button) folded before Flop (didn't bet)
Seat 3: romk@vip (small blind) folded before Flop
Seat 4: themasteryan (big blind) folded before Flop
Seat 5: welcat collected (27200)
Seat 6: marval231 folded before Flop (didn't bet)
Seat 7: hichnick777 folded before Flop (didn't bet)
Seat 8: zafstop folded before Flop (didn't bet)
Seat 9: guirib8ir0 folded before Flop (didn't bet)


*********** # 222 **************
PokerStars Hand #176677213590: Tournament #2054568934, $20+$2 USD Hold'em No Limit - Level XXVII (4500/9000) - 2017/10/09 3:49:24 MSK [2017/10/08 20:49:24 ET]
Table '2054568934 506' 9-max Seat #3 is the button
Seat 1: wesol05 (449450 in chips)
Seat 2: Perke0 (267378 in chips)
Seat 3: romk@vip (134968 in chips)
Seat 4: themasteryan (548046 in chips)
Seat 5: welcat (304218 in chips)
Seat 6: marval231 (198628 in chips)
Seat 7: hichnick777 (275568 in chips)
Seat 8: zafstop (452353 in chips)
Seat 9: guirib8ir0 (387251 in chips)
wesol05: posts the ante 900
Perke0: posts the ante 900
romk@vip: posts the ante 900
themasteryan: posts the ante 900
welcat: posts the ante 900
marval231: posts the ante 900
hichnick777: posts the ante 900
zafstop: posts the ante 900
guirib8ir0: posts the ante 900
themasteryan: posts small blind 4500
welcat: posts big blind 9000
*** HOLE CARDS ***
Dealt to hichnick777 [Ks 4d]
marval231: raises 9000 to 18000
hichnick777: folds
zafstop: folds
guirib8ir0: raises 24677 to 42677
wesol05: folds
Perke0: folds
romk@vip: folds
themasteryan: folds
welcat: folds
marval231: calls 24677
*** FLOP *** [8d Jh Th]
marval231: checks
guirib8ir0: bets 49199
marval231: raises 105852 to 155051 and is all-in
guirib8ir0: calls 105852
*** TURN *** [8d Jh Th] [7s]
*** RIVER *** [8d Jh Th 7s] [4s]
*** SHOW DOWN ***
marval231: shows [Ts Td] (three of a kind, Tens)
guirib8ir0: shows [Kc Tc] (a pair of Tens)
marval231 collected 417056 from pot
*** SUMMARY ***
Total pot 417056 | Rake 0
Board [8d Jh Th 7s 4s]
Seat 1: wesol05 folded before Flop (didn't bet)
Seat 2: Perke0 folded before Flop (didn't bet)
Seat 3: romk@vip (button) folded before Flop (didn't bet)
Seat 4: themasteryan (small blind) folded before Flop
Seat 5: welcat (big blind) folded before Flop
Seat 6: marval231 showed [Ts Td] and won (417056) with three of a kind, Tens
Seat 7: hichnick777 folded before Flop (didn't bet)
Seat 8: zafstop folded before Flop (didn't bet)
Seat 9: guirib8ir0 showed [Kc Tc] and lost with a pair of Tens


*********** # 223 **************
PokerStars Hand #176677249098: Tournament #2054568934, $20+$2 USD Hold'em No Limit - Level XXVII (4500/9000) - 2017/10/09 3:50:49 MSK [2017/10/08 20:50:49 ET]
Table '2054568934 506' 9-max Seat #4 is the button
Seat 1: wesol05 (448550 in chips)
Seat 2: Perke0 (266478 in chips)
Seat 3: romk@vip (134068 in chips)
Seat 4: themasteryan (542646 in chips)
Seat 5: welcat (294318 in chips)
Seat 6: marval231 (417056 in chips)
Seat 7: hichnick777 (274668 in chips)
Seat 8: zafstop (451453 in chips)
Seat 9: guirib8ir0 (188623 in chips)
wesol05: posts the ante 900
Perke0: posts the ante 900
romk@vip: posts the ante 900
themasteryan: posts the ante 900
welcat: posts the ante 900
marval231: posts the ante 900
hichnick777: posts the ante 900
zafstop: posts the ante 900
guirib8ir0: posts the ante 900
welcat: posts small blind 4500
marval231: posts big blind 9000
*** HOLE CARDS ***
Dealt to hichnick777 [Ad Td]
hichnick777: raises 11250 to 20250
zafstop: folds
guirib8ir0: folds
wesol05: folds
Perke0: folds
romk@vip: folds
themasteryan: calls 20250
welcat: folds
marval231: folds
*** FLOP *** [7s 5s 6s]
hichnick777: checks
themasteryan: checks
*** TURN *** [7s 5s 6s] [3d]
hichnick777: checks
themasteryan: checks
*** RIVER *** [7s 5s 6s 3d] [8h]
hichnick777: checks
themasteryan: bets 17985
hichnick777: folds
Uncalled bet (17985) returned to themasteryan
themasteryan collected 62100 from pot
themasteryan: doesn't show hand
*** SUMMARY ***
Total pot 62100 | Rake 0
Board [7s 5s 6s 3d 8h]
Seat 1: wesol05 folded before Flop (didn't bet)
Seat 2: Perke0 folded before Flop (didn't bet)
Seat 3: romk@vip folded before Flop (didn't bet)
Seat 4: themasteryan (button) collected (62100)
Seat 5: welcat (small blind) folded before Flop
Seat 6: marval231 (big blind) folded before Flop
Seat 7: hichnick777 folded on the River
Seat 8: zafstop folded before Flop (didn't bet)
Seat 9: guirib8ir0 folded before Flop (didn't bet)


*********** # 224 **************
PokerStars Hand #176677290531: Tournament #2054568934, $20+$2 USD Hold'em No Limit - Level XXVII (4500/9000) - 2017/10/09 3:52:29 MSK [2017/10/08 20:52:29 ET]
Table '2054568934 506' 9-max Seat #5 is the button
Seat 1: wesol05 (447650 in chips)
Seat 2: Perke0 (265578 in chips)
Seat 3: romk@vip (133168 in chips)
Seat 4: themasteryan (583596 in chips)
Seat 5: welcat (288918 in chips)
Seat 6: marval231 (407156 in chips)
Seat 7: hichnick777 (253518 in chips)
Seat 8: zafstop (450553 in chips)
Seat 9: guirib8ir0 (187723 in chips)
wesol05: posts the ante 900
Perke0: posts the ante 900
romk@vip: posts the ante 900
themasteryan: posts the ante 900
welcat: posts the ante 900
marval231: posts the ante 900
hichnick777: posts the ante 900
zafstop: posts the ante 900
guirib8ir0: posts the ante 900
marval231: posts small blind 4500
hichnick777: posts big blind 9000
*** HOLE CARDS ***
Dealt to hichnick777 [Jc Ad]
zafstop: folds
guirib8ir0: folds
wesol05: raises 13500 to 22500
Perke0: raises 45000 to 67500
romk@vip: folds
themasteryan: folds
welcat: folds
marval231: folds
hichnick777: folds
wesol05: folds
Uncalled bet (45000) returned to Perke0
Perke0 collected 66600 from pot
Perke0: doesn't show hand
*** SUMMARY ***
Total pot 66600 | Rake 0
Seat 1: wesol05 folded before Flop
Seat 2: Perke0 collected (66600)
Seat 3: romk@vip folded before Flop (didn't bet)
Seat 4: themasteryan folded before Flop (didn't bet)
Seat 5: welcat (button) folded before Flop (didn't bet)
Seat 6: marval231 (small blind) folded before Flop
Seat 7: hichnick777 (big blind) folded before Flop
Seat 8: zafstop folded before Flop (didn't bet)
Seat 9: guirib8ir0 folded before Flop (didn't bet)


*********** # 225 **************
PokerStars Hand #176677319079: Tournament #2054568934, $20+$2 USD Hold'em No Limit - Level XXVII (4500/9000) - 2017/10/09 3:53:38 MSK [2017/10/08 20:53:38 ET]
Table '2054568934 506' 9-max Seat #6 is the button
Seat 1: wesol05 (424250 in chips)
Seat 2: Perke0 (308778 in chips)
Seat 3: romk@vip (132268 in chips)
Seat 4: themasteryan (582696 in chips)
Seat 5: welcat (288018 in chips)
Seat 6: marval231 (401756 in chips)
Seat 7: hichnick777 (243618 in chips)
Seat 8: zafstop (449653 in chips)
Seat 9: guirib8ir0 (186823 in chips)
wesol05: posts the ante 900
Perke0: posts the ante 900
romk@vip: posts the ante 900
themasteryan: posts the ante 900
welcat: posts the ante 900
marval231: posts the ante 900
hichnick777: posts the ante 900
zafstop: posts the ante 900
guirib8ir0: posts the ante 900
hichnick777: posts small blind 4500
zafstop: posts big blind 9000
*** HOLE CARDS ***
Dealt to hichnick777 [Kh Jh]
guirib8ir0: folds
wesol05: folds
Perke0: folds
romk@vip: folds
themasteryan: folds
welcat: folds
marval231: raises 9000 to 18000
hichnick777: raises 27000 to 45000
zafstop: folds
marval231: folds
Uncalled bet (27000) returned to hichnick777
hichnick777 collected 53100 from pot
hichnick777: doesn't show hand
*** SUMMARY ***
Total pot 53100 | Rake 0
Seat 1: wesol05 folded before Flop (didn't bet)
Seat 2: Perke0 folded before Flop (didn't bet)
Seat 3: romk@vip folded before Flop (didn't bet)
Seat 4: themasteryan folded before Flop (didn't bet)
Seat 5: welcat folded before Flop (didn't bet)
Seat 6: marval231 (button) folded before Flop
Seat 7: hichnick777 (small blind) collected (53100)
Seat 8: zafstop (big blind) folded before Flop
Seat 9: guirib8ir0 folded before Flop (didn't bet)


*********** # 226 **************
PokerStars Hand #176677353562: Tournament #2054568934, $20+$2 USD Hold'em No Limit - Level XXVII (4500/9000) - 2017/10/09 3:54:38 MSK [2017/10/08 20:54:38 ET]
Table '2054568934 506' 9-max Seat #7 is the button
Seat 1: wesol05 (423350 in chips)
Seat 2: Perke0 (307878 in chips)
Seat 3: romk@vip (131368 in chips)
Seat 4: themasteryan (581796 in chips)
Seat 5: welcat (287118 in chips)
Seat 6: marval231 (382856 in chips)
Seat 7: hichnick777 (277818 in chips)
Seat 8: zafstop (439753 in chips)
Seat 9: guirib8ir0 (185923 in chips)
wesol05: posts the ante 900
Perke0: posts the ante 900
romk@vip: posts the ante 900
themasteryan: posts the ante 900
welcat: posts the ante 900
marval231: posts the ante 900
hichnick777: posts the ante 900
zafstop: posts the ante 900
guirib8ir0: posts the ante 900
zafstop: posts small blind 4500
guirib8ir0: posts big blind 9000
*** HOLE CARDS ***
Dealt to hichnick777 [3s 7s]
wesol05: folds
Perke0: folds
romk@vip: raises 121468 to 130468 and is all-in
themasteryan: calls 130468
welcat: folds
marval231: folds
hichnick777: folds
zafstop: folds
guirib8ir0: folds
*** FLOP *** [Qd 6s 8d]
*** TURN *** [Qd 6s 8d] [6d]
*** RIVER *** [Qd 6s 8d 6d] [4s]
*** SHOW DOWN ***
romk@vip: shows [Td Jd] (a flush, Queen high)
themasteryan: shows [Tc Th] (two pair, Tens and Sixes)
romk@vip collected 282536 from pot
*** SUMMARY ***
Total pot 282536 | Rake 0
Board [Qd 6s 8d 6d 4s]
Seat 1: wesol05 folded before Flop (didn't bet)
Seat 2: Perke0 folded before Flop (didn't bet)
Seat 3: romk@vip showed [Td Jd] and won (282536) with a flush, Queen high
Seat 4: themasteryan showed [Tc Th] and lost with two pair, Tens and Sixes
Seat 5: welcat folded before Flop (didn't bet)
Seat 6: marval231 folded before Flop (didn't bet)
Seat 7: hichnick777 (button) folded before Flop (didn't bet)
Seat 8: zafstop (small blind) folded before Flop
Seat 9: guirib8ir0 (big blind) folded before Flop


*********** # 227 **************
PokerStars Hand #176677501270: Tournament #2054568934, $20+$2 USD Hold'em No Limit - Level XXVII (4500/9000) - 2017/10/09 4:01:38 MSK [2017/10/08 21:01:38 ET]
Table '2054568934 506' 9-max Seat #8 is the button
Seat 1: wesol05 (422450 in chips)
Seat 2: Perke0 (306978 in chips)
Seat 3: romk@vip (282536 in chips)
Seat 4: themasteryan (450428 in chips)
Seat 5: welcat (286218 in chips)
Seat 6: marval231 (381956 in chips)
Seat 7: hichnick777 (276918 in chips)
Seat 8: zafstop (434353 in chips)
Seat 9: guirib8ir0 (176023 in chips)
wesol05: posts the ante 900
Perke0: posts the ante 900
romk@vip: posts the ante 900
themasteryan: posts the ante 900
welcat: posts the ante 900
marval231: posts the ante 900
hichnick777: posts the ante 900
zafstop: posts the ante 900
guirib8ir0: posts the ante 900
guirib8ir0: posts small blind 4500
wesol05: posts big blind 9000
*** HOLE CARDS ***
Dealt to hichnick777 [3h 3c]
Perke0: folds
romk@vip: folds
themasteryan: folds
welcat has timed out
welcat: folds
welcat is sitting out
welcat has returned
marval231: folds
hichnick777: raises 9720 to 18720
zafstop: raises 40270 to 58990
guirib8ir0: folds
wesol05: folds
hichnick777: raises 217028 to 276018 and is all-in
zafstop: folds
Uncalled bet (217028) returned to hichnick777
hichnick777 collected 139580 from pot
hichnick777: doesn't show hand
*** SUMMARY ***
Total pot 139580 | Rake 0
Seat 1: wesol05 (big blind) folded before Flop
Seat 2: Perke0 folded before Flop (didn't bet)
Seat 3: romk@vip folded before Flop (didn't bet)
Seat 4: themasteryan folded before Flop (didn't bet)
Seat 5: welcat folded before Flop (didn't bet)
Seat 6: marval231 folded before Flop (didn't bet)
Seat 7: hichnick777 collected (139580)
Seat 8: zafstop (button) folded before Flop
Seat 9: guirib8ir0 (small blind) folded before Flop


*********** # 228 **************
PokerStars Hand #176677565505: Tournament #2054568934, $20+$2 USD Hold'em No Limit - Level XXVII (4500/9000) - 2017/10/09 4:04:20 MSK [2017/10/08 21:04:20 ET]
Table '2054568934 506' 9-max Seat #9 is the button
Seat 1: wesol05 (412550 in chips)
Seat 2: Perke0 (306078 in chips)
Seat 3: romk@vip (281636 in chips)
Seat 4: themasteryan (449528 in chips)
Seat 5: welcat (285318 in chips)
Seat 6: marval231 (381056 in chips)
Seat 7: hichnick777 (356608 in chips)
Seat 8: zafstop (374463 in chips)
Seat 9: guirib8ir0 (170623 in chips)
wesol05: posts the ante 900
Perke0: posts the ante 900
romk@vip: posts the ante 900
themasteryan: posts the ante 900
welcat: posts the ante 900
marval231: posts the ante 900
hichnick777: posts the ante 900
zafstop: posts the ante 900
guirib8ir0: posts the ante 900
wesol05: posts small blind 4500
Perke0: posts big blind 9000
*** HOLE CARDS ***
Dealt to hichnick777 [3h 5c]
romk@vip: raises 9000 to 18000
themasteryan: folds
welcat: folds
marval231: folds
hichnick777: folds
zafstop: folds
guirib8ir0: folds
wesol05: folds
Perke0: folds
Uncalled bet (9000) returned to romk@vip
romk@vip collected 30600 from pot
*** SUMMARY ***
Total pot 30600 | Rake 0
Seat 1: wesol05 (small blind) folded before Flop
Seat 2: Perke0 (big blind) folded before Flop
Seat 3: romk@vip collected (30600)
Seat 4: themasteryan folded before Flop (didn't bet)
Seat 5: welcat folded before Flop (didn't bet)
Seat 6: marval231 folded before Flop (didn't bet)
Seat 7: hichnick777 folded before Flop (didn't bet)
Seat 8: zafstop folded before Flop (didn't bet)
Seat 9: guirib8ir0 (button) folded before Flop (didn't bet)


*********** # 229 **************
PokerStars Hand #176677576084: Tournament #2054568934, $20+$2 USD Hold'em No Limit - Level XXVII (4500/9000) - 2017/10/09 4:04:47 MSK [2017/10/08 21:04:47 ET]
Table '2054568934 506' 9-max Seat #1 is the button
Seat 1: wesol05 (407150 in chips)
Seat 2: Perke0 (296178 in chips)
Seat 3: romk@vip (302336 in chips)
Seat 4: themasteryan (448628 in chips)
Seat 5: welcat (284418 in chips)
Seat 6: marval231 (380156 in chips)
Seat 7: hichnick777 (355708 in chips)
Seat 8: zafstop (373563 in chips)
Seat 9: guirib8ir0 (169723 in chips)
wesol05: posts the ante 900
Perke0: posts the ante 900
romk@vip: posts the ante 900
themasteryan: posts the ante 900
welcat: posts the ante 900
marval231: posts the ante 900
hichnick777: posts the ante 900
zafstop: posts the ante 900
guirib8ir0: posts the ante 900
Perke0: posts small blind 4500
romk@vip: posts big blind 9000
*** HOLE CARDS ***
Dealt to hichnick777 [Jh 7s]
themasteryan: folds
welcat: raises 9000 to 18000
marval231: folds
hichnick777: folds
zafstop: folds
guirib8ir0: folds
wesol05: folds
Perke0: folds
romk@vip: folds
Uncalled bet (9000) returned to welcat
welcat collected 30600 from pot
welcat: doesn't show hand
*** SUMMARY ***
Total pot 30600 | Rake 0
Seat 1: wesol05 (button) folded before Flop (didn't bet)
Seat 2: Perke0 (small blind) folded before Flop
Seat 3: romk@vip (big blind) folded before Flop
Seat 4: themasteryan folded before Flop (didn't bet)
Seat 5: welcat collected (30600)
Seat 6: marval231 folded before Flop (didn't bet)
Seat 7: hichnick777 folded before Flop (didn't bet)
Seat 8: zafstop folded before Flop (didn't bet)
Seat 9: guirib8ir0 folded before Flop (didn't bet)


*********** # 230 **************
PokerStars Hand #176677593233: Tournament #2054568934, $20+$2 USD Hold'em No Limit - Level XXVII (4500/9000) - 2017/10/09 4:05:28 MSK [2017/10/08 21:05:28 ET]
Table '2054568934 506' 9-max Seat #2 is the button
Seat 1: wesol05 (406250 in chips)
Seat 2: Perke0 (290778 in chips)
Seat 3: romk@vip (292436 in chips)
Seat 4: themasteryan (447728 in chips)
Seat 5: welcat (305118 in chips)
Seat 6: marval231 (379256 in chips)
Seat 7: hichnick777 (354808 in chips)
Seat 8: zafstop (372663 in chips)
Seat 9: guirib8ir0 (168823 in chips)
wesol05: posts the ante 900
Perke0: posts the ante 900
romk@vip: posts the ante 900
themasteryan: posts the ante 900
welcat: posts the ante 900
marval231: posts the ante 900
hichnick777: posts the ante 900
zafstop: posts the ante 900
guirib8ir0: posts the ante 900
romk@vip: posts small blind 4500
themasteryan: posts big blind 9000
*** HOLE CARDS ***
Dealt to hichnick777 [6h 7d]
welcat: folds
marval231: folds
hichnick777: folds
zafstop: folds
guirib8ir0: folds
wesol05: folds
Perke0: raises 9000 to 18000
romk@vip: folds
themasteryan: calls 9000
*** FLOP *** [3h Qh As]
themasteryan: checks
Perke0: bets 19577
themasteryan: calls 19577
*** TURN *** [3h Qh As] [Ks]
themasteryan: checks
Perke0: checks
*** RIVER *** [3h Qh As Ks] [4h]
themasteryan: bets 34985
Perke0: folds
Uncalled bet (34985) returned to themasteryan
themasteryan collected 87754 from pot
themasteryan: doesn't show hand
*** SUMMARY ***
Total pot 87754 | Rake 0
Board [3h Qh As Ks 4h]
Seat 1: wesol05 folded before Flop (didn't bet)
Seat 2: Perke0 (button) folded on the River
Seat 3: romk@vip (small blind) folded before Flop
Seat 4: themasteryan (big blind) collected (87754)
Seat 5: welcat folded before Flop (didn't bet)
Seat 6: marval231 folded before Flop (didn't bet)
Seat 7: hichnick777 folded before Flop (didn't bet)
Seat 8: zafstop folded before Flop (didn't bet)
Seat 9: guirib8ir0 folded before Flop (didn't bet)


*********** # 231 **************
PokerStars Hand #176677627169: Tournament #2054568934, $20+$2 USD Hold'em No Limit - Level XXVII (4500/9000) - 2017/10/09 4:06:52 MSK [2017/10/08 21:06:52 ET]
Table '2054568934 506' 9-max Seat #3 is the button
Seat 1: wesol05 (405350 in chips)
Seat 2: Perke0 (252301 in chips)
Seat 3: romk@vip (287036 in chips)
Seat 4: themasteryan (497005 in chips)
Seat 5: welcat (304218 in chips)
Seat 6: marval231 (378356 in chips)
Seat 7: hichnick777 (353908 in chips)
Seat 8: zafstop (371763 in chips)
Seat 9: guirib8ir0 (167923 in chips)
wesol05: posts the ante 900
Perke0: posts the ante 900
romk@vip: posts the ante 900
themasteryan: posts the ante 900
welcat: posts the ante 900
marval231: posts the ante 900
hichnick777: posts the ante 900
zafstop: posts the ante 900
guirib8ir0: posts the ante 900
themasteryan: posts small blind 4500
welcat: posts big blind 9000
*** HOLE CARDS ***
Dealt to hichnick777 [9c 5s]
marval231: folds
hichnick777: folds
zafstop: folds
guirib8ir0: raises 9000 to 18000
wesol05: folds
Perke0: folds
romk@vip: folds
themasteryan: folds
welcat: folds
Uncalled bet (9000) returned to guirib8ir0
guirib8ir0 collected 30600 from pot
guirib8ir0: doesn't show hand
*** SUMMARY ***
Total pot 30600 | Rake 0
Seat 1: wesol05 folded before Flop (didn't bet)
Seat 2: Perke0 folded before Flop (didn't bet)
Seat 3: romk@vip (button) folded before Flop (didn't bet)
Seat 4: themasteryan (small blind) folded before Flop
Seat 5: welcat (big blind) folded before Flop
Seat 6: marval231 folded before Flop (didn't bet)
Seat 7: hichnick777 folded before Flop (didn't bet)
Seat 8: zafstop folded before Flop (didn't bet)
Seat 9: guirib8ir0 collected (30600)


*********** # 232 **************
PokerStars Hand #176677646357: Tournament #2054568934, $20+$2 USD Hold'em No Limit - Level XXVIII (5000/10000) - 2017/10/09 4:07:39 MSK [2017/10/08 21:07:39 ET]
Table '2054568934 506' 9-max Seat #4 is the button
Seat 1: wesol05 (404450 in chips)
Seat 2: Perke0 (251401 in chips)
Seat 3: romk@vip (286136 in chips)
Seat 4: themasteryan (491605 in chips)
Seat 5: welcat (294318 in chips)
Seat 6: marval231 (377456 in chips)
Seat 7: hichnick777 (353008 in chips)
Seat 8: zafstop (370863 in chips)
Seat 9: guirib8ir0 (188623 in chips)
wesol05: posts the ante 1000
Perke0: posts the ante 1000
romk@vip: posts the ante 1000
themasteryan: posts the ante 1000
welcat: posts the ante 1000
marval231: posts the ante 1000
hichnick777: posts the ante 1000
zafstop: posts the ante 1000
guirib8ir0: posts the ante 1000
welcat: posts small blind 5000
marval231: posts big blind 10000
*** HOLE CARDS ***
Dealt to hichnick777 [2d Jc]
hichnick777: folds
zafstop: folds
guirib8ir0: folds
wesol05: folds
Perke0: folds
romk@vip: raises 12000 to 22000
themasteryan: folds
welcat: folds
marval231: calls 12000
*** FLOP *** [2h 9c 3d]
marval231: checks
romk@vip: bets 22040
marval231: calls 22040
*** TURN *** [2h 9c 3d] [8h]
marval231: checks
romk@vip: bets 40000
marval231: calls 40000
*** RIVER *** [2h 9c 3d 8h] [Ts]
marval231: checks
romk@vip: checks
*** SHOW DOWN ***
marval231: shows [Kd Ah] (high card Ace)
romk@vip: shows [Kc Kh] (a pair of Kings)
romk@vip collected 182080 from pot
*** SUMMARY ***
Total pot 182080 | Rake 0
Board [2h 9c 3d 8h Ts]
Seat 1: wesol05 folded before Flop (didn't bet)
Seat 2: Perke0 folded before Flop (didn't bet)
Seat 3: romk@vip showed [Kc Kh] and won (182080) with a pair of Kings
Seat 4: themasteryan (button) folded before Flop (didn't bet)
Seat 5: welcat (small blind) folded before Flop
Seat 6: marval231 (big blind) showed [Kd Ah] and lost with high card Ace
Seat 7: hichnick777 folded before Flop (didn't bet)
Seat 8: zafstop folded before Flop (didn't bet)
Seat 9: guirib8ir0 folded before Flop (didn't bet)


*********** # 233 **************
PokerStars Hand #176677681542: Tournament #2054568934, $20+$2 USD Hold'em No Limit - Level XXVIII (5000/10000) - 2017/10/09 4:09:05 MSK [2017/10/08 21:09:05 ET]
Table '2054568934 506' 9-max Seat #5 is the button
Seat 1: wesol05 (403450 in chips)
Seat 2: Perke0 (250401 in chips)
Seat 3: romk@vip (383176 in chips)
Seat 4: themasteryan (490605 in chips)
Seat 5: welcat (288318 in chips)
Seat 6: marval231 (292416 in chips)
Seat 7: hichnick777 (352008 in chips)
Seat 8: zafstop (369863 in chips)
Seat 9: guirib8ir0 (187623 in chips)
wesol05: posts the ante 1000
Perke0: posts the ante 1000
romk@vip: posts the ante 1000
themasteryan: posts the ante 1000
welcat: posts the ante 1000
marval231: posts the ante 1000
hichnick777: posts the ante 1000
zafstop: posts the ante 1000
guirib8ir0: posts the ante 1000
marval231: posts small blind 5000
hichnick777: posts big blind 10000
*** HOLE CARDS ***
Dealt to hichnick777 [6s Jh]
zafstop: folds
guirib8ir0: raises 10000 to 20000
wesol05: folds
Perke0: folds
romk@vip: folds
themasteryan: folds
welcat: folds
marval231: folds
hichnick777: folds
Uncalled bet (10000) returned to guirib8ir0
guirib8ir0 collected 34000 from pot
guirib8ir0: doesn't show hand
*** SUMMARY ***
Total pot 34000 | Rake 0
Seat 1: wesol05 folded before Flop (didn't bet)
Seat 2: Perke0 folded before Flop (didn't bet)
Seat 3: romk@vip folded before Flop (didn't bet)
Seat 4: themasteryan folded before Flop (didn't bet)
Seat 5: welcat (button) folded before Flop (didn't bet)
Seat 6: marval231 (small blind) folded before Flop
Seat 7: hichnick777 (big blind) folded before Flop
Seat 8: zafstop folded before Flop (didn't bet)
Seat 9: guirib8ir0 collected (34000)


*********** # 234 **************
PokerStars Hand #176677696362: Tournament #2054568934, $20+$2 USD Hold'em No Limit - Level XXVIII (5000/10000) - 2017/10/09 4:09:42 MSK [2017/10/08 21:09:42 ET]
Table '2054568934 506' 9-max Seat #6 is the button
Seat 1: wesol05 (402450 in chips)
Seat 2: Perke0 (249401 in chips)
Seat 3: romk@vip (382176 in chips)
Seat 4: themasteryan (489605 in chips)
Seat 5: welcat (287318 in chips)
Seat 6: marval231 (286416 in chips)
Seat 7: hichnick777 (341008 in chips)
Seat 8: zafstop (368863 in chips)
Seat 9: guirib8ir0 (210623 in chips)
wesol05: posts the ante 1000
Perke0: posts the ante 1000
romk@vip: posts the ante 1000
themasteryan: posts the ante 1000
welcat: posts the ante 1000
marval231: posts the ante 1000
hichnick777: posts the ante 1000
zafstop: posts the ante 1000
guirib8ir0: posts the ante 1000
hichnick777: posts small blind 5000
zafstop: posts big blind 10000
*** HOLE CARDS ***
Dealt to hichnick777 [Qc 5c]
guirib8ir0: folds
wesol05: folds
Perke0: folds
romk@vip: folds
themasteryan: raises 12085 to 22085
welcat: folds
marval231: folds
hichnick777: folds
zafstop: folds
Uncalled bet (12085) returned to themasteryan
themasteryan collected 34000 from pot
themasteryan: doesn't show hand
*** SUMMARY ***
Total pot 34000 | Rake 0
Seat 1: wesol05 folded before Flop (didn't bet)
Seat 2: Perke0 folded before Flop (didn't bet)
Seat 3: romk@vip folded before Flop (didn't bet)
Seat 4: themasteryan collected (34000)
Seat 5: welcat folded before Flop (didn't bet)
Seat 6: marval231 (button) folded before Flop (didn't bet)
Seat 7: hichnick777 (small blind) folded before Flop
Seat 8: zafstop (big blind) folded before Flop
Seat 9: guirib8ir0 folded before Flop (didn't bet)


*********** # 235 **************
PokerStars Hand #176677712595: Tournament #2054568934, $20+$2 USD Hold'em No Limit - Level XXVIII (5000/10000) - 2017/10/09 4:10:22 MSK [2017/10/08 21:10:22 ET]
Table '2054568934 506' 9-max Seat #7 is the button
Seat 1: wesol05 (401450 in chips)
Seat 2: Perke0 (248401 in chips)
Seat 3: romk@vip (381176 in chips)
Seat 4: themasteryan (512605 in chips)
Seat 5: welcat (286318 in chips)
Seat 6: marval231 (285416 in chips)
Seat 7: hichnick777 (335008 in chips)
Seat 8: zafstop (357863 in chips)
Seat 9: guirib8ir0 (209623 in chips)
wesol05: posts the ante 1000
Perke0: posts the ante 1000
romk@vip: posts the ante 1000
themasteryan: posts the ante 1000
welcat: posts the ante 1000
marval231: posts the ante 1000
hichnick777: posts the ante 1000
zafstop: posts the ante 1000
guirib8ir0: posts the ante 1000
zafstop: posts small blind 5000
guirib8ir0: posts big blind 10000
*** HOLE CARDS ***
Dealt to hichnick777 [Ac 3d]
wesol05: folds
Perke0: folds
romk@vip: folds
themasteryan: folds
welcat: folds
marval231: folds
hichnick777: raises 10800 to 20800
zafstop: raises 336063 to 356863 and is all-in
guirib8ir0: folds
hichnick777: folds
Uncalled bet (336063) returned to zafstop
zafstop collected 60600 from pot
*** SUMMARY ***
Total pot 60600 | Rake 0
Seat 1: wesol05 folded before Flop (didn't bet)
Seat 2: Perke0 folded before Flop (didn't bet)
Seat 3: romk@vip folded before Flop (didn't bet)
Seat 4: themasteryan folded before Flop (didn't bet)
Seat 5: welcat folded before Flop (didn't bet)
Seat 6: marval231 folded before Flop (didn't bet)
Seat 7: hichnick777 (button) folded before Flop
Seat 8: zafstop (small blind) collected (60600)
Seat 9: guirib8ir0 (big blind) folded before Flop


*********** # 236 **************
PokerStars Hand #176677729437: Tournament #2054568934, $20+$2 USD Hold'em No Limit - Level XXVIII (5000/10000) - 2017/10/09 4:11:04 MSK [2017/10/08 21:11:04 ET]
Table '2054568934 506' 9-max Seat #8 is the button
Seat 1: wesol05 (400450 in chips)
Seat 2: Perke0 (247401 in chips)
Seat 3: romk@vip (380176 in chips)
Seat 4: themasteryan (511605 in chips)
Seat 5: welcat (285318 in chips)
Seat 6: marval231 (284416 in chips)
Seat 7: hichnick777 (313208 in chips)
Seat 8: zafstop (396663 in chips)
Seat 9: guirib8ir0 (198623 in chips)
wesol05: posts the ante 1000
Perke0: posts the ante 1000
romk@vip: posts the ante 1000
themasteryan: posts the ante 1000
welcat: posts the ante 1000
marval231: posts the ante 1000
hichnick777: posts the ante 1000
zafstop: posts the ante 1000
guirib8ir0: posts the ante 1000
guirib8ir0: posts small blind 5000
wesol05: posts big blind 10000
*** HOLE CARDS ***
Dealt to hichnick777 [8h 2h]
Perke0: folds
romk@vip: folds
themasteryan: folds
welcat: folds
marval231: folds
hichnick777: folds
zafstop: raises 12000 to 22000
guirib8ir0: folds
wesol05: raises 44858 to 66858
zafstop: raises 328805 to 395663 and is all-in
wesol05: calls 328805
*** FLOP *** [Qs Ac Kh]
*** TURN *** [Qs Ac Kh] [7c]
*** RIVER *** [Qs Ac Kh 7c] [4d]
*** SHOW DOWN ***
wesol05: shows [Qh Qc] (three of a kind, Queens)
zafstop: shows [Kc As] (two pair, Aces and Kings)
wesol05 collected 805326 from pot
zafstop finished the tournament in 233rd place and received $78.28.
*** SUMMARY ***
Total pot 805326 | Rake 0
Board [Qs Ac Kh 7c 4d]
Seat 1: wesol05 (big blind) showed [Qh Qc] and won (805326) with three of a kind, Queens
Seat 2: Perke0 folded before Flop (didn't bet)
Seat 3: romk@vip folded before Flop (didn't bet)
Seat 4: themasteryan folded before Flop (didn't bet)
Seat 5: welcat folded before Flop (didn't bet)
Seat 6: marval231 folded before Flop (didn't bet)
Seat 7: hichnick777 folded before Flop (didn't bet)
Seat 8: zafstop (button) showed [Kc As] and lost with two pair, Aces and Kings
Seat 9: guirib8ir0 (small blind) folded before Flop


*********** # 237 **************
PokerStars Hand #176677760697: Tournament #2054568934, $20+$2 USD Hold'em No Limit - Level XXVIII (5000/10000) - 2017/10/09 4:12:22 MSK [2017/10/08 21:12:22 ET]
Table '2054568934 506' 9-max Seat #9 is the button
Seat 1: wesol05 (809113 in chips)
Seat 2: Perke0 (246401 in chips)
Seat 3: romk@vip (379176 in chips)
Seat 4: themasteryan (510605 in chips)
Seat 5: welcat (284318 in chips)
Seat 6: marval231 (283416 in chips)
Seat 7: hichnick777 (312208 in chips)
Seat 9: guirib8ir0 (192623 in chips)
wesol05: posts the ante 1000
Perke0: posts the ante 1000
romk@vip: posts the ante 1000
themasteryan: posts the ante 1000
welcat: posts the ante 1000
marval231: posts the ante 1000
hichnick777: posts the ante 1000
guirib8ir0: posts the ante 1000
wesol05: posts small blind 5000
Perke0: posts big blind 10000
*** HOLE CARDS ***
Dealt to hichnick777 [8h 8c]
romk@vip: folds
themasteryan: raises 12085 to 22085
welcat: folds
marval231: folds
hichnick777: calls 22085
guirib8ir0: folds
wesol05: folds
Perke0: folds
*** FLOP *** [Kh 7c 6h]
themasteryan: checks
hichnick777: bets 25000
themasteryan: calls 25000
*** TURN *** [Kh 7c 6h] [5c]
themasteryan: checks
hichnick777: bets 67959
themasteryan: raises 189816 to 257775
hichnick777: folds
Uncalled bet (189816) returned to themasteryan
themasteryan collected 253088 from pot
themasteryan: doesn't show hand
*** SUMMARY ***
Total pot 253088 | Rake 0
Board [Kh 7c 6h 5c]
Seat 1: wesol05 (small blind) folded before Flop
Seat 2: Perke0 (big blind) folded before Flop
Seat 3: romk@vip folded before Flop (didn't bet)
Seat 4: themasteryan collected (253088)
Seat 5: welcat folded before Flop (didn't bet)
Seat 6: marval231 folded before Flop (didn't bet)
Seat 7: hichnick777 folded on the Turn
Seat 9: guirib8ir0 (button) folded before Flop (didn't bet)


*********** # 238 **************
PokerStars Hand #176677803899: Tournament #2054568934, $20+$2 USD Hold'em No Limit - Level XXVIII (5000/10000) - 2017/10/09 4:14:10 MSK [2017/10/08 21:14:10 ET]
Table '2054568934 506' 9-max Seat #1 is the button
Seat 1: wesol05 (803113 in chips)
Seat 2: Perke0 (235401 in chips)
Seat 3: romk@vip (378176 in chips)
Seat 4: themasteryan (647649 in chips)
Seat 5: welcat (283318 in chips)
Seat 6: marval231 (282416 in chips)
Seat 7: hichnick777 (196164 in chips)
Seat 8: Dredjke (121985 in chips)
Seat 9: guirib8ir0 (191623 in chips)
wesol05: posts the ante 1000
Perke0: posts the ante 1000
romk@vip: posts the ante 1000
themasteryan: posts the ante 1000
welcat: posts the ante 1000
marval231: posts the ante 1000
hichnick777: posts the ante 1000
Dredjke: posts the ante 1000
guirib8ir0: posts the ante 1000
Perke0: posts small blind 5000
romk@vip: posts big blind 10000
*** HOLE CARDS ***
Dealt to hichnick777 [Kh 9c]
themasteryan: raises 12085 to 22085
welcat: folds
marval231: folds
hichnick777: folds
Dredjke: folds
guirib8ir0: folds
wesol05: folds
Perke0: folds
romk@vip: folds
Uncalled bet (12085) returned to themasteryan
themasteryan collected 34000 from pot
themasteryan: doesn't show hand
*** SUMMARY ***
Total pot 34000 | Rake 0
Seat 1: wesol05 (button) folded before Flop (didn't bet)
Seat 2: Perke0 (small blind) folded before Flop
Seat 3: romk@vip (big blind) folded before Flop
Seat 4: themasteryan collected (34000)
Seat 5: welcat folded before Flop (didn't bet)
Seat 6: marval231 folded before Flop (didn't bet)
Seat 7: hichnick777 folded before Flop (didn't bet)
Seat 8: Dredjke folded before Flop (didn't bet)
Seat 9: guirib8ir0 folded before Flop (didn't bet)


*********** # 239 **************
PokerStars Hand #176677812613: Tournament #2054568934, $20+$2 USD Hold'em No Limit - Level XXVIII (5000/10000) - 2017/10/09 4:14:32 MSK [2017/10/08 21:14:32 ET]
Table '2054568934 506' 9-max Seat #2 is the button
Seat 1: wesol05 (802113 in chips)
Seat 2: Perke0 (229401 in chips)
Seat 3: romk@vip (367176 in chips)
Seat 4: themasteryan (670649 in chips)
Seat 5: welcat (282318 in chips)
Seat 6: marval231 (281416 in chips)
Seat 7: hichnick777 (195164 in chips)
Seat 8: Dredjke (120985 in chips)
Seat 9: guirib8ir0 (190623 in chips)
wesol05: posts the ante 1000
Perke0: posts the ante 1000
romk@vip: posts the ante 1000
themasteryan: posts the ante 1000
welcat: posts the ante 1000
marval231: posts the ante 1000
hichnick777: posts the ante 1000
Dredjke: posts the ante 1000
guirib8ir0: posts the ante 1000
romk@vip: posts small blind 5000
themasteryan: posts big blind 10000
*** HOLE CARDS ***
Dealt to hichnick777 [5h 9d]
welcat: folds
marval231: raises 10000 to 20000
hichnick777: folds
Dredjke: folds
guirib8ir0: folds
wesol05: calls 20000
Perke0: raises 208401 to 228401 and is all-in
romk@vip: folds
themasteryan: folds
marval231: calls 208401
wesol05: folds
*** FLOP *** [6c Jh 8h]
*** TURN *** [6c Jh 8h] [2s]
*** RIVER *** [6c Jh 8h 2s] [3d]
*** SHOW DOWN ***
marval231: shows [Jc Js] (three of a kind, Jacks)
Perke0: shows [9c 9s] (a pair of Nines)
marval231 collected 500802 from pot
Perke0 finished the tournament in 225th place and received $78.28.
*** SUMMARY ***
Total pot 500802 | Rake 0
Board [6c Jh 8h 2s 3d]
Seat 1: wesol05 folded before Flop
Seat 2: Perke0 (button) showed [9c 9s] and lost with a pair of Nines
Seat 3: romk@vip (small blind) folded before Flop
Seat 4: themasteryan (big blind) folded before Flop
Seat 5: welcat folded before Flop (didn't bet)
Seat 6: marval231 showed [Jc Js] and won (500802) with three of a kind, Jacks
Seat 7: hichnick777 folded before Flop (didn't bet)
Seat 8: Dredjke folded before Flop (didn't bet)
Seat 9: guirib8ir0 folded before Flop (didn't bet)


*********** # 240 **************
PokerStars Hand #176677836858: Tournament #2054568934, $20+$2 USD Hold'em No Limit - Level XXVIII (5000/10000) - 2017/10/09 4:15:35 MSK [2017/10/08 21:15:35 ET]
Table '2054568934 506' 9-max Seat #3 is the button
Seat 1: wesol05 (781113 in chips)
Seat 3: romk@vip (361176 in chips)
Seat 4: themasteryan (659649 in chips)
Seat 5: welcat (281318 in chips)
Seat 6: marval231 (552817 in chips)
Seat 7: hichnick777 (194164 in chips)
Seat 8: Dredjke (119985 in chips)
Seat 9: guirib8ir0 (189623 in chips)
wesol05: posts the ante 1000
romk@vip: posts the ante 1000
themasteryan: posts the ante 1000
welcat: posts the ante 1000
marval231: posts the ante 1000
hichnick777: posts the ante 1000
Dredjke: posts the ante 1000
guirib8ir0: posts the ante 1000
themasteryan: posts small blind 5000
welcat: posts big blind 10000
*** HOLE CARDS ***
Dealt to hichnick777 [9h 2h]
marval231: folds
hichnick777: folds
Dredjke: folds
guirib8ir0: folds
wesol05: folds
romk@vip: raises 10000 to 20000
themasteryan: folds
welcat: calls 10000
*** FLOP *** [Tc 4h 3c]
welcat: checks
romk@vip: bets 20140
welcat: calls 20140
*** TURN *** [Tc 4h 3c] [6s]
welcat: checks
romk@vip: bets 41322
welcat: calls 41322
*** RIVER *** [Tc 4h 3c 6s] [9d]
welcat: checks
romk@vip: checks
*** SHOW DOWN ***
welcat: shows [Kc Qc] (high card King)
romk@vip: shows [2c 6h] (a pair of Sixes)
romk@vip collected 175924 from pot
*** SUMMARY ***
Total pot 175924 | Rake 0
Board [Tc 4h 3c 6s 9d]
Seat 1: wesol05 folded before Flop (didn't bet)
Seat 3: romk@vip (button) showed [2c 6h] and won (175924) with a pair of Sixes
Seat 4: themasteryan (small blind) folded before Flop
Seat 5: welcat (big blind) showed [Kc Qc] and lost with high card King
Seat 6: marval231 folded before Flop (didn't bet)
Seat 7: hichnick777 folded before Flop (didn't bet)
Seat 8: Dredjke folded before Flop (didn't bet)
Seat 9: guirib8ir0 folded before Flop (didn't bet)


*********** # 241 **************
PokerStars Hand #176677875477: Tournament #2054568934, $20+$2 USD Hold'em No Limit - Level XXVIII (5000/10000) - 2017/10/09 4:17:14 MSK [2017/10/08 21:17:14 ET]
Table '2054568934 506' 9-max Seat #4 is the button
Seat 1: wesol05 (780113 in chips)
Seat 3: romk@vip (454638 in chips)
Seat 4: themasteryan (653649 in chips)
Seat 5: welcat (198856 in chips)
Seat 6: marval231 (551817 in chips)
Seat 7: hichnick777 (193164 in chips)
Seat 8: Dredjke (118985 in chips)
Seat 9: guirib8ir0 (188623 in chips)
wesol05: posts the ante 1000
romk@vip: posts the ante 1000
themasteryan: posts the ante 1000
welcat: posts the ante 1000
marval231: posts the ante 1000
hichnick777: posts the ante 1000
Dredjke: posts the ante 1000
guirib8ir0: posts the ante 1000
welcat: posts small blind 5000
marval231: posts big blind 10000
*** HOLE CARDS ***
Dealt to hichnick777 [5c 7s]
hichnick777: folds
Dredjke: folds
guirib8ir0: folds
wesol05: folds
romk@vip: raises 10000 to 20000
themasteryan: folds
welcat: folds
marval231: calls 10000
*** FLOP *** [4s 4h 5d]
marval231: checks
romk@vip: bets 20140
marval231: folds
Uncalled bet (20140) returned to romk@vip
romk@vip collected 53000 from pot
*** SUMMARY ***
Total pot 53000 | Rake 0
Board [4s 4h 5d]
Seat 1: wesol05 folded before Flop (didn't bet)
Seat 3: romk@vip collected (53000)
Seat 4: themasteryan (button) folded before Flop (didn't bet)
Seat 5: welcat (small blind) folded before Flop
Seat 6: marval231 (big blind) folded on the Flop
Seat 7: hichnick777 folded before Flop (didn't bet)
Seat 8: Dredjke folded before Flop (didn't bet)
Seat 9: guirib8ir0 folded before Flop (didn't bet)


*********** # 242 **************
PokerStars Hand #176677897102: Tournament #2054568934, $20+$2 USD Hold'em No Limit - Level XXVIII (5000/10000) - 2017/10/09 4:18:10 MSK [2017/10/08 21:18:10 ET]
Table '2054568934 506' 9-max Seat #5 is the button
Seat 1: wesol05 (779113 in chips)
Seat 3: romk@vip (486638 in chips)
Seat 4: themasteryan (652649 in chips)
Seat 5: welcat (192856 in chips)
Seat 6: marval231 (530817 in chips)
Seat 7: hichnick777 (192164 in chips)
Seat 8: Dredjke (117985 in chips)
Seat 9: guirib8ir0 (187623 in chips)
wesol05: posts the ante 1000
romk@vip: posts the ante 1000
themasteryan: posts the ante 1000
welcat: posts the ante 1000
marval231: posts the ante 1000
hichnick777: posts the ante 1000
Dredjke: posts the ante 1000
guirib8ir0: posts the ante 1000
marval231: posts small blind 5000
hichnick777: posts big blind 10000
*** HOLE CARDS ***
Dealt to hichnick777 [9s Kh]
Dredjke: folds
guirib8ir0: folds
wesol05: folds
romk@vip: folds
themasteryan: raises 12085 to 22085
welcat: folds
marval231: folds
hichnick777: calls 12085
*** FLOP *** [2d 9c 7s]
hichnick777: checks
themasteryan: checks
*** TURN *** [2d 9c 7s] [Ac]
hichnick777: checks
themasteryan: bets 25585
hichnick777: calls 25585
*** RIVER *** [2d 9c 7s Ac] [6s]
hichnick777: checks
themasteryan: checks
*** SHOW DOWN ***
hichnick777: shows [9s Kh] (a pair of Nines)
themasteryan: mucks hand
hichnick777 collected 108340 from pot
*** SUMMARY ***
Total pot 108340 | Rake 0
Board [2d 9c 7s Ac 6s]
Seat 1: wesol05 folded before Flop (didn't bet)
Seat 3: romk@vip folded before Flop (didn't bet)
Seat 4: themasteryan mucked [Jc Qs]
Seat 5: welcat (button) folded before Flop (didn't bet)
Seat 6: marval231 (small blind) folded before Flop
Seat 7: hichnick777 (big blind) showed [9s Kh] and won (108340) with a pair of Nines
Seat 8: Dredjke folded before Flop (didn't bet)
Seat 9: guirib8ir0 folded before Flop (didn't bet)


*********** # 243 **************
PokerStars Hand #176677927887: Tournament #2054568934, $20+$2 USD Hold'em No Limit - Level XXIX (6000/12000) - 2017/10/09 4:19:29 MSK [2017/10/08 21:19:29 ET]
Table '2054568934 506' 9-max Seat #6 is the button
Seat 1: wesol05 (778113 in chips)
Seat 2: Dat'sGOOD (999535 in chips)
Seat 3: romk@vip (485638 in chips)
Seat 4: themasteryan (603979 in chips)
Seat 5: welcat (191856 in chips)
Seat 6: marval231 (524817 in chips)
Seat 7: hichnick777 (251834 in chips)
Seat 8: Dredjke (116985 in chips)
Seat 9: guirib8ir0 (186623 in chips)
wesol05: posts the ante 1200
Dat'sGOOD: posts the ante 1200
romk@vip: posts the ante 1200
themasteryan: posts the ante 1200
welcat: posts the ante 1200
marval231: posts the ante 1200
hichnick777: posts the ante 1200
Dredjke: posts the ante 1200
guirib8ir0: posts the ante 1200
hichnick777: posts small blind 6000
Dredjke: posts big blind 12000
*** HOLE CARDS ***
Dealt to hichnick777 [Ad Tc]
guirib8ir0: folds
wesol05: folds
Dat'sGOOD: folds
romk@vip: folds
themasteryan: folds
welcat: raises 12000 to 24000
marval231: folds
hichnick777: raises 226634 to 250634 and is all-in
Dredjke: folds
welcat: folds
Uncalled bet (226634) returned to hichnick777
hichnick777 collected 70800 from pot
hichnick777: doesn't show hand
*** SUMMARY ***
Total pot 70800 | Rake 0
Seat 1: wesol05 folded before Flop (didn't bet)
Seat 2: Dat'sGOOD folded before Flop (didn't bet)
Seat 3: romk@vip folded before Flop (didn't bet)
Seat 4: themasteryan folded before Flop (didn't bet)
Seat 5: welcat folded before Flop
Seat 6: marval231 (button) folded before Flop (didn't bet)
Seat 7: hichnick777 (small blind) collected (70800)
Seat 8: Dredjke (big blind) folded before Flop
Seat 9: guirib8ir0 folded before Flop (didn't bet)


*********** # 244 **************
PokerStars Hand #176677949745: Tournament #2054568934, $20+$2 USD Hold'em No Limit - Level XXIX (6000/12000) - 2017/10/09 4:20:26 MSK [2017/10/08 21:20:26 ET]
Table '2054568934 506' 9-max Seat #7 is the button
Seat 1: wesol05 (776913 in chips)
Seat 2: Dat'sGOOD (998335 in chips)
Seat 3: romk@vip (484438 in chips)
Seat 4: themasteryan (602779 in chips)
Seat 5: welcat (166656 in chips)
Seat 6: marval231 (523617 in chips)
Seat 7: hichnick777 (297434 in chips)
Seat 8: Dredjke (103785 in chips)
Seat 9: guirib8ir0 (185423 in chips)
wesol05: posts the ante 1200
Dat'sGOOD: posts the ante 1200
romk@vip: posts the ante 1200
themasteryan: posts the ante 1200
welcat: posts the ante 1200
marval231: posts the ante 1200
hichnick777: posts the ante 1200
Dredjke: posts the ante 1200
guirib8ir0: posts the ante 1200
Dredjke: posts small blind 6000
guirib8ir0: posts big blind 12000
*** HOLE CARDS ***
Dealt to hichnick777 [2d 3s]
wesol05: folds
Dat'sGOOD: folds
romk@vip: folds
themasteryan: folds
welcat: folds
marval231: raises 12000 to 24000
hichnick777: folds
Dredjke: folds
guirib8ir0: raises 160223 to 184223 and is all-in
marval231: folds
Uncalled bet (160223) returned to guirib8ir0
guirib8ir0 collected 64800 from pot
guirib8ir0: doesn't show hand
*** SUMMARY ***
Total pot 64800 | Rake 0
Seat 1: wesol05 folded before Flop (didn't bet)
Seat 2: Dat'sGOOD folded before Flop (didn't bet)
Seat 3: romk@vip folded before Flop (didn't bet)
Seat 4: themasteryan folded before Flop (didn't bet)
Seat 5: welcat folded before Flop (didn't bet)
Seat 6: marval231 folded before Flop
Seat 7: hichnick777 (button) folded before Flop (didn't bet)
Seat 8: Dredjke (small blind) folded before Flop
Seat 9: guirib8ir0 (big blind) collected (64800)


*********** # 245 **************
PokerStars Hand #176677974302: Tournament #2054568934, $20+$2 USD Hold'em No Limit - Level XXIX (6000/12000) - 2017/10/09 4:21:31 MSK [2017/10/08 21:21:31 ET]
Table '2054568934 506' 9-max Seat #8 is the button
Seat 1: wesol05 (775713 in chips)
Seat 2: Dat'sGOOD (997135 in chips)
Seat 3: romk@vip (483238 in chips)
Seat 4: themasteryan (601579 in chips)
Seat 5: welcat (165456 in chips)
Seat 6: marval231 (498417 in chips)
Seat 7: hichnick777 (296234 in chips)
Seat 8: Dredjke (96585 in chips)
Seat 9: guirib8ir0 (225023 in chips)
wesol05: posts the ante 1200
Dat'sGOOD: posts the ante 1200
romk@vip: posts the ante 1200
themasteryan: posts the ante 1200
welcat: posts the ante 1200
marval231: posts the ante 1200
hichnick777: posts the ante 1200
Dredjke: posts the ante 1200
guirib8ir0: posts the ante 1200
guirib8ir0: posts small blind 6000
wesol05: posts big blind 12000
*** HOLE CARDS ***
Dealt to hichnick777 [3s Qh]
Dat'sGOOD: folds
romk@vip: folds
themasteryan: folds
welcat: folds
marval231: folds
hichnick777: folds
Dredjke: folds
guirib8ir0: raises 211823 to 223823 and is all-in
wesol05: folds
Uncalled bet (211823) returned to guirib8ir0
guirib8ir0 collected 34800 from pot
guirib8ir0: doesn't show hand
*** SUMMARY ***
Total pot 34800 | Rake 0
Seat 1: wesol05 (big blind) folded before Flop
Seat 2: Dat'sGOOD folded before Flop (didn't bet)
Seat 3: romk@vip folded before Flop (didn't bet)
Seat 4: themasteryan folded before Flop (didn't bet)
Seat 5: welcat folded before Flop (didn't bet)
Seat 6: marval231 folded before Flop (didn't bet)
Seat 7: hichnick777 folded before Flop (didn't bet)
Seat 8: Dredjke (button) folded before Flop (didn't bet)
Seat 9: guirib8ir0 (small blind) collected (34800)


*********** # 246 **************
PokerStars Hand #176677992505: Tournament #2054568934, $20+$2 USD Hold'em No Limit - Level XXIX (6000/12000) - 2017/10/09 4:22:18 MSK [2017/10/08 21:22:18 ET]
Table '2054568934 506' 9-max Seat #9 is the button
Seat 1: wesol05 (762513 in chips)
Seat 2: Dat'sGOOD (995935 in chips)
Seat 3: romk@vip (482038 in chips)
Seat 4: themasteryan (600379 in chips)
Seat 5: welcat (164256 in chips)
Seat 6: marval231 (497217 in chips)
Seat 7: hichnick777 (295034 in chips)
Seat 8: Dredjke (95385 in chips)
Seat 9: guirib8ir0 (246623 in chips)
wesol05: posts the ante 1200
Dat'sGOOD: posts the ante 1200
romk@vip: posts the ante 1200
themasteryan: posts the ante 1200
welcat: posts the ante 1200
marval231: posts the ante 1200
hichnick777: posts the ante 1200
Dredjke: posts the ante 1200
guirib8ir0: posts the ante 1200
wesol05: posts small blind 6000
Dat'sGOOD: posts big blind 12000
*** HOLE CARDS ***
Dealt to hichnick777 [7c Kh]
romk@vip: folds
themasteryan: raises 13085 to 25085
welcat: folds
marval231: folds
hichnick777: folds
Dredjke: folds
guirib8ir0: folds
wesol05: folds
Dat'sGOOD: calls 13085
*** FLOP *** [Ks 3d Ad]
Dat'sGOOD: checks
themasteryan: bets 27785
Dat'sGOOD: folds
Uncalled bet (27785) returned to themasteryan
themasteryan collected 66970 from pot
themasteryan: doesn't show hand
*** SUMMARY ***
Total pot 66970 | Rake 0
Board [Ks 3d Ad]
Seat 1: wesol05 (small blind) folded before Flop
Seat 2: Dat'sGOOD (big blind) folded on the Flop
Seat 3: romk@vip folded before Flop (didn't bet)
Seat 4: themasteryan collected (66970)
Seat 5: welcat folded before Flop (didn't bet)
Seat 6: marval231 folded before Flop (didn't bet)
Seat 7: hichnick777 folded before Flop (didn't bet)
Seat 8: Dredjke folded before Flop (didn't bet)
Seat 9: guirib8ir0 (button) folded before Flop (didn't bet)


*********** # 247 **************
PokerStars Hand #176678018952: Tournament #2054568934, $20+$2 USD Hold'em No Limit - Level XXIX (6000/12000) - 2017/10/09 4:23:27 MSK [2017/10/08 21:23:27 ET]
Table '2054568934 506' 9-max Seat #1 is the button
Seat 1: wesol05 (755313 in chips)
Seat 2: Dat'sGOOD (969650 in chips)
Seat 3: romk@vip (480838 in chips)
Seat 4: themasteryan (641064 in chips)
Seat 5: welcat (163056 in chips)
Seat 6: marval231 (496017 in chips)
Seat 7: hichnick777 (293834 in chips)
Seat 8: Dredjke (94185 in chips)
Seat 9: guirib8ir0 (245423 in chips)
wesol05: posts the ante 1200
Dat'sGOOD: posts the ante 1200
romk@vip: posts the ante 1200
themasteryan: posts the ante 1200
welcat: posts the ante 1200
marval231: posts the ante 1200
hichnick777: posts the ante 1200
Dredjke: posts the ante 1200
guirib8ir0: posts the ante 1200
Dat'sGOOD: posts small blind 6000
romk@vip: posts big blind 12000
*** HOLE CARDS ***
Dealt to hichnick777 [5s 3c]
themasteryan: folds
welcat: folds
marval231: folds
hichnick777: folds
Dredjke: folds
guirib8ir0: raises 12000 to 24000
wesol05: calls 24000
Dat'sGOOD: raises 60000 to 84000
romk@vip: folds
guirib8ir0: folds
wesol05: calls 60000
*** FLOP *** [5d Kh Tc]
Dat'sGOOD: bets 84000
wesol05: calls 84000
*** TURN *** [5d Kh Tc] [As]
Dat'sGOOD: bets 144000
wesol05: folds
Uncalled bet (144000) returned to Dat'sGOOD
Dat'sGOOD collected 382800 from pot
*** SUMMARY ***
Total pot 382800 | Rake 0
Board [5d Kh Tc As]
Seat 1: wesol05 (button) folded on the Turn
Seat 2: Dat'sGOOD (small blind) collected (382800)
Seat 3: romk@vip (big blind) folded before Flop
Seat 4: themasteryan folded before Flop (didn't bet)
Seat 5: welcat folded before Flop (didn't bet)
Seat 6: marval231 folded before Flop (didn't bet)
Seat 7: hichnick777 folded before Flop (didn't bet)
Seat 8: Dredjke folded before Flop (didn't bet)
Seat 9: guirib8ir0 folded before Flop


*********** # 248 **************
PokerStars Hand #176678058459: Tournament #2054568934, $20+$2 USD Hold'em No Limit - Level XXIX (6000/12000) - 2017/10/09 4:25:05 MSK [2017/10/08 21:25:05 ET]
Table '2054568934 506' 9-max Seat #2 is the button
Seat 1: wesol05 (586113 in chips)
Seat 2: Dat'sGOOD (1183250 in chips)
Seat 3: romk@vip (467638 in chips)
Seat 4: themasteryan (639864 in chips)
Seat 5: welcat (161856 in chips)
Seat 6: marval231 (494817 in chips)
Seat 7: hichnick777 (292634 in chips)
Seat 8: Dredjke (92985 in chips)
Seat 9: guirib8ir0 (220223 in chips)
wesol05: posts the ante 1200
Dat'sGOOD: posts the ante 1200
romk@vip: posts the ante 1200
themasteryan: posts the ante 1200
welcat: posts the ante 1200
marval231: posts the ante 1200
hichnick777: posts the ante 1200
Dredjke: posts the ante 1200
guirib8ir0: posts the ante 1200
romk@vip: posts small blind 6000
themasteryan: posts big blind 12000
*** HOLE CARDS ***
Dealt to hichnick777 [8h Jh]
welcat: folds
marval231: folds
hichnick777: folds
Dredjke: folds
guirib8ir0: folds
wesol05: folds
Dat'sGOOD: folds
romk@vip: calls 6000
themasteryan: checks
*** FLOP *** [4h Qh Js]
romk@vip: bets 13224
themasteryan: calls 13224
*** TURN *** [4h Qh Js] [Ac]
romk@vip: bets 23274
themasteryan: folds
Uncalled bet (23274) returned to romk@vip
romk@vip collected 61248 from pot
*** SUMMARY ***
Total pot 61248 | Rake 0
Board [4h Qh Js Ac]
Seat 1: wesol05 folded before Flop (didn't bet)
Seat 2: Dat'sGOOD (button) folded before Flop (didn't bet)
Seat 3: romk@vip (small blind) collected (61248)
Seat 4: themasteryan (big blind) folded on the Turn
Seat 5: welcat folded before Flop (didn't bet)
Seat 6: marval231 folded before Flop (didn't bet)
Seat 7: hichnick777 folded before Flop (didn't bet)
Seat 8: Dredjke folded before Flop (didn't bet)
Seat 9: guirib8ir0 folded before Flop (didn't bet)


*********** # 249 **************
PokerStars Hand #176678086119: Tournament #2054568934, $20+$2 USD Hold'em No Limit - Level XXIX (6000/12000) - 2017/10/09 4:26:18 MSK [2017/10/08 21:26:18 ET]
Table '2054568934 506' 9-max Seat #3 is the button
Seat 1: wesol05 (584913 in chips)
Seat 2: Dat'sGOOD (1182050 in chips)
Seat 3: romk@vip (502462 in chips)
Seat 4: themasteryan (613440 in chips)
Seat 5: welcat (160656 in chips)
Seat 6: marval231 (493617 in chips)
Seat 7: hichnick777 (291434 in chips)
Seat 8: Dredjke (91785 in chips)
Seat 9: guirib8ir0 (219023 in chips)
wesol05: posts the ante 1200
Dat'sGOOD: posts the ante 1200
romk@vip: posts the ante 1200
themasteryan: posts the ante 1200
welcat: posts the ante 1200
marval231: posts the ante 1200
hichnick777: posts the ante 1200
Dredjke: posts the ante 1200
guirib8ir0: posts the ante 1200
themasteryan: posts small blind 6000
welcat: posts big blind 12000
*** HOLE CARDS ***
Dealt to hichnick777 [Ts Ad]
marval231: folds
hichnick777: raises 15000 to 27000
Dredjke: folds
guirib8ir0: folds
wesol05: folds
Dat'sGOOD: folds
romk@vip: folds
themasteryan: folds
welcat: folds
Uncalled bet (15000) returned to hichnick777
hichnick777 collected 40800 from pot
hichnick777: doesn't show hand
*** SUMMARY ***
Total pot 40800 | Rake 0
Seat 1: wesol05 folded before Flop (didn't bet)
Seat 2: Dat'sGOOD folded before Flop (didn't bet)
Seat 3: romk@vip (button) folded before Flop (didn't bet)
Seat 4: themasteryan (small blind) folded before Flop
Seat 5: welcat (big blind) folded before Flop
Seat 6: marval231 folded before Flop (didn't bet)
Seat 7: hichnick777 collected (40800)
Seat 8: Dredjke folded before Flop (didn't bet)
Seat 9: guirib8ir0 folded before Flop (didn't bet)


*********** # 250 **************
PokerStars Hand #176678100885: Tournament #2054568934, $20+$2 USD Hold'em No Limit - Level XXIX (6000/12000) - 2017/10/09 4:26:57 MSK [2017/10/08 21:26:57 ET]
Table '2054568934 506' 9-max Seat #4 is the button
Seat 1: wesol05 (583713 in chips)
Seat 2: Dat'sGOOD (1180850 in chips)
Seat 3: romk@vip (501262 in chips)
Seat 4: themasteryan (606240 in chips)
Seat 5: welcat (147456 in chips)
Seat 6: marval231 (492417 in chips)
Seat 7: hichnick777 (319034 in chips)
Seat 8: Dredjke (90585 in chips)
Seat 9: guirib8ir0 (217823 in chips)
wesol05: posts the ante 1200
Dat'sGOOD: posts the ante 1200
romk@vip: posts the ante 1200
themasteryan: posts the ante 1200
welcat: posts the ante 1200
marval231: posts the ante 1200
hichnick777: posts the ante 1200
Dredjke: posts the ante 1200
guirib8ir0: posts the ante 1200
welcat: posts small blind 6000
marval231: posts big blind 12000
*** HOLE CARDS ***
Dealt to hichnick777 [Qd Ks]
hichnick777: raises 15000 to 27000
Dredjke: folds
guirib8ir0: folds
wesol05: folds
Dat'sGOOD: folds
romk@vip: folds
themasteryan: folds
welcat: folds
marval231: folds
Uncalled bet (15000) returned to hichnick777
hichnick777 collected 40800 from pot
hichnick777: doesn't show hand
*** SUMMARY ***
Total pot 40800 | Rake 0
Seat 1: wesol05 folded before Flop (didn't bet)
Seat 2: Dat'sGOOD folded before Flop (didn't bet)
Seat 3: romk@vip folded before Flop (didn't bet)
Seat 4: themasteryan (button) folded before Flop (didn't bet)
Seat 5: welcat (small blind) folded before Flop
Seat 6: marval231 (big blind) folded before Flop
Seat 7: hichnick777 collected (40800)
Seat 8: Dredjke folded before Flop (didn't bet)
Seat 9: guirib8ir0 folded before Flop (didn't bet)


*********** # 251 **************
PokerStars Hand #176678121335: Tournament #2054568934, $20+$2 USD Hold'em No Limit - Level XXIX (6000/12000) - 2017/10/09 4:27:50 MSK [2017/10/08 21:27:50 ET]
Table '2054568934 506' 9-max Seat #5 is the button
Seat 1: wesol05 (582513 in chips)
Seat 2: Dat'sGOOD (1179650 in chips)
Seat 3: romk@vip (500062 in chips)
Seat 4: themasteryan (605040 in chips)
Seat 5: welcat (140256 in chips)
Seat 6: marval231 (479217 in chips)
Seat 7: hichnick777 (346634 in chips)
Seat 8: Dredjke (89385 in chips)
Seat 9: guirib8ir0 (216623 in chips)
wesol05: posts the ante 1200
Dat'sGOOD: posts the ante 1200
romk@vip: posts the ante 1200
themasteryan: posts the ante 1200
welcat: posts the ante 1200
marval231: posts the ante 1200
hichnick777: posts the ante 1200
Dredjke: posts the ante 1200
guirib8ir0: posts the ante 1200
marval231: posts small blind 6000
hichnick777: posts big blind 12000
*** HOLE CARDS ***
Dealt to hichnick777 [8c 4c]
Dredjke: folds
guirib8ir0: raises 12000 to 24000
wesol05: folds
Dat'sGOOD: folds
romk@vip: folds
themasteryan: raises 32685 to 56685
welcat: folds
marval231: folds
hichnick777: folds
guirib8ir0: folds
Uncalled bet (32685) returned to themasteryan
themasteryan collected 76800 from pot
themasteryan: doesn't show hand
*** SUMMARY ***
Total pot 76800 | Rake 0
Seat 1: wesol05 folded before Flop (didn't bet)
Seat 2: Dat'sGOOD folded before Flop (didn't bet)
Seat 3: romk@vip folded before Flop (didn't bet)
Seat 4: themasteryan collected (76800)
Seat 5: welcat (button) folded before Flop (didn't bet)
Seat 6: marval231 (small blind) folded before Flop
Seat 7: hichnick777 (big blind) folded before Flop
Seat 8: Dredjke folded before Flop (didn't bet)
Seat 9: guirib8ir0 folded before Flop


*********** # 252 **************
PokerStars Hand #176678144619: Tournament #2054568934, $20+$2 USD Hold'em No Limit - Level XXIX (6000/12000) - 2017/10/09 4:28:52 MSK [2017/10/08 21:28:52 ET]
Table '2054568934 506' 9-max Seat #6 is the button
Seat 1: wesol05 (581313 in chips)
Seat 2: Dat'sGOOD (1178450 in chips)
Seat 3: romk@vip (498862 in chips)
Seat 4: themasteryan (656640 in chips)
Seat 5: welcat (139056 in chips)
Seat 6: marval231 (472017 in chips)
Seat 7: hichnick777 (333434 in chips)
Seat 8: Dredjke (88185 in chips)
Seat 9: guirib8ir0 (191423 in chips)
wesol05: posts the ante 1200
Dat'sGOOD: posts the ante 1200
romk@vip: posts the ante 1200
themasteryan: posts the ante 1200
welcat: posts the ante 1200
marval231: posts the ante 1200
hichnick777: posts the ante 1200
Dredjke: posts the ante 1200
guirib8ir0: posts the ante 1200
hichnick777: posts small blind 6000
Dredjke: posts big blind 12000
*** HOLE CARDS ***
Dealt to hichnick777 [8s 9d]
guirib8ir0: folds
wesol05: folds
Dat'sGOOD: folds
romk@vip: folds
themasteryan: folds
welcat: folds
marval231: folds
hichnick777: raises 320234 to 332234 and is all-in
Dredjke: calls 74985 and is all-in
Uncalled bet (245249) returned to hichnick777
*** FLOP *** [Jh Qc 5c]
*** TURN *** [Jh Qc 5c] [Ts]
*** RIVER *** [Jh Qc 5c Ts] [Ks]
*** SHOW DOWN ***
hichnick777: shows [8s 9d] (a straight, Nine to King)
Dredjke: shows [Td As] (a straight, Ten to Ace)
Dredjke collected 184770 from pot
*** SUMMARY ***
Total pot 184770 | Rake 0
Board [Jh Qc 5c Ts Ks]
Seat 1: wesol05 folded before Flop (didn't bet)
Seat 2: Dat'sGOOD folded before Flop (didn't bet)
Seat 3: romk@vip folded before Flop (didn't bet)
Seat 4: themasteryan folded before Flop (didn't bet)
Seat 5: welcat folded before Flop (didn't bet)
Seat 6: marval231 (button) folded before Flop (didn't bet)
Seat 7: hichnick777 (small blind) showed [8s 9d] and lost with a straight, Nine to King
Seat 8: Dredjke (big blind) showed [Td As] and won (184770) with a straight, Ten to Ace
Seat 9: guirib8ir0 folded before Flop (didn't bet)


*********** # 253 **************
PokerStars Hand #176678164478: Tournament #2054568934, $20+$2 USD Hold'em No Limit - Level XXIX (6000/12000) - 2017/10/09 4:29:42 MSK [2017/10/08 21:29:42 ET]
Table '2054568934 506' 9-max Seat #7 is the button
Seat 1: wesol05 (580113 in chips)
Seat 2: Dat'sGOOD (1177250 in chips)
Seat 3: romk@vip (497662 in chips)
Seat 4: themasteryan (655440 in chips)
Seat 5: welcat (137856 in chips)
Seat 6: marval231 (470817 in chips)
Seat 7: hichnick777 (245249 in chips)
Seat 8: Dredjke (184770 in chips)
Seat 9: guirib8ir0 (190223 in chips)
wesol05: posts the ante 1200
Dat'sGOOD: posts the ante 1200
romk@vip: posts the ante 1200
themasteryan: posts the ante 1200
welcat: posts the ante 1200
marval231: posts the ante 1200
hichnick777: posts the ante 1200
Dredjke: posts the ante 1200
guirib8ir0: posts the ante 1200
Dredjke: posts small blind 6000
guirib8ir0: posts big blind 12000
*** HOLE CARDS ***
Dealt to hichnick777 [4h Qh]
wesol05: folds
Dat'sGOOD: folds
romk@vip: folds
themasteryan: folds
welcat: folds
marval231: folds
hichnick777: raises 12960 to 24960
Dredjke: folds
guirib8ir0: raises 164063 to 189023 and is all-in
hichnick777: folds
Uncalled bet (164063) returned to guirib8ir0
guirib8ir0 collected 66720 from pot
guirib8ir0: doesn't show hand
*** SUMMARY ***
Total pot 66720 | Rake 0
Seat 1: wesol05 folded before Flop (didn't bet)
Seat 2: Dat'sGOOD folded before Flop (didn't bet)
Seat 3: romk@vip folded before Flop (didn't bet)
Seat 4: themasteryan folded before Flop (didn't bet)
Seat 5: welcat folded before Flop (didn't bet)
Seat 6: marval231 folded before Flop (didn't bet)
Seat 7: hichnick777 (button) folded before Flop
Seat 8: Dredjke (small blind) folded before Flop
Seat 9: guirib8ir0 (big blind) collected (66720)


*********** # 254 **************
PokerStars Hand #176678186233: Tournament #2054568934, $20+$2 USD Hold'em No Limit - Level XXIX (6000/12000) - 2017/10/09 4:30:41 MSK [2017/10/08 21:30:41 ET]
Table '2054568934 506' 9-max Seat #8 is the button
Seat 1: wesol05 (578913 in chips)
Seat 2: Dat'sGOOD (1176050 in chips)
Seat 3: romk@vip (496462 in chips)
Seat 4: themasteryan (654240 in chips)
Seat 5: welcat (136656 in chips)
Seat 6: marval231 (469617 in chips)
Seat 7: hichnick777 (219089 in chips)
Seat 8: Dredjke (177570 in chips)
Seat 9: guirib8ir0 (230783 in chips)
wesol05: posts the ante 1200
Dat'sGOOD: posts the ante 1200
romk@vip: posts the ante 1200
themasteryan: posts the ante 1200
welcat: posts the ante 1200
marval231: posts the ante 1200
hichnick777: posts the ante 1200
Dredjke: posts the ante 1200
guirib8ir0: posts the ante 1200
guirib8ir0: posts small blind 6000
wesol05: posts big blind 12000
*** HOLE CARDS ***
Dealt to hichnick777 [3d 9c]
Dat'sGOOD: raises 18000 to 30000
romk@vip: folds
themasteryan: folds
welcat: folds
marval231: folds
hichnick777: folds
Dredjke: folds
guirib8ir0: calls 24000
wesol05: folds
*** FLOP *** [9d 8s 6s]
guirib8ir0: checks
Dat'sGOOD: checks
*** TURN *** [9d 8s 6s] [7c]
guirib8ir0: checks
Dat'sGOOD: checks
*** RIVER *** [9d 8s 6s 7c] [8c]
guirib8ir0: bets 60000
Dat'sGOOD: calls 60000
*** SHOW DOWN ***
guirib8ir0: shows [Qc Tc] (a straight, Six to Ten)
Dat'sGOOD: mucks hand
guirib8ir0 collected 202800 from pot
*** SUMMARY ***
Total pot 202800 | Rake 0
Board [9d 8s 6s 7c 8c]
Seat 1: wesol05 (big blind) folded before Flop
Seat 2: Dat'sGOOD mucked [Ac Kc]
Seat 3: romk@vip folded before Flop (didn't bet)
Seat 4: themasteryan folded before Flop (didn't bet)
Seat 5: welcat folded before Flop (didn't bet)
Seat 6: marval231 folded before Flop (didn't bet)
Seat 7: hichnick777 folded before Flop (didn't bet)
Seat 8: Dredjke (button) folded before Flop (didn't bet)
Seat 9: guirib8ir0 (small blind) showed [Qc Tc] and won (202800) with a straight, Six to Ten


*********** # 255 **************
PokerStars Hand #176678214506: Tournament #2054568934, $20+$2 USD Hold'em No Limit - Level XXX (8000/16000) - 2017/10/09 4:31:57 MSK [2017/10/08 21:31:57 ET]
Table '2054568934 506' 9-max Seat #9 is the button
Seat 1: wesol05 (565713 in chips)
Seat 2: Dat'sGOOD (1084850 in chips)
Seat 3: romk@vip (495262 in chips)
Seat 4: themasteryan (653040 in chips)
Seat 5: welcat (135456 in chips)
Seat 6: marval231 (468417 in chips)
Seat 7: hichnick777 (217889 in chips)
Seat 8: Dredjke (176370 in chips)
Seat 9: guirib8ir0 (342383 in chips)
wesol05: posts the ante 1600
Dat'sGOOD: posts the ante 1600
romk@vip: posts the ante 1600
themasteryan: posts the ante 1600
welcat: posts the ante 1600
marval231: posts the ante 1600
hichnick777: posts the ante 1600
Dredjke: posts the ante 1600
guirib8ir0: posts the ante 1600
wesol05: posts small blind 8000
Dat'sGOOD: posts big blind 16000
*** HOLE CARDS ***
Dealt to hichnick777 [Tc 7h]
romk@vip: folds
themasteryan: folds
welcat: folds
marval231: folds
hichnick777: folds
Dredjke: raises 158770 to 174770 and is all-in
guirib8ir0: folds
wesol05: folds
Dat'sGOOD: folds
Uncalled bet (158770) returned to Dredjke
Dredjke collected 54400 from pot
Dredjke: doesn't show hand
*** SUMMARY ***
Total pot 54400 | Rake 0
Seat 1: wesol05 (small blind) folded before Flop
Seat 2: Dat'sGOOD (big blind) folded before Flop
Seat 3: romk@vip folded before Flop (didn't bet)
Seat 4: themasteryan folded before Flop (didn't bet)
Seat 5: welcat folded before Flop (didn't bet)
Seat 6: marval231 folded before Flop (didn't bet)
Seat 7: hichnick777 folded before Flop (didn't bet)
Seat 8: Dredjke collected (54400)
Seat 9: guirib8ir0 (button) folded before Flop (didn't bet)


*********** # 256 **************
PokerStars Hand #176678224817: Tournament #2054568934, $20+$2 USD Hold'em No Limit - Level XXX (8000/16000) - 2017/10/09 4:32:25 MSK [2017/10/08 21:32:25 ET]
Table '2054568934 506' 9-max Seat #1 is the button
Seat 1: wesol05 (556113 in chips)
Seat 2: Dat'sGOOD (1067250 in chips)
Seat 3: romk@vip (493662 in chips)
Seat 4: themasteryan (651440 in chips)
Seat 5: welcat (133856 in chips)
Seat 6: marval231 (466817 in chips)
Seat 7: hichnick777 (216289 in chips)
Seat 8: Dredjke (213170 in chips)
Seat 9: guirib8ir0 (340783 in chips)
wesol05: posts the ante 1600
Dat'sGOOD: posts the ante 1600
romk@vip: posts the ante 1600
themasteryan: posts the ante 1600
welcat: posts the ante 1600
marval231: posts the ante 1600
hichnick777: posts the ante 1600
Dredjke: posts the ante 1600
guirib8ir0: posts the ante 1600
Dat'sGOOD: posts small blind 8000
romk@vip: posts big blind 16000
*** HOLE CARDS ***
Dealt to hichnick777 [8s 7h]
themasteryan: folds
welcat: folds
marval231: folds
hichnick777: folds
Dredjke: folds
guirib8ir0: raises 16000 to 32000
wesol05: folds
Dat'sGOOD: folds
romk@vip: raises 460062 to 492062 and is all-in
guirib8ir0: calls 307183 and is all-in
Uncalled bet (152879) returned to romk@vip
*** FLOP *** [9c 7s Qd]
*** TURN *** [9c 7s Qd] [As]
*** RIVER *** [9c 7s Qd As] [Kh]
*** SHOW DOWN ***
romk@vip: shows [Qs 9d] (two pair, Queens and Nines)
guirib8ir0: shows [Ac Ad] (three of a kind, Aces)
guirib8ir0 collected 700766 from pot
*** SUMMARY ***
Total pot 700766 | Rake 0
Board [9c 7s Qd As Kh]
Seat 1: wesol05 (button) folded before Flop (didn't bet)
Seat 2: Dat'sGOOD (small blind) folded before Flop
Seat 3: romk@vip (big blind) showed [Qs 9d] and lost with two pair, Queens and Nines
Seat 4: themasteryan folded before Flop (didn't bet)
Seat 5: welcat folded before Flop (didn't bet)
Seat 6: marval231 folded before Flop (didn't bet)
Seat 7: hichnick777 folded before Flop (didn't bet)
Seat 8: Dredjke folded before Flop (didn't bet)
Seat 9: guirib8ir0 showed [Ac Ad] and won (700766) with three of a kind, Aces


*********** # 257 **************
PokerStars Hand #176678242878: Tournament #2054568934, $20+$2 USD Hold'em No Limit - Level XXX (8000/16000) - 2017/10/09 4:33:13 MSK [2017/10/08 21:33:13 ET]
Table '2054568934 506' 9-max Seat #2 is the button
Seat 1: wesol05 (554513 in chips)
Seat 2: Dat'sGOOD (1057650 in chips)
Seat 3: romk@vip (152879 in chips)
Seat 4: themasteryan (649840 in chips)
Seat 5: welcat (132256 in chips)
Seat 6: marval231 (465217 in chips)
Seat 7: hichnick777 (214689 in chips)
Seat 8: Dredjke (211570 in chips)
Seat 9: guirib8ir0 (700766 in chips)
wesol05: posts the ante 1600
Dat'sGOOD: posts the ante 1600
romk@vip: posts the ante 1600
themasteryan: posts the ante 1600
welcat: posts the ante 1600
marval231: posts the ante 1600
hichnick777: posts the ante 1600
Dredjke: posts the ante 1600
guirib8ir0: posts the ante 1600
romk@vip: posts small blind 8000
themasteryan: posts big blind 16000
*** HOLE CARDS ***
Dealt to hichnick777 [Td Js]
Dat'sGOOD said, "almost"
welcat: folds
marval231: folds
hichnick777: folds
Dredjke: folds
guirib8ir0: raises 16000 to 32000
wesol05: raises 53869 to 85869
Dat'sGOOD: folds
romk@vip: folds
themasteryan: folds
guirib8ir0: folds
Uncalled bet (53869) returned to wesol05
wesol05 collected 102400 from pot
wesol05: doesn't show hand
*** SUMMARY ***
Total pot 102400 | Rake 0
Seat 1: wesol05 collected (102400)
Seat 2: Dat'sGOOD (button) folded before Flop (didn't bet)
Seat 3: romk@vip (small blind) folded before Flop
Seat 4: themasteryan (big blind) folded before Flop
Seat 5: welcat folded before Flop (didn't bet)
Seat 6: marval231 folded before Flop (didn't bet)
Seat 7: hichnick777 folded before Flop (didn't bet)
Seat 8: Dredjke folded before Flop (didn't bet)
Seat 9: guirib8ir0 folded before Flop


*********** # 258 **************
PokerStars Hand #176678268493: Tournament #2054568934, $20+$2 USD Hold'em No Limit - Level XXX (8000/16000) - 2017/10/09 4:34:14 MSK [2017/10/08 21:34:14 ET]
Table '2054568934 506' 9-max Seat #3 is the button
Seat 1: wesol05 (623313 in chips)
Seat 2: Dat'sGOOD (1056050 in chips)
Seat 3: romk@vip (143279 in chips)
Seat 4: themasteryan (632240 in chips)
Seat 5: welcat (130656 in chips)
Seat 6: marval231 (463617 in chips)
Seat 7: hichnick777 (213089 in chips)
Seat 8: Dredjke (209970 in chips)
Seat 9: guirib8ir0 (667166 in chips)
wesol05: posts the ante 1600
Dat'sGOOD: posts the ante 1600
romk@vip: posts the ante 1600
themasteryan: posts the ante 1600
welcat: posts the ante 1600
marval231: posts the ante 1600
hichnick777: posts the ante 1600
Dredjke: posts the ante 1600
guirib8ir0: posts the ante 1600
themasteryan: posts small blind 8000
welcat: posts big blind 16000
*** HOLE CARDS ***
Dealt to hichnick777 [Qh 2d]
marval231: folds
hichnick777: folds
Dredjke: folds
guirib8ir0: folds
wesol05: folds
Dat'sGOOD: folds
romk@vip: folds
themasteryan: raises 614640 to 630640 and is all-in
welcat: folds
Uncalled bet (614640) returned to themasteryan
themasteryan collected 46400 from pot
themasteryan: doesn't show hand
*** SUMMARY ***
Total pot 46400 | Rake 0
Seat 1: wesol05 folded before Flop (didn't bet)
Seat 2: Dat'sGOOD folded before Flop (didn't bet)
Seat 3: romk@vip (button) folded before Flop (didn't bet)
Seat 4: themasteryan (small blind) collected (46400)
Seat 5: welcat (big blind) folded before Flop
Seat 6: marval231 folded before Flop (didn't bet)
Seat 7: hichnick777 folded before Flop (didn't bet)
Seat 8: Dredjke folded before Flop (didn't bet)
Seat 9: guirib8ir0 folded before Flop (didn't bet)


*********** # 259 **************
PokerStars Hand #176678286943: Tournament #2054568934, $20+$2 USD Hold'em No Limit - Level XXX (8000/16000) - 2017/10/09 4:35:03 MSK [2017/10/08 21:35:03 ET]
Table '2054568934 506' 9-max Seat #4 is the button
Seat 1: wesol05 (621713 in chips)
Seat 2: Dat'sGOOD (1054450 in chips)
Seat 3: romk@vip (141679 in chips)
Seat 4: themasteryan (661040 in chips)
Seat 5: welcat (113056 in chips)
Seat 6: marval231 (462017 in chips)
Seat 7: hichnick777 (211489 in chips)
Seat 8: Dredjke (208370 in chips)
Seat 9: guirib8ir0 (665566 in chips)
wesol05: posts the ante 1600
Dat'sGOOD: posts the ante 1600
romk@vip: posts the ante 1600
themasteryan: posts the ante 1600
welcat: posts the ante 1600
marval231: posts the ante 1600
hichnick777: posts the ante 1600
Dredjke: posts the ante 1600
guirib8ir0: posts the ante 1600
welcat: posts small blind 8000
marval231: posts big blind 16000
*** HOLE CARDS ***
Dealt to hichnick777 [8c 9d]
hichnick777: folds
Dredjke: folds
guirib8ir0: folds
wesol05: folds
Dat'sGOOD: folds
romk@vip: raises 124079 to 140079 and is all-in
themasteryan: folds
welcat: folds
marval231: folds
Uncalled bet (124079) returned to romk@vip
romk@vip collected 54400 from pot
*** SUMMARY ***
Total pot 54400 | Rake 0
Seat 1: wesol05 folded before Flop (didn't bet)
Seat 2: Dat'sGOOD folded before Flop (didn't bet)
Seat 3: romk@vip collected (54400)
Seat 4: themasteryan (button) folded before Flop (didn't bet)
Seat 5: welcat (small blind) folded before Flop
Seat 6: marval231 (big blind) folded before Flop
Seat 7: hichnick777 folded before Flop (didn't bet)
Seat 8: Dredjke folded before Flop (didn't bet)
Seat 9: guirib8ir0 folded before Flop (didn't bet)


*********** # 260 **************
PokerStars Hand #176678297933: Tournament #2054568934, $20+$2 USD Hold'em No Limit - Level XXX (8000/16000) - 2017/10/09 4:35:33 MSK [2017/10/08 21:35:33 ET]
Table '2054568934 506' 9-max Seat #5 is the button
Seat 1: wesol05 (620113 in chips)
Seat 2: Dat'sGOOD (1052850 in chips)
Seat 3: romk@vip (178479 in chips)
Seat 4: themasteryan (659440 in chips)
Seat 5: welcat (103456 in chips)
Seat 6: marval231 (444417 in chips)
Seat 7: hichnick777 (209889 in chips)
Seat 8: Dredjke (206770 in chips)
Seat 9: guirib8ir0 (663966 in chips)
wesol05: posts the ante 1600
Dat'sGOOD: posts the ante 1600
romk@vip: posts the ante 1600
themasteryan: posts the ante 1600
welcat: posts the ante 1600
marval231: posts the ante 1600
hichnick777: posts the ante 1600
Dredjke: posts the ante 1600
guirib8ir0: posts the ante 1600
marval231: posts small blind 8000
hichnick777: posts big blind 16000
*** HOLE CARDS ***
Dealt to hichnick777 [6c 6d]
Dredjke: folds
guirib8ir0: raises 16000 to 32000
wesol05: folds
Dat'sGOOD: folds
romk@vip: folds
themasteryan: folds
welcat: folds
marval231: folds
hichnick777: raises 176289 to 208289 and is all-in
guirib8ir0: folds
Uncalled bet (176289) returned to hichnick777
hichnick777 collected 86400 from pot
hichnick777: doesn't show hand
*** SUMMARY ***
Total pot 86400 | Rake 0
Seat 1: wesol05 folded before Flop (didn't bet)
Seat 2: Dat'sGOOD folded before Flop (didn't bet)
Seat 3: romk@vip folded before Flop (didn't bet)
Seat 4: themasteryan folded before Flop (didn't bet)
Seat 5: welcat (button) folded before Flop (didn't bet)
Seat 6: marval231 (small blind) folded before Flop
Seat 7: hichnick777 (big blind) collected (86400)
Seat 8: Dredjke folded before Flop (didn't bet)
Seat 9: guirib8ir0 folded before Flop


*********** # 261 **************
PokerStars Hand #176678316869: Tournament #2054568934, $20+$2 USD Hold'em No Limit - Level XXX (8000/16000) - 2017/10/09 4:36:24 MSK [2017/10/08 21:36:24 ET]
Table '2054568934 506' 9-max Seat #6 is the button
Seat 1: wesol05 (618513 in chips)
Seat 2: Dat'sGOOD (1051250 in chips)
Seat 3: romk@vip (176879 in chips)
Seat 4: themasteryan (657840 in chips)
Seat 5: welcat (101856 in chips)
Seat 6: marval231 (434817 in chips)
Seat 7: hichnick777 (262689 in chips)
Seat 8: Dredjke (205170 in chips)
Seat 9: guirib8ir0 (630366 in chips)
wesol05: posts the ante 1600
Dat'sGOOD: posts the ante 1600
romk@vip: posts the ante 1600
themasteryan: posts the ante 1600
welcat: posts the ante 1600
marval231: posts the ante 1600
hichnick777: posts the ante 1600
Dredjke: posts the ante 1600
guirib8ir0: posts the ante 1600
hichnick777: posts small blind 8000
Dredjke: posts big blind 16000
*** HOLE CARDS ***
Dealt to hichnick777 [3c 7h]
guirib8ir0: folds
wesol05: folds
Dat'sGOOD: folds
romk@vip: raises 159279 to 175279 and is all-in
themasteryan: folds
welcat: folds
marval231: calls 175279
hichnick777: folds
Dredjke: folds
*** FLOP *** [Jh 6s 8s]
*** TURN *** [Jh 6s 8s] [Ts]
*** RIVER *** [Jh 6s 8s Ts] [9c]
*** SHOW DOWN ***
romk@vip: shows [9s Js] (a flush, Jack high)
marval231: shows [Qh Qc] (a straight, Eight to Queen)
romk@vip collected 388958 from pot
*** SUMMARY ***
Total pot 388958 | Rake 0
Board [Jh 6s 8s Ts 9c]
Seat 1: wesol05 folded before Flop (didn't bet)
Seat 2: Dat'sGOOD folded before Flop (didn't bet)
Seat 3: romk@vip showed [9s Js] and won (388958) with a flush, Jack high
Seat 4: themasteryan folded before Flop (didn't bet)
Seat 5: welcat folded before Flop (didn't bet)
Seat 6: marval231 (button) showed [Qh Qc] and lost with a straight, Eight to Queen
Seat 7: hichnick777 (small blind) folded before Flop
Seat 8: Dredjke (big blind) folded before Flop
Seat 9: guirib8ir0 folded before Flop (didn't bet)


*********** # 262 **************
PokerStars Hand #176678331772: Tournament #2054568934, $20+$2 USD Hold'em No Limit - Level XXX (8000/16000) - 2017/10/09 4:37:05 MSK [2017/10/08 21:37:05 ET]
Table '2054568934 506' 9-max Seat #7 is the button
Seat 1: wesol05 (616913 in chips)
Seat 2: Dat'sGOOD (1049650 in chips)
Seat 3: romk@vip (388958 in chips)
Seat 4: themasteryan (656240 in chips)
Seat 5: welcat (100256 in chips)
Seat 6: marval231 (257938 in chips)
Seat 7: hichnick777 (253089 in chips)
Seat 8: Dredjke (187570 in chips)
Seat 9: guirib8ir0 (628766 in chips)
wesol05: posts the ante 1600
Dat'sGOOD: posts the ante 1600
romk@vip: posts the ante 1600
themasteryan: posts the ante 1600
welcat: posts the ante 1600
marval231: posts the ante 1600
hichnick777: posts the ante 1600
Dredjke: posts the ante 1600
guirib8ir0: posts the ante 1600
Dredjke: posts small blind 8000
guirib8ir0: posts big blind 16000
*** HOLE CARDS ***
Dealt to hichnick777 [5d 9d]
wesol05: folds
Dat'sGOOD: raises 16000 to 32000
romk@vip: folds
themasteryan: folds
welcat: folds
marval231: folds
hichnick777: folds
Dredjke: folds
guirib8ir0: calls 16000
*** FLOP *** [2d 8c Js]
guirib8ir0: checks
Dat'sGOOD: bets 32000
guirib8ir0: calls 32000
*** TURN *** [2d 8c Js] [6d]
guirib8ir0: checks
Dat'sGOOD: bets 80000
guirib8ir0: calls 80000
*** RIVER *** [2d 8c Js 6d] [Kh]
guirib8ir0: checks
Dat'sGOOD: bets 176000
guirib8ir0: calls 176000
*** SHOW DOWN ***
Dat'sGOOD: shows [Ac As] (a pair of Aces)
guirib8ir0: mucks hand
Dat'sGOOD collected 662400 from pot
*** SUMMARY ***
Total pot 662400 | Rake 0
Board [2d 8c Js 6d Kh]
Seat 1: wesol05 folded before Flop (didn't bet)
Seat 2: Dat'sGOOD showed [Ac As] and won (662400) with a pair of Aces
Seat 3: romk@vip folded before Flop (didn't bet)
Seat 4: themasteryan folded before Flop (didn't bet)
Seat 5: welcat folded before Flop (didn't bet)
Seat 6: marval231 folded before Flop (didn't bet)
Seat 7: hichnick777 (button) folded before Flop (didn't bet)
Seat 8: Dredjke (small blind) folded before Flop
Seat 9: guirib8ir0 (big blind) mucked [8d Th]


*********** # 263 **************
PokerStars Hand #176678365671: Tournament #2054568934, $20+$2 USD Hold'em No Limit - Level XXX (8000/16000) - 2017/10/09 4:38:37 MSK [2017/10/08 21:38:37 ET]
Table '2054568934 506' 9-max Seat #8 is the button
Seat 1: wesol05 (615313 in chips)
Seat 2: Dat'sGOOD (1390450 in chips)
Seat 3: romk@vip (387358 in chips)
Seat 4: themasteryan (654640 in chips)
Seat 5: welcat (98656 in chips)
Seat 6: marval231 (256338 in chips)
Seat 7: hichnick777 (251489 in chips)
Seat 8: Dredjke (177970 in chips)
Seat 9: guirib8ir0 (307166 in chips)
wesol05: posts the ante 1600
Dat'sGOOD: posts the ante 1600
romk@vip: posts the ante 1600
themasteryan: posts the ante 1600
welcat: posts the ante 1600
marval231: posts the ante 1600
hichnick777: posts the ante 1600
Dredjke: posts the ante 1600
guirib8ir0: posts the ante 1600
guirib8ir0: posts small blind 8000
wesol05: posts big blind 16000
*** HOLE CARDS ***
Dealt to hichnick777 [7d Kc]
Dat'sGOOD: folds
romk@vip: folds
themasteryan: raises 19585 to 35585
welcat: folds
marval231: folds
hichnick777: folds
Dredjke: folds
guirib8ir0: folds
wesol05: folds
Uncalled bet (19585) returned to themasteryan
themasteryan collected 54400 from pot
themasteryan: doesn't show hand
*** SUMMARY ***
Total pot 54400 | Rake 0
Seat 1: wesol05 (big blind) folded before Flop
Seat 2: Dat'sGOOD folded before Flop (didn't bet)
Seat 3: romk@vip folded before Flop (didn't bet)
Seat 4: themasteryan collected (54400)
Seat 5: welcat folded before Flop (didn't bet)
Seat 6: marval231 folded before Flop (didn't bet)
Seat 7: hichnick777 folded before Flop (didn't bet)
Seat 8: Dredjke (button) folded before Flop (didn't bet)
Seat 9: guirib8ir0 (small blind) folded before Flop


*********** # 264 **************
PokerStars Hand #176678387010: Tournament #2054568934, $20+$2 USD Hold'em No Limit - Level XXX (8000/16000) - 2017/10/09 4:39:36 MSK [2017/10/08 21:39:36 ET]
Table '2054568934 506' 9-max Seat #9 is the button
Seat 1: wesol05 (597713 in chips)
Seat 2: Dat'sGOOD (1388850 in chips)
Seat 3: romk@vip (385758 in chips)
Seat 4: themasteryan (691440 in chips)
Seat 5: welcat (97056 in chips)
Seat 6: marval231 (254738 in chips)
Seat 7: hichnick777 (249889 in chips)
Seat 8: Dredjke (176370 in chips)
Seat 9: guirib8ir0 (297566 in chips)
wesol05: posts the ante 1600
Dat'sGOOD: posts the ante 1600
romk@vip: posts the ante 1600
themasteryan: posts the ante 1600
welcat: posts the ante 1600
marval231: posts the ante 1600
hichnick777: posts the ante 1600
Dredjke: posts the ante 1600
guirib8ir0: posts the ante 1600
wesol05: posts small blind 8000
Dat'sGOOD: posts big blind 16000
*** HOLE CARDS ***
Dealt to hichnick777 [8c Jh]
romk@vip: folds
themasteryan: folds
welcat: folds
marval231: raises 19200 to 35200
hichnick777: folds
Dredjke: folds
guirib8ir0: folds
wesol05: folds
Dat'sGOOD: folds
Uncalled bet (19200) returned to marval231
marval231 collected 54400 from pot
marval231: doesn't show hand
*** SUMMARY ***
Total pot 54400 | Rake 0
Seat 1: wesol05 (small blind) folded before Flop
Seat 2: Dat'sGOOD (big blind) folded before Flop
Seat 3: romk@vip folded before Flop (didn't bet)
Seat 4: themasteryan folded before Flop (didn't bet)
Seat 5: welcat folded before Flop (didn't bet)
Seat 6: marval231 collected (54400)
Seat 7: hichnick777 folded before Flop (didn't bet)
Seat 8: Dredjke folded before Flop (didn't bet)
Seat 9: guirib8ir0 (button) folded before Flop (didn't bet)


*********** # 265 **************
PokerStars Hand #176678400906: Tournament #2054568934, $20+$2 USD Hold'em No Limit - Level XXX (8000/16000) - 2017/10/09 4:40:15 MSK [2017/10/08 21:40:15 ET]
Table '2054568934 506' 9-max Seat #1 is the button
Seat 1: wesol05 (588113 in chips)
Seat 2: Dat'sGOOD (1371250 in chips)
Seat 3: romk@vip (384158 in chips)
Seat 4: themasteryan (689840 in chips)
Seat 5: welcat (95456 in chips)
Seat 6: marval231 (291538 in chips)
Seat 7: hichnick777 (248289 in chips)
Seat 8: Dredjke (174770 in chips)
Seat 9: guirib8ir0 (295966 in chips)
wesol05: posts the ante 1600
Dat'sGOOD: posts the ante 1600
romk@vip: posts the ante 1600
themasteryan: posts the ante 1600
welcat: posts the ante 1600
marval231: posts the ante 1600
hichnick777: posts the ante 1600
Dredjke: posts the ante 1600
guirib8ir0: posts the ante 1600
Dat'sGOOD: posts small blind 8000
romk@vip: posts big blind 16000
*** HOLE CARDS ***
Dealt to hichnick777 [8d Qc]
themasteryan: folds
welcat: folds
marval231: folds
hichnick777: folds
Dredjke: folds
guirib8ir0: raises 16000 to 32000
wesol05: folds
Dat'sGOOD: folds
romk@vip: raises 350558 to 382558 and is all-in
guirib8ir0: calls 262366 and is all-in
Uncalled bet (88192) returned to romk@vip
*** FLOP *** [9h 3s 9c]
*** TURN *** [9h 3s 9c] [Js]
*** RIVER *** [9h 3s 9c Js] [5s]
*** SHOW DOWN ***
romk@vip: shows [Jh Ks] (two pair, Jacks and Nines)
guirib8ir0: shows [8c Ah] (a pair of Nines)
romk@vip collected 611132 from pot
guirib8ir0 finished the tournament in 166th place and received $91.49.
*** SUMMARY ***
Total pot 611132 | Rake 0
Board [9h 3s 9c Js 5s]
Seat 1: wesol05 (button) folded before Flop (didn't bet)
Seat 2: Dat'sGOOD (small blind) folded before Flop
Seat 3: romk@vip (big blind) showed [Jh Ks] and won (611132) with two pair, Jacks and Nines
Seat 4: themasteryan folded before Flop (didn't bet)
Seat 5: welcat folded before Flop (didn't bet)
Seat 6: marval231 folded before Flop (didn't bet)
Seat 7: hichnick777 folded before Flop (didn't bet)
Seat 8: Dredjke folded before Flop (didn't bet)
Seat 9: guirib8ir0 showed [8c Ah] and lost with a pair of Nines


*********** # 266 **************
PokerStars Hand #176678429608: Tournament #2054568934, $20+$2 USD Hold'em No Limit - Level XXX (8000/16000) - 2017/10/09 4:41:33 MSK [2017/10/08 21:41:33 ET]
Table '2054568934 506' 9-max Seat #2 is the button
Seat 1: wesol05 (586513 in chips)
Seat 2: Dat'sGOOD (1361650 in chips)
Seat 3: romk@vip (699324 in chips)
Seat 4: themasteryan (688240 in chips)
Seat 5: welcat (93856 in chips)
Seat 6: marval231 (289938 in chips)
Seat 7: hichnick777 (246689 in chips)
Seat 8: Dredjke (173170 in chips)
wesol05: posts the ante 1600
Dat'sGOOD: posts the ante 1600
romk@vip: posts the ante 1600
themasteryan: posts the ante 1600
welcat: posts the ante 1600
marval231: posts the ante 1600
hichnick777: posts the ante 1600
Dredjke: posts the ante 1600
romk@vip: posts small blind 8000
themasteryan: posts big blind 16000
*** HOLE CARDS ***
Dealt to hichnick777 [2s Qd]
welcat: folds
marval231: folds
hichnick777: folds
Dredjke: folds
wesol05: folds
Dat'sGOOD: raises 17000 to 33000
romk@vip: calls 25000
themasteryan: calls 17000
*** FLOP *** [9c 6c Qc]
romk@vip: checks
themasteryan: checks
Dat'sGOOD: checks
*** TURN *** [9c 6c Qc] [Td]
romk@vip: bets 42484
themasteryan: calls 42484
Dat'sGOOD: folds
*** RIVER *** [9c 6c Qc Td] [Jd]
romk@vip: checks
themasteryan: bets 104685
romk@vip: calls 104685
*** SHOW DOWN ***
themasteryan: shows [9s Kc] (a straight, Nine to King)
romk@vip: shows [Kd Qh] (a straight, Nine to King)
romk@vip collected 203069 from pot
themasteryan collected 203069 from pot
*** SUMMARY ***
Total pot 406138 | Rake 0
Board [9c 6c Qc Td Jd]
Seat 1: wesol05 folded before Flop (didn't bet)
Seat 2: Dat'sGOOD (button) folded on the Turn
Seat 3: romk@vip (small blind) showed [Kd Qh] and won (203069) with a straight, Nine to King
Seat 4: themasteryan (big blind) showed [9s Kc] and won (203069) with a straight, Nine to King
Seat 5: welcat folded before Flop (didn't bet)
Seat 6: marval231 folded before Flop (didn't bet)
Seat 7: hichnick777 folded before Flop (didn't bet)
Seat 8: Dredjke folded before Flop (didn't bet)


*********** # 267 **************
PokerStars Hand #176678456242: Tournament #2054568934, $20+$2 USD Hold'em No Limit - Level XXX (8000/16000) - 2017/10/09 4:42:48 MSK [2017/10/08 21:42:48 ET]
Table '2054568934 506' 9-max Seat #3 is the button
Seat 1: wesol05 (584913 in chips)
Seat 2: Dat'sGOOD (1327050 in chips)
Seat 3: romk@vip (720624 in chips)
Seat 4: themasteryan (709540 in chips)
Seat 5: welcat (92256 in chips)
Seat 6: marval231 (288338 in chips)
Seat 7: hichnick777 (245089 in chips)
Seat 8: Dredjke (171570 in chips)
wesol05: posts the ante 1600
Dat'sGOOD: posts the ante 1600
romk@vip: posts the ante 1600
themasteryan: posts the ante 1600
welcat: posts the ante 1600
marval231: posts the ante 1600
hichnick777: posts the ante 1600
Dredjke: posts the ante 1600
themasteryan: posts small blind 8000
welcat: posts big blind 16000
*** HOLE CARDS ***
Dealt to hichnick777 [5c 8d]
marval231: folds
hichnick777: folds
themasteryan said, "nh"
Dredjke: folds
wesol05: folds
Dat'sGOOD: raises 16000 to 32000
romk@vip: folds
themasteryan: folds
welcat: folds
Uncalled bet (16000) returned to Dat'sGOOD
Dat'sGOOD collected 52800 from pot
*** SUMMARY ***
Total pot 52800 | Rake 0
Seat 1: wesol05 folded before Flop (didn't bet)
Seat 2: Dat'sGOOD collected (52800)
Seat 3: romk@vip (button) folded before Flop (didn't bet)
Seat 4: themasteryan (small blind) folded before Flop
Seat 5: welcat (big blind) folded before Flop
Seat 6: marval231 folded before Flop (didn't bet)
Seat 7: hichnick777 folded before Flop (didn't bet)
Seat 8: Dredjke folded before Flop (didn't bet)


*********** # 268 **************
PokerStars Hand #176678470855: Tournament #2054568934, $20+$2 USD Hold'em No Limit - Level XXXI (10000/20000) - 2017/10/09 4:43:29 MSK [2017/10/08 21:43:29 ET]
Table '2054568934 506' 9-max Seat #4 is the button
Seat 1: wesol05 (583313 in chips)
Seat 2: Dat'sGOOD (1362250 in chips)
Seat 3: romk@vip (719024 in chips)
Seat 4: themasteryan (699940 in chips)
Seat 5: welcat (74656 in chips)
Seat 6: marval231 (286738 in chips)
Seat 7: hichnick777 (243489 in chips)
Seat 8: Dredjke (169970 in chips)
Seat 9: WizardOffAz (996088 in chips)
wesol05: posts the ante 2000
Dat'sGOOD: posts the ante 2000
romk@vip: posts the ante 2000
themasteryan: posts the ante 2000
welcat: posts the ante 2000
marval231: posts the ante 2000
hichnick777: posts the ante 2000
Dredjke: posts the ante 2000
WizardOffAz: posts the ante 2000
welcat: posts small blind 10000
marval231: posts big blind 20000
*** HOLE CARDS ***
Dealt to hichnick777 [6c 5s]
hichnick777: folds
Dredjke: raises 147970 to 167970 and is all-in
WizardOffAz: folds
wesol05: folds
Dat'sGOOD: folds
romk@vip: folds
themasteryan: folds
welcat: folds
marval231: folds
Uncalled bet (147970) returned to Dredjke
Dredjke collected 68000 from pot
Dredjke: doesn't show hand
*** SUMMARY ***
Total pot 68000 | Rake 0
Seat 1: wesol05 folded before Flop (didn't bet)
Seat 2: Dat'sGOOD folded before Flop (didn't bet)
Seat 3: romk@vip folded before Flop (didn't bet)
Seat 4: themasteryan (button) folded before Flop (didn't bet)
Seat 5: welcat (small blind) folded before Flop
Seat 6: marval231 (big blind) folded before Flop
Seat 7: hichnick777 folded before Flop (didn't bet)
Seat 8: Dredjke collected (68000)
Seat 9: WizardOffAz folded before Flop (didn't bet)


*********** # 269 **************
PokerStars Hand #176678487057: Tournament #2054568934, $20+$2 USD Hold'em No Limit - Level XXXI (10000/20000) - 2017/10/09 4:44:14 MSK [2017/10/08 21:44:14 ET]
Table '2054568934 506' 9-max Seat #5 is the button
Seat 1: wesol05 (581313 in chips)
Seat 2: Dat'sGOOD (1360250 in chips)
Seat 3: romk@vip (717024 in chips)
Seat 4: themasteryan (697940 in chips)
Seat 5: welcat (62656 in chips)
Seat 6: marval231 (264738 in chips)
Seat 7: hichnick777 (241489 in chips)
Seat 8: Dredjke (215970 in chips)
Seat 9: WizardOffAz (994088 in chips)
wesol05: posts the ante 2000
Dat'sGOOD: posts the ante 2000
romk@vip: posts the ante 2000
themasteryan: posts the ante 2000
welcat: posts the ante 2000
marval231: posts the ante 2000
hichnick777: posts the ante 2000
Dredjke: posts the ante 2000
WizardOffAz: posts the ante 2000
marval231: posts small blind 10000
hichnick777: posts big blind 20000
*** HOLE CARDS ***
Dealt to hichnick777 [9h Qh]
Dredjke: folds
WizardOffAz: folds
wesol05: folds
Dat'sGOOD: folds
romk@vip: raises 20000 to 40000
themasteryan: folds
welcat: folds
marval231: folds
hichnick777: calls 20000
*** FLOP *** [8d Kc 7d]
hichnick777: checks
romk@vip: bets 41040
hichnick777: folds
Uncalled bet (41040) returned to romk@vip
romk@vip collected 108000 from pot
*** SUMMARY ***
Total pot 108000 | Rake 0
Board [8d Kc 7d]
Seat 1: wesol05 folded before Flop (didn't bet)
Seat 2: Dat'sGOOD folded before Flop (didn't bet)
Seat 3: romk@vip collected (108000)
Seat 4: themasteryan folded before Flop (didn't bet)
Seat 5: welcat (button) folded before Flop (didn't bet)
Seat 6: marval231 (small blind) folded before Flop
Seat 7: hichnick777 (big blind) folded on the Flop
Seat 8: Dredjke folded before Flop (didn't bet)
Seat 9: WizardOffAz folded before Flop (didn't bet)


*********** # 270 **************
PokerStars Hand #176678512472: Tournament #2054568934, $20+$2 USD Hold'em No Limit - Level XXXI (10000/20000) - 2017/10/09 4:45:14 MSK [2017/10/08 21:45:14 ET]
Table '2054568934 506' 9-max Seat #6 is the button
Seat 1: wesol05 (579313 in chips)
Seat 2: Dat'sGOOD (1358250 in chips)
Seat 3: romk@vip (783024 in chips)
Seat 4: themasteryan (695940 in chips)
Seat 5: welcat (60656 in chips)
Seat 6: marval231 (252738 in chips)
Seat 7: hichnick777 (199489 in chips)
Seat 8: Dredjke (213970 in chips)
Seat 9: WizardOffAz (992088 in chips)
wesol05: posts the ante 2000
Dat'sGOOD: posts the ante 2000
romk@vip: posts the ante 2000
themasteryan: posts the ante 2000
welcat: posts the ante 2000
marval231: posts the ante 2000
hichnick777: posts the ante 2000
Dredjke: posts the ante 2000
WizardOffAz: posts the ante 2000
hichnick777: posts small blind 10000
Dredjke: posts big blind 20000
*** HOLE CARDS ***
Dealt to hichnick777 [Qs 2h]
WizardOffAz: folds
wesol05: folds
Dat'sGOOD: folds
romk@vip: raises 20000 to 40000
themasteryan: folds
welcat: raises 18656 to 58656 and is all-in
marval231: folds
hichnick777: folds
Dredjke: folds
romk@vip: calls 18656
*** FLOP *** [Kc Ac 4s]
*** TURN *** [Kc Ac 4s] [Qh]
*** RIVER *** [Kc Ac 4s Qh] [Jh]
*** SHOW DOWN ***
romk@vip: shows [Ah 6h] (a pair of Aces)
welcat: shows [4c 4d] (three of a kind, Fours)
welcat collected 165312 from pot
*** SUMMARY ***
Total pot 165312 | Rake 0
Board [Kc Ac 4s Qh Jh]
Seat 1: wesol05 folded before Flop (didn't bet)
Seat 2: Dat'sGOOD folded before Flop (didn't bet)
Seat 3: romk@vip showed [Ah 6h] and lost with a pair of Aces
Seat 4: themasteryan folded before Flop (didn't bet)
Seat 5: welcat showed [4c 4d] and won (165312) with three of a kind, Fours
Seat 6: marval231 (button) folded before Flop (didn't bet)
Seat 7: hichnick777 (small blind) folded before Flop
Seat 8: Dredjke (big blind) folded before Flop
Seat 9: WizardOffAz folded before Flop (didn't bet)


*********** # 271 **************
PokerStars Hand #176678532349: Tournament #2054568934, $20+$2 USD Hold'em No Limit - Level XXXI (10000/20000) - 2017/10/09 4:46:10 MSK [2017/10/08 21:46:10 ET]
Table '2054568934 506' 9-max Seat #7 is the button
Seat 1: wesol05 (577313 in chips)
Seat 2: Dat'sGOOD (1356250 in chips)
Seat 3: romk@vip (722368 in chips)
Seat 4: themasteryan (693940 in chips)
Seat 5: welcat (165312 in chips)
Seat 6: marval231 (250738 in chips)
Seat 7: hichnick777 (187489 in chips)
Seat 8: Dredjke (191970 in chips)
Seat 9: WizardOffAz (990088 in chips)
wesol05: posts the ante 2000
Dat'sGOOD: posts the ante 2000
romk@vip: posts the ante 2000
themasteryan: posts the ante 2000
welcat: posts the ante 2000
marval231: posts the ante 2000
hichnick777: posts the ante 2000
Dredjke: posts the ante 2000
WizardOffAz: posts the ante 2000
Dredjke: posts small blind 10000
WizardOffAz: posts big blind 20000
*** HOLE CARDS ***
Dealt to hichnick777 [Kc 5h]
wesol05: folds
Dat'sGOOD: folds
romk@vip: folds
themasteryan: folds
welcat: raises 143312 to 163312 and is all-in
marval231: folds
hichnick777: folds
Dredjke: folds
WizardOffAz: calls 143312
*** FLOP *** [Ks 2h 2s]
*** TURN *** [Ks 2h 2s] [5d]
*** RIVER *** [Ks 2h 2s 5d] [8h]
*** SHOW DOWN ***
WizardOffAz: shows [As 7c] (a pair of Deuces)
welcat: shows [3s 3d] (two pair, Threes and Deuces)
welcat collected 354624 from pot
*** SUMMARY ***
Total pot 354624 | Rake 0
Board [Ks 2h 2s 5d 8h]
Seat 1: wesol05 folded before Flop (didn't bet)
Seat 2: Dat'sGOOD folded before Flop (didn't bet)
Seat 3: romk@vip folded before Flop (didn't bet)
Seat 4: themasteryan folded before Flop (didn't bet)
Seat 5: welcat showed [3s 3d] and won (354624) with two pair, Threes and Deuces
Seat 6: marval231 folded before Flop (didn't bet)
Seat 7: hichnick777 (button) folded before Flop (didn't bet)
Seat 8: Dredjke (small blind) folded before Flop
Seat 9: WizardOffAz (big blind) showed [As 7c] and lost with a pair of Deuces


*********** # 272 **************
PokerStars Hand #176678553081: Tournament #2054568934, $20+$2 USD Hold'em No Limit - Level XXXI (10000/20000) - 2017/10/09 4:47:08 MSK [2017/10/08 21:47:08 ET]
Table '2054568934 506' 9-max Seat #8 is the button
Seat 1: wesol05 (575313 in chips)
Seat 2: Dat'sGOOD (1354250 in chips)
Seat 3: romk@vip (720368 in chips)
Seat 4: themasteryan (691940 in chips)
Seat 5: welcat (354624 in chips)
Seat 6: marval231 (248738 in chips)
Seat 7: hichnick777 (185489 in chips)
Seat 8: Dredjke (179970 in chips)
Seat 9: WizardOffAz (824776 in chips)
wesol05: posts the ante 2000
Dat'sGOOD: posts the ante 2000
romk@vip: posts the ante 2000
themasteryan: posts the ante 2000
welcat: posts the ante 2000
marval231: posts the ante 2000
hichnick777: posts the ante 2000
Dredjke: posts the ante 2000
WizardOffAz: posts the ante 2000
WizardOffAz: posts small blind 10000
wesol05: posts big blind 20000
*** HOLE CARDS ***
Dealt to hichnick777 [3h Th]
Dat'sGOOD: folds
romk@vip: folds
themasteryan: folds
welcat: folds
marval231: folds
hichnick777: folds
Dredjke: folds
WizardOffAz: calls 10000
wesol05: checks
*** FLOP *** [3d 8d 9h]
WizardOffAz: bets 28980
wesol05: calls 28980
*** TURN *** [3d 8d 9h] [Qs]
WizardOffAz: bets 73500
wesol05: calls 73500
*** RIVER *** [3d 8d 9h Qs] [Ah]
WizardOffAz: bets 204540
wesol05: calls 204540
*** SHOW DOWN ***
WizardOffAz: shows [7d Jc] (high card Ace)
wesol05: shows [Qh 8c] (two pair, Queens and Eights)
wesol05 collected 672040 from pot
*** SUMMARY ***
Total pot 672040 | Rake 0
Board [3d 8d 9h Qs Ah]
Seat 1: wesol05 (big blind) showed [Qh 8c] and won (672040) with two pair, Queens and Eights
Seat 2: Dat'sGOOD folded before Flop (didn't bet)
Seat 3: romk@vip folded before Flop (didn't bet)
Seat 4: themasteryan folded before Flop (didn't bet)
Seat 5: welcat folded before Flop (didn't bet)
Seat 6: marval231 folded before Flop (didn't bet)
Seat 7: hichnick777 folded before Flop (didn't bet)
Seat 8: Dredjke (button) folded before Flop (didn't bet)
Seat 9: WizardOffAz (small blind) showed [7d Jc] and lost with high card Ace


*********** # 273 **************
PokerStars Hand #176678591178: Tournament #2054568934, $20+$2 USD Hold'em No Limit - Level XXXI (10000/20000) - 2017/10/09 4:48:56 MSK [2017/10/08 21:48:56 ET]
Table '2054568934 506' 9-max Seat #9 is the button
Seat 1: wesol05 (918333 in chips)
Seat 2: Dat'sGOOD (1352250 in chips)
Seat 3: romk@vip (718368 in chips)
Seat 4: themasteryan (689940 in chips)
Seat 5: welcat (352624 in chips)
Seat 6: marval231 (246738 in chips)
Seat 7: hichnick777 (183489 in chips)
Seat 8: Dredjke (177970 in chips)
Seat 9: WizardOffAz (495756 in chips)
wesol05: posts the ante 2000
Dat'sGOOD: posts the ante 2000
romk@vip: posts the ante 2000
themasteryan: posts the ante 2000
welcat: posts the ante 2000
marval231: posts the ante 2000
hichnick777: posts the ante 2000
Dredjke: posts the ante 2000
WizardOffAz: posts the ante 2000
wesol05: posts small blind 10000
Dat'sGOOD: posts big blind 20000
*** HOLE CARDS ***
Dealt to hichnick777 [5c 4h]
romk@vip: folds
themasteryan: folds
welcat: folds
marval231: folds
hichnick777: folds
Dredjke: raises 155970 to 175970 and is all-in
WizardOffAz: folds
wesol05: raises 740363 to 916333 and is all-in
Dat'sGOOD: folds
Uncalled bet (740363) returned to wesol05
*** FLOP *** [6h 7c Tc]
*** TURN *** [6h 7c Tc] [Jh]
*** RIVER *** [6h 7c Tc Jh] [2c]
*** SHOW DOWN ***
wesol05: shows [As Ks] (high card Ace)
Dredjke: shows [Jd Kc] (a pair of Jacks)
Dredjke collected 389940 from pot
*** SUMMARY ***
Total pot 389940 | Rake 0
Board [6h 7c Tc Jh 2c]
Seat 1: wesol05 (small blind) showed [As Ks] and lost with high card Ace
Seat 2: Dat'sGOOD (big blind) folded before Flop
Seat 3: romk@vip folded before Flop (didn't bet)
Seat 4: themasteryan folded before Flop (didn't bet)
Seat 5: welcat folded before Flop (didn't bet)
Seat 6: marval231 folded before Flop (didn't bet)
Seat 7: hichnick777 folded before Flop (didn't bet)
Seat 8: Dredjke showed [Jd Kc] and won (389940) with a pair of Jacks
Seat 9: WizardOffAz (button) folded before Flop (didn't bet)


*********** # 274 **************
PokerStars Hand #176678603360: Tournament #2054568934, $20+$2 USD Hold'em No Limit - Level XXXI (10000/20000) - 2017/10/09 4:49:30 MSK [2017/10/08 21:49:30 ET]
Table '2054568934 506' 9-max Seat #1 is the button
Seat 1: wesol05 (740363 in chips)
Seat 2: Dat'sGOOD (1330250 in chips)
Seat 3: romk@vip (716368 in chips)
Seat 4: themasteryan (687940 in chips)
Seat 5: welcat (350624 in chips)
Seat 6: marval231 (244738 in chips)
Seat 7: hichnick777 (181489 in chips)
Seat 8: Dredjke (389940 in chips)
Seat 9: WizardOffAz (493756 in chips)
wesol05: posts the ante 2000
Dat'sGOOD: posts the ante 2000
romk@vip: posts the ante 2000
themasteryan: posts the ante 2000
welcat: posts the ante 2000
marval231: posts the ante 2000
hichnick777: posts the ante 2000
Dredjke: posts the ante 2000
WizardOffAz: posts the ante 2000
Dat'sGOOD: posts small blind 10000
romk@vip: posts big blind 20000
*** HOLE CARDS ***
Dealt to hichnick777 [Jc Ac]
themasteryan: folds
welcat: folds
marval231: folds
hichnick777: raises 159489 to 179489 and is all-in
Dredjke: folds
WizardOffAz: folds
wesol05: folds
Dat'sGOOD: folds
romk@vip: calls 159489
*** FLOP *** [Ks 2c Jh]
*** TURN *** [Ks 2c Jh] [6c]
*** RIVER *** [Ks 2c Jh 6c] [9c]
*** SHOW DOWN ***
romk@vip: shows [Qd Qc] (a pair of Queens)
hichnick777: shows [Jc Ac] (a flush, Ace high)
hichnick777 collected 386978 from pot
*** SUMMARY ***
Total pot 386978 | Rake 0
Board [Ks 2c Jh 6c 9c]
Seat 1: wesol05 (button) folded before Flop (didn't bet)
Seat 2: Dat'sGOOD (small blind) folded before Flop
Seat 3: romk@vip (big blind) showed [Qd Qc] and lost with a pair of Queens
Seat 4: themasteryan folded before Flop (didn't bet)
Seat 5: welcat folded before Flop (didn't bet)
Seat 6: marval231 folded before Flop (didn't bet)
Seat 7: hichnick777 showed [Jc Ac] and won (386978) with a flush, Ace high
Seat 8: Dredjke folded before Flop (didn't bet)
Seat 9: WizardOffAz folded before Flop (didn't bet)


*********** # 275 **************
PokerStars Hand #176678622183: Tournament #2054568934, $20+$2 USD Hold'em No Limit - Level XXXI (10000/20000) - 2017/10/09 4:50:24 MSK [2017/10/08 21:50:24 ET]
Table '2054568934 506' 9-max Seat #2 is the button
Seat 1: wesol05 (738363 in chips)
Seat 2: Dat'sGOOD (1318250 in chips)
Seat 3: romk@vip (534879 in chips)
Seat 4: themasteryan (685940 in chips)
Seat 5: welcat (348624 in chips)
Seat 6: marval231 (242738 in chips)
Seat 7: hichnick777 (386978 in chips)
Seat 8: Dredjke (387940 in chips)
Seat 9: WizardOffAz (491756 in chips)
wesol05: posts the ante 2000
Dat'sGOOD: posts the ante 2000
romk@vip: posts the ante 2000
themasteryan: posts the ante 2000
welcat: posts the ante 2000
marval231: posts the ante 2000
hichnick777: posts the ante 2000
Dredjke: posts the ante 2000
WizardOffAz: posts the ante 2000
romk@vip: posts small blind 10000
themasteryan: posts big blind 20000
*** HOLE CARDS ***
Dealt to hichnick777 [9d Js]
welcat: folds
marval231: folds
hichnick777: folds
Dredjke: folds
WizardOffAz: folds
wesol05: folds
Dat'sGOOD: folds
romk@vip: calls 10000
themasteryan: checks
*** FLOP *** [Tc Kc Th]
romk@vip: bets 22040
themasteryan: folds
Uncalled bet (22040) returned to romk@vip
romk@vip collected 58000 from pot
*** SUMMARY ***
Total pot 58000 | Rake 0
Board [Tc Kc Th]
Seat 1: wesol05 folded before Flop (didn't bet)
Seat 2: Dat'sGOOD (button) folded before Flop (didn't bet)
Seat 3: romk@vip (small blind) collected (58000)
Seat 4: themasteryan (big blind) folded on the Flop
Seat 5: welcat folded before Flop (didn't bet)
Seat 6: marval231 folded before Flop (didn't bet)
Seat 7: hichnick777 folded before Flop (didn't bet)
Seat 8: Dredjke folded before Flop (didn't bet)
Seat 9: WizardOffAz folded before Flop (didn't bet)


*********** # 276 **************
PokerStars Hand #176678638694: Tournament #2054568934, $20+$2 USD Hold'em No Limit - Level XXXI (10000/20000) - 2017/10/09 4:51:11 MSK [2017/10/08 21:51:11 ET]
Table '2054568934 506' 9-max Seat #3 is the button
Seat 1: wesol05 (736363 in chips)
Seat 2: Dat'sGOOD (1316250 in chips)
Seat 3: romk@vip (570879 in chips)
Seat 4: themasteryan (663940 in chips)
Seat 5: walmer555 (547545 in chips)
Seat 6: marval231 (240738 in chips)
Seat 7: hichnick777 (384978 in chips)
Seat 8: Dredjke (385940 in chips)
Seat 9: WizardOffAz (489756 in chips)
wesol05: posts the ante 2000
Dat'sGOOD: posts the ante 2000
romk@vip: posts the ante 2000
themasteryan: posts the ante 2000
walmer555: posts the ante 2000
marval231: posts the ante 2000
hichnick777: posts the ante 2000
Dredjke: posts the ante 2000
WizardOffAz: posts the ante 2000
themasteryan: posts small blind 10000
walmer555: posts big blind 20000
*** HOLE CARDS ***
Dealt to hichnick777 [6h 7d]
marval231: folds
hichnick777: folds
Dredjke: folds
WizardOffAz: folds
wesol05: folds
Dat'sGOOD: raises 21250 to 41250
romk@vip: raises 68750 to 110000
themasteryan: folds
walmer555: folds
Dat'sGOOD: calls 68750
*** FLOP *** [6c 5d Jc]
Dat'sGOOD: checks
romk@vip: checks
*** TURN *** [6c 5d Jc] [3d]
Dat'sGOOD: bets 100000
romk@vip: calls 100000
*** RIVER *** [6c 5d Jc 3d] [6d]
Dat'sGOOD: checks
romk@vip: checks
*** SHOW DOWN ***
Dat'sGOOD: shows [4s As] (a pair of Sixes)
romk@vip: shows [2h Ad] (a pair of Sixes)
Dat'sGOOD collected 234000 from pot
romk@vip collected 234000 from pot
*** SUMMARY ***
Total pot 468000 | Rake 0
Board [6c 5d Jc 3d 6d]
Seat 1: wesol05 folded before Flop (didn't bet)
Seat 2: Dat'sGOOD showed [4s As] and won (234000) with a pair of Sixes
Seat 3: romk@vip (button) showed [2h Ad] and won (234000) with a pair of Sixes
Seat 4: themasteryan (small blind) folded before Flop
Seat 5: walmer555 (big blind) folded before Flop
Seat 6: marval231 folded before Flop (didn't bet)
Seat 7: hichnick777 folded before Flop (didn't bet)
Seat 8: Dredjke folded before Flop (didn't bet)
Seat 9: WizardOffAz folded before Flop (didn't bet)


*********** # 277 **************
PokerStars Hand #176678672552: Tournament #2054568934, $20+$2 USD Hold'em No Limit - Level XXXI (10000/20000) - 2017/10/09 4:52:48 MSK [2017/10/08 21:52:48 ET]
Table '2054568934 506' 9-max Seat #4 is the button
Seat 1: wesol05 (734363 in chips)
Seat 2: Dat'sGOOD (1338250 in chips)
Seat 3: romk@vip (592879 in chips)
Seat 4: themasteryan (651940 in chips)
Seat 5: walmer555 (525545 in chips)
Seat 6: marval231 (238738 in chips)
Seat 7: hichnick777 (382978 in chips)
Seat 8: Dredjke (383940 in chips)
Seat 9: WizardOffAz (487756 in chips)
wesol05: posts the ante 2000
Dat'sGOOD: posts the ante 2000
romk@vip: posts the ante 2000
themasteryan: posts the ante 2000
walmer555: posts the ante 2000
marval231: posts the ante 2000
hichnick777: posts the ante 2000
Dredjke: posts the ante 2000
WizardOffAz: posts the ante 2000
walmer555: posts small blind 10000
marval231: posts big blind 20000
*** HOLE CARDS ***
Dealt to hichnick777 [7h Qd]
hichnick777: folds
Dat'sGOOD said, ":'("
Dredjke: folds
WizardOffAz: folds
wesol05: folds
Dat'sGOOD: raises 21250 to 41250
romk@vip: folds
themasteryan: folds
walmer555: folds
marval231: folds
Uncalled bet (21250) returned to Dat'sGOOD
Dat'sGOOD collected 68000 from pot
*** SUMMARY ***
Total pot 68000 | Rake 0
Seat 1: wesol05 folded before Flop (didn't bet)
Seat 2: Dat'sGOOD collected (68000)
Seat 3: romk@vip folded before Flop (didn't bet)
Seat 4: themasteryan (button) folded before Flop (didn't bet)
Seat 5: walmer555 (small blind) folded before Flop
Seat 6: marval231 (big blind) folded before Flop
Seat 7: hichnick777 folded before Flop (didn't bet)
Seat 8: Dredjke folded before Flop (didn't bet)
Seat 9: WizardOffAz folded before Flop (didn't bet)


*********** # 278 **************
PokerStars Hand #176678685143: Tournament #2054568934, $20+$2 USD Hold'em No Limit - Level XXXI (10000/20000) - 2017/10/09 4:53:24 MSK [2017/10/08 21:53:24 ET]
Table '2054568934 506' 9-max Seat #5 is the button
Seat 1: wesol05 (732363 in chips)
Seat 2: Dat'sGOOD (1384250 in chips)
Seat 3: romk@vip (590879 in chips)
Seat 4: themasteryan (649940 in chips)
Seat 5: walmer555 (513545 in chips)
Seat 6: marval231 (216738 in chips)
Seat 7: hichnick777 (380978 in chips)
Seat 8: Dredjke (381940 in chips)
Seat 9: WizardOffAz (485756 in chips)
wesol05: posts the ante 2000
Dat'sGOOD: posts the ante 2000
romk@vip: posts the ante 2000
themasteryan: posts the ante 2000
walmer555: posts the ante 2000
marval231: posts the ante 2000
hichnick777: posts the ante 2000
Dredjke: posts the ante 2000
WizardOffAz: posts the ante 2000
marval231: posts small blind 10000
hichnick777: posts big blind 20000
*** HOLE CARDS ***
Dealt to hichnick777 [3h Kc]
Dredjke: folds
WizardOffAz: folds
wesol05: folds
Dat'sGOOD: raises 22501 to 42501
romk@vip: folds
themasteryan: folds
walmer555: folds
marval231: folds
hichnick777: folds
Uncalled bet (22501) returned to Dat'sGOOD
Dat'sGOOD collected 68000 from pot
*** SUMMARY ***
Total pot 68000 | Rake 0
Seat 1: wesol05 folded before Flop (didn't bet)
Seat 2: Dat'sGOOD collected (68000)
Seat 3: romk@vip folded before Flop (didn't bet)
Seat 4: themasteryan folded before Flop (didn't bet)
Seat 5: walmer555 (button) folded before Flop (didn't bet)
Seat 6: marval231 (small blind) folded before Flop
Seat 7: hichnick777 (big blind) folded before Flop
Seat 8: Dredjke folded before Flop (didn't bet)
Seat 9: WizardOffAz folded before Flop (didn't bet)


*********** # 279 **************
PokerStars Hand #176678698387: Tournament #2054568934, $20+$2 USD Hold'em No Limit - Level XXXI (10000/20000) - 2017/10/09 4:54:02 MSK [2017/10/08 21:54:02 ET]
Table '2054568934 506' 9-max Seat #6 is the button
Seat 1: wesol05 (730363 in chips)
Seat 2: Dat'sGOOD (1430250 in chips)
Seat 3: romk@vip (588879 in chips)
Seat 4: themasteryan (647940 in chips)
Seat 5: walmer555 (511545 in chips)
Seat 6: marval231 (204738 in chips)
Seat 7: hichnick777 (358978 in chips)
Seat 8: Dredjke (379940 in chips)
Seat 9: WizardOffAz (483756 in chips)
wesol05: posts the ante 2000
Dat'sGOOD: posts the ante 2000
romk@vip: posts the ante 2000
themasteryan: posts the ante 2000
walmer555: posts the ante 2000
marval231: posts the ante 2000
hichnick777: posts the ante 2000
Dredjke: posts the ante 2000
WizardOffAz: posts the ante 2000
hichnick777: posts small blind 10000
Dredjke: posts big blind 20000
*** HOLE CARDS ***
Dealt to hichnick777 [Ks Td]
WizardOffAz: folds
wesol05: folds
Dat'sGOOD: folds
romk@vip: folds
themasteryan: folds
walmer555: folds
marval231: raises 182738 to 202738 and is all-in
hichnick777: folds
Dredjke: folds
Uncalled bet (182738) returned to marval231
marval231 collected 68000 from pot
marval231: doesn't show hand
*** SUMMARY ***
Total pot 68000 | Rake 0
Seat 1: wesol05 folded before Flop (didn't bet)
Seat 2: Dat'sGOOD folded before Flop (didn't bet)
Seat 3: romk@vip folded before Flop (didn't bet)
Seat 4: themasteryan folded before Flop (didn't bet)
Seat 5: walmer555 folded before Flop (didn't bet)
Seat 6: marval231 (button) collected (68000)
Seat 7: hichnick777 (small blind) folded before Flop
Seat 8: Dredjke (big blind) folded before Flop
Seat 9: WizardOffAz folded before Flop (didn't bet)


*********** # 280 **************
PokerStars Hand #176678710152: Tournament #2054568934, $20+$2 USD Hold'em No Limit - Level XXXI (10000/20000) - 2017/10/09 4:54:36 MSK [2017/10/08 21:54:36 ET]
Table '2054568934 506' 9-max Seat #7 is the button
Seat 1: wesol05 (728363 in chips)
Seat 2: Dat'sGOOD (1428250 in chips)
Seat 3: romk@vip (586879 in chips)
Seat 4: themasteryan (645940 in chips)
Seat 5: walmer555 (509545 in chips)
Seat 6: marval231 (250738 in chips)
Seat 7: hichnick777 (346978 in chips)
Seat 8: Dredjke (357940 in chips)
Seat 9: WizardOffAz (481756 in chips)
wesol05: posts the ante 2000
Dat'sGOOD: posts the ante 2000
romk@vip: posts the ante 2000
themasteryan: posts the ante 2000
walmer555: posts the ante 2000
marval231: posts the ante 2000
hichnick777: posts the ante 2000
Dredjke: posts the ante 2000
WizardOffAz: posts the ante 2000
Dredjke: posts small blind 10000
WizardOffAz: posts big blind 20000
*** HOLE CARDS ***
Dealt to hichnick777 [Jc 8c]
wesol05: folds
Dat'sGOOD: folds
romk@vip: folds
themasteryan: folds
walmer555: calls 20000
marval231: folds
hichnick777: raises 40000 to 60000
Dredjke: folds
WizardOffAz: folds
walmer555: calls 40000
*** FLOP *** [4c Ad 3h]
walmer555: checks
hichnick777: bets 55440
walmer555: calls 55440
*** TURN *** [4c Ad 3h] [3c]
walmer555: checks
hichnick777: bets 229538 and is all-in
walmer555: folds
Uncalled bet (229538) returned to hichnick777
hichnick777 collected 278880 from pot
hichnick777: doesn't show hand
*** SUMMARY ***
Total pot 278880 | Rake 0
Board [4c Ad 3h 3c]
Seat 1: wesol05 folded before Flop (didn't bet)
Seat 2: Dat'sGOOD folded before Flop (didn't bet)
Seat 3: romk@vip folded before Flop (didn't bet)
Seat 4: themasteryan folded before Flop (didn't bet)
Seat 5: walmer555 folded on the Turn
Seat 6: marval231 folded before Flop (didn't bet)
Seat 7: hichnick777 (button) collected (278880)
Seat 8: Dredjke (small blind) folded before Flop
Seat 9: WizardOffAz (big blind) folded before Flop


*********** # 281 **************
PokerStars Hand #176678835273: Tournament #2054568934, $20+$2 USD Hold'em No Limit - Level XXXII (12500/25000) - 2017/10/09 5:01:30 MSK [2017/10/08 22:01:30 ET]
Table '2054568934 506' 9-max Seat #8 is the button
Seat 1: wesol05 (726363 in chips)
Seat 2: Dat'sGOOD (1426250 in chips)
Seat 3: romk@vip (584879 in chips)
Seat 4: themasteryan (643940 in chips)
Seat 5: walmer555 (392105 in chips)
Seat 6: marval231 (248738 in chips)
Seat 7: hichnick777 (508418 in chips)
Seat 8: Dredjke (345940 in chips)
Seat 9: WizardOffAz (459756 in chips)
wesol05: posts the ante 2500
Dat'sGOOD: posts the ante 2500
romk@vip: posts the ante 2500
themasteryan: posts the ante 2500
walmer555: posts the ante 2500
marval231: posts the ante 2500
hichnick777: posts the ante 2500
Dredjke: posts the ante 2500
WizardOffAz: posts the ante 2500
WizardOffAz: posts small blind 12500
wesol05: posts big blind 25000
*** HOLE CARDS ***
Dealt to hichnick777 [Ks Kh]
Dat'sGOOD: folds
romk@vip: raises 25000 to 50000
themasteryan: folds
walmer555: folds
marval231: folds
hichnick777: raises 75000 to 125000
Dredjke: folds
WizardOffAz: folds
wesol05: folds
romk@vip: raises 457379 to 582379 and is all-in
hichnick777: calls 380918 and is all-in
Uncalled bet (76461) returned to romk@vip
*** FLOP *** [3s 5d Js]
*** TURN *** [3s 5d Js] [2s]
*** RIVER *** [3s 5d Js 2s] [7d]
*** SHOW DOWN ***
romk@vip: shows [Kc As] (high card Ace)
hichnick777: shows [Ks Kh] (a pair of Kings)
hichnick777 collected 1071836 from pot
*** SUMMARY ***
Total pot 1071836 | Rake 0
Board [3s 5d Js 2s 7d]
Seat 1: wesol05 (big blind) folded before Flop
Seat 2: Dat'sGOOD folded before Flop (didn't bet)
Seat 3: romk@vip showed [Kc As] and lost with high card Ace
Seat 4: themasteryan folded before Flop (didn't bet)
Seat 5: walmer555 folded before Flop (didn't bet)
Seat 6: marval231 folded before Flop (didn't bet)
Seat 7: hichnick777 showed [Ks Kh] and won (1071836) with a pair of Kings
Seat 8: Dredjke (button) folded before Flop (didn't bet)
Seat 9: WizardOffAz (small blind) folded before Flop


*********** # 282 **************
PokerStars Hand #176678876785: Tournament #2054568934, $20+$2 USD Hold'em No Limit - Level XXXII (12500/25000) - 2017/10/09 5:03:07 MSK [2017/10/08 22:03:07 ET]
Table '2054568934 506' 9-max Seat #9 is the button
Seat 1: wesol05 (698863 in chips)
Seat 2: Dat'sGOOD (1423750 in chips)
Seat 3: romk@vip (76461 in chips)
Seat 4: themasteryan (641440 in chips)
Seat 5: walmer555 (389605 in chips)
Seat 6: marval231 (246238 in chips)
Seat 7: hichnick777 (1071836 in chips)
Seat 8: Dredjke (343440 in chips)
Seat 9: WizardOffAz (444756 in chips)
wesol05: posts the ante 2500
Dat'sGOOD: posts the ante 2500
romk@vip: posts the ante 2500
themasteryan: posts the ante 2500
walmer555: posts the ante 2500
marval231: posts the ante 2500
hichnick777: posts the ante 2500
Dredjke: posts the ante 2500
WizardOffAz: posts the ante 2500
wesol05: posts small blind 12500
Dat'sGOOD: posts big blind 25000
*** HOLE CARDS ***
Dealt to hichnick777 [Js 4d]
romk@vip: raises 48961 to 73961 and is all-in
themasteryan: folds
walmer555: folds
marval231: raises 169777 to 243738 and is all-in
hichnick777: folds
Dredjke: folds
WizardOffAz: folds
wesol05: folds
Dat'sGOOD: folds
Uncalled bet (169777) returned to marval231
*** FLOP *** [Tc 2h 4c]
*** TURN *** [Tc 2h 4c] [5d]
*** RIVER *** [Tc 2h 4c 5d] [Ts]
*** SHOW DOWN ***
romk@vip: shows [Kd 8d] (a pair of Tens)
marval231: shows [Ah Qs] (a pair of Tens - Ace kicker)
marval231 collected 207922 from pot
romk@vip finished the tournament in 130th place and received $106.98.
*** SUMMARY ***
Total pot 207922 | Rake 0
Board [Tc 2h 4c 5d Ts]
Seat 1: wesol05 (small blind) folded before Flop
Seat 2: Dat'sGOOD (big blind) folded before Flop
Seat 3: romk@vip showed [Kd 8d] and lost with a pair of Tens
Seat 4: themasteryan folded before Flop (didn't bet)
Seat 5: walmer555 folded before Flop (didn't bet)
Seat 6: marval231 showed [Ah Qs] and won (207922) with a pair of Tens
Seat 7: hichnick777 folded before Flop (didn't bet)
Seat 8: Dredjke folded before Flop (didn't bet)
Seat 9: WizardOffAz (button) folded before Flop (didn't bet)


*********** # 283 **************
PokerStars Hand #176678890650: Tournament #2054568934, $20+$2 USD Hold'em No Limit - Level XXXII (12500/25000) - 2017/10/09 5:03:48 MSK [2017/10/08 22:03:48 ET]
Table '2054568934 506' 9-max Seat #1 is the button
Seat 1: wesol05 (683863 in chips)
Seat 2: Dat'sGOOD (1396250 in chips)
Seat 4: themasteryan (638940 in chips)
Seat 5: walmer555 (387105 in chips)
Seat 6: marval231 (377699 in chips)
Seat 7: hichnick777 (1069336 in chips)
Seat 8: Dredjke (340940 in chips)
Seat 9: WizardOffAz (442256 in chips)
wesol05: posts the ante 2500
Dat'sGOOD: posts the ante 2500
themasteryan: posts the ante 2500
walmer555: posts the ante 2500
marval231: posts the ante 2500
hichnick777: posts the ante 2500
Dredjke: posts the ante 2500
WizardOffAz: posts the ante 2500
Dat'sGOOD: posts small blind 12500
themasteryan: posts big blind 25000
*** HOLE CARDS ***
Dealt to hichnick777 [2c 2d]
walmer555: folds
marval231: folds
hichnick777: raises 31250 to 56250
Dredjke: folds
WizardOffAz: folds
wesol05: calls 56250
Dat'sGOOD: calls 43750
themasteryan: folds
*** FLOP *** [6d Ts 9h]
Dat'sGOOD: checks
hichnick777: checks
wesol05: bets 106875
Dat'sGOOD: calls 106875
hichnick777: folds
*** TURN *** [6d Ts 9h] [Ah]
Dat'sGOOD: checks
wesol05: checks
*** RIVER *** [6d Ts 9h Ah] [Ks]
Dat'sGOOD: bets 175000
wesol05: calls 175000
*** SHOW DOWN ***
Dat'sGOOD: shows [Th 9d] (two pair, Tens and Nines)
wesol05: mucks hand
Dat'sGOOD collected 777500 from pot
*** SUMMARY ***
Total pot 777500 | Rake 0
Board [6d Ts 9h Ah Ks]
Seat 1: wesol05 (button) mucked [Jc Tc]
Seat 2: Dat'sGOOD (small blind) showed [Th 9d] and won (777500) with two pair, Tens and Nines
Seat 4: themasteryan (big blind) folded before Flop
Seat 5: walmer555 folded before Flop (didn't bet)
Seat 6: marval231 folded before Flop (didn't bet)
Seat 7: hichnick777 folded on the Flop
Seat 8: Dredjke folded before Flop (didn't bet)
Seat 9: WizardOffAz folded before Flop (didn't bet)


*********** # 284 **************
PokerStars Hand #176678927185: Tournament #2054568934, $20+$2 USD Hold'em No Limit - Level XXXII (12500/25000) - 2017/10/09 5:05:34 MSK [2017/10/08 22:05:34 ET]
Table '2054568934 506' 9-max Seat #2 is the button
Seat 1: wesol05 (343238 in chips)
Seat 2: Dat'sGOOD (1833125 in chips)
Seat 3: Peirak (727096 in chips) out of hand (moved from another table into small blind)
Seat 4: themasteryan (611440 in chips)
Seat 5: walmer555 (384605 in chips)
Seat 6: marval231 (375199 in chips)
Seat 7: hichnick777 (1010586 in chips)
Seat 8: Dredjke (338440 in chips)
Seat 9: WizardOffAz (439756 in chips)
wesol05: posts the ante 2500
Dat'sGOOD: posts the ante 2500
themasteryan: posts the ante 2500
walmer555: posts the ante 2500
marval231: posts the ante 2500
hichnick777: posts the ante 2500
Dredjke: posts the ante 2500
WizardOffAz: posts the ante 2500
themasteryan: posts small blind 12500
walmer555: posts big blind 25000
*** HOLE CARDS ***
Dealt to hichnick777 [Kc 9c]
marval231: folds
hichnick777: folds
Dredjke: folds
WizardOffAz: calls 25000
wesol05: folds
Dat'sGOOD: folds
themasteryan: folds
walmer555: checks
*** FLOP *** [Qd Kd 6s]
walmer555: checks
WizardOffAz: checks
*** TURN *** [Qd Kd 6s] [Jh]
walmer555: checks
WizardOffAz: bets 34650
walmer555: folds
Uncalled bet (34650) returned to WizardOffAz
WizardOffAz collected 82500 from pot
WizardOffAz: doesn't show hand
*** SUMMARY ***
Total pot 82500 | Rake 0
Board [Qd Kd 6s Jh]
Seat 1: wesol05 folded before Flop (didn't bet)
Seat 2: Dat'sGOOD (button) folded before Flop (didn't bet)
Seat 4: themasteryan (small blind) folded before Flop
Seat 5: walmer555 (big blind) folded on the Turn
Seat 6: marval231 folded before Flop (didn't bet)
Seat 7: hichnick777 folded before Flop (didn't bet)
Seat 8: Dredjke folded before Flop (didn't bet)
Seat 9: WizardOffAz collected (82500)


*********** # 285 **************
PokerStars Hand #176678955995: Tournament #2054568934, $20+$2 USD Hold'em No Limit - Level XXXII (12500/25000) - 2017/10/09 5:07:00 MSK [2017/10/08 22:07:00 ET]
Table '2054568934 506' 9-max Seat #4 is the button
Seat 1: wesol05 (340738 in chips)
Seat 2: Dat'sGOOD (1830625 in chips)
Seat 3: Peirak (727096 in chips)
Seat 4: themasteryan (596440 in chips)
Seat 5: walmer555 (357105 in chips)
Seat 6: marval231 (372699 in chips)
Seat 7: hichnick777 (1008086 in chips)
Seat 8: Dredjke (335940 in chips)
Seat 9: WizardOffAz (494756 in chips)
wesol05: posts the ante 2500
Dat'sGOOD: posts the ante 2500
Peirak: posts the ante 2500
themasteryan: posts the ante 2500
walmer555: posts the ante 2500
marval231: posts the ante 2500
hichnick777: posts the ante 2500
Dredjke: posts the ante 2500
WizardOffAz: posts the ante 2500
walmer555: posts small blind 12500
marval231: posts big blind 25000
*** HOLE CARDS ***
Dealt to hichnick777 [3h 8d]
hichnick777: folds
Dredjke: raises 308440 to 333440 and is all-in
WizardOffAz: folds
wesol05: folds
Dat'sGOOD: calls 333440
Peirak: folds
themasteryan: folds
walmer555: folds
marval231: folds
*** FLOP *** [Jc Ts 6d]
*** TURN *** [Jc Ts 6d] [3c]
*** RIVER *** [Jc Ts 6d 3c] [Js]
*** SHOW DOWN ***
Dredjke: shows [7h 7d] (two pair, Jacks and Sevens)
Dat'sGOOD: shows [Kc Ah] (a pair of Jacks)
Dredjke collected 726880 from pot
*** SUMMARY ***
Total pot 726880 | Rake 0
Board [Jc Ts 6d 3c Js]
Seat 1: wesol05 folded before Flop (didn't bet)
Seat 2: Dat'sGOOD showed [Kc Ah] and lost with a pair of Jacks
Seat 3: Peirak folded before Flop (didn't bet)
Seat 4: themasteryan (button) folded before Flop (didn't bet)
Seat 5: walmer555 (small blind) folded before Flop
Seat 6: marval231 (big blind) folded before Flop
Seat 7: hichnick777 folded before Flop (didn't bet)
Seat 8: Dredjke showed [7h 7d] and won (726880) with two pair, Jacks and Sevens
Seat 9: WizardOffAz folded before Flop (didn't bet)


*********** # 286 **************
PokerStars Hand #176678971490: Tournament #2054568934, $20+$2 USD Hold'em No Limit - Level XXXII (12500/25000) - 2017/10/09 5:07:45 MSK [2017/10/08 22:07:45 ET]
Table '2054568934 506' 9-max Seat #5 is the button
Seat 1: wesol05 (338238 in chips)
Seat 2: Dat'sGOOD (1494685 in chips)
Seat 3: Peirak (724596 in chips)
Seat 4: themasteryan (593940 in chips)
Seat 5: walmer555 (342105 in chips)
Seat 6: marval231 (345199 in chips)
Seat 7: hichnick777 (1005586 in chips)
Seat 8: Dredjke (726880 in chips)
Seat 9: WizardOffAz (492256 in chips)
wesol05: posts the ante 2500
Dat'sGOOD: posts the ante 2500
Peirak: posts the ante 2500
themasteryan: posts the ante 2500
walmer555: posts the ante 2500
marval231: posts the ante 2500
hichnick777: posts the ante 2500
Dredjke: posts the ante 2500
WizardOffAz: posts the ante 2500
marval231: posts small blind 12500
hichnick777: posts big blind 25000
*** HOLE CARDS ***
Dealt to hichnick777 [5c 8c]
Dredjke: folds
WizardOffAz: raises 27500 to 52500
wesol05: folds
Dat'sGOOD: folds
Peirak: folds
themasteryan: folds
walmer555: folds
marval231: folds
hichnick777: calls 27500
*** FLOP *** [8s 2s 5h]
hichnick777: checks
WizardOffAz: checks
*** TURN *** [8s 2s 5h] [Qs]
hichnick777: bets 93333
WizardOffAz: folds
Uncalled bet (93333) returned to hichnick777
hichnick777 collected 140000 from pot
hichnick777: doesn't show hand
*** SUMMARY ***
Total pot 140000 | Rake 0
Board [8s 2s 5h Qs]
Seat 1: wesol05 folded before Flop (didn't bet)
Seat 2: Dat'sGOOD folded before Flop (didn't bet)
Seat 3: Peirak folded before Flop (didn't bet)
Seat 4: themasteryan folded before Flop (didn't bet)
Seat 5: walmer555 (button) folded before Flop (didn't bet)
Seat 6: marval231 (small blind) folded before Flop
Seat 7: hichnick777 (big blind) collected (140000)
Seat 8: Dredjke folded before Flop (didn't bet)
Seat 9: WizardOffAz folded on the Turn


*********** # 287 **************
PokerStars Hand #176679004286: Tournament #2054568934, $20+$2 USD Hold'em No Limit - Level XXXII (12500/25000) - 2017/10/09 5:09:23 MSK [2017/10/08 22:09:23 ET]
Table '2054568934 506' 9-max Seat #6 is the button
Seat 1: wesol05 (335738 in chips)
Seat 2: Dat'sGOOD (1492185 in chips)
Seat 3: Peirak (722096 in chips)
Seat 4: themasteryan (591440 in chips)
Seat 5: walmer555 (339605 in chips)
Seat 6: marval231 (330199 in chips)
Seat 7: hichnick777 (1090586 in chips)
Seat 8: Dredjke (724380 in chips)
Seat 9: WizardOffAz (437256 in chips)
wesol05: posts the ante 2500
Dat'sGOOD: posts the ante 2500
Peirak: posts the ante 2500
themasteryan: posts the ante 2500
walmer555: posts the ante 2500
marval231: posts the ante 2500
hichnick777: posts the ante 2500
Dredjke: posts the ante 2500
WizardOffAz: posts the ante 2500
hichnick777: posts small blind 12500
Dredjke: posts big blind 25000
*** HOLE CARDS ***
Dealt to hichnick777 [2h Ah]
WizardOffAz: folds
wesol05: folds
Dat'sGOOD: folds
Peirak: folds
themasteryan: folds
walmer555: folds
marval231: folds
hichnick777: raises 37500 to 62500
Dredjke: calls 37500
*** FLOP *** [8c 6d Jh]
hichnick777: bets 67850
Dredjke: folds
Uncalled bet (67850) returned to hichnick777
hichnick777 collected 147500 from pot
hichnick777: doesn't show hand
*** SUMMARY ***
Total pot 147500 | Rake 0
Board [8c 6d Jh]
Seat 1: wesol05 folded before Flop (didn't bet)
Seat 2: Dat'sGOOD folded before Flop (didn't bet)
Seat 3: Peirak folded before Flop (didn't bet)
Seat 4: themasteryan folded before Flop (didn't bet)
Seat 5: walmer555 folded before Flop (didn't bet)
Seat 6: marval231 (button) folded before Flop (didn't bet)
Seat 7: hichnick777 (small blind) collected (147500)
Seat 8: Dredjke (big blind) folded on the Flop
Seat 9: WizardOffAz folded before Flop (didn't bet)


*********** # 288 **************
PokerStars Hand #176679029739: Tournament #2054568934, $20+$2 USD Hold'em No Limit - Level XXXII (12500/25000) - 2017/10/09 5:10:40 MSK [2017/10/08 22:10:40 ET]
Table '2054568934 506' 9-max Seat #7 is the button
Seat 1: wesol05 (333238 in chips)
Seat 2: Dat'sGOOD (1489685 in chips)
Seat 3: Peirak (719596 in chips)
Seat 4: themasteryan (588940 in chips)
Seat 5: walmer555 (337105 in chips)
Seat 6: marval231 (327699 in chips)
Seat 7: hichnick777 (1173086 in chips)
Seat 8: Dredjke (659380 in chips)
Seat 9: WizardOffAz (434756 in chips)
wesol05: posts the ante 2500
Dat'sGOOD: posts the ante 2500
Peirak: posts the ante 2500
themasteryan: posts the ante 2500
walmer555: posts the ante 2500
marval231: posts the ante 2500
hichnick777: posts the ante 2500
Dredjke: posts the ante 2500
WizardOffAz: posts the ante 2500
Dredjke: posts small blind 12500
WizardOffAz: posts big blind 25000
*** HOLE CARDS ***
Dealt to hichnick777 [Qc Jh]
wesol05: folds
Dat'sGOOD: raises 30555 to 55555
Peirak: folds
themasteryan: folds
walmer555 has timed out
walmer555: folds
walmer555 is sitting out
marval231: folds
hichnick777: folds
Dredjke: folds
WizardOffAz: folds
Uncalled bet (30555) returned to Dat'sGOOD
walmer555 has returned
Dat'sGOOD collected 85000 from pot
*** SUMMARY ***
Total pot 85000 | Rake 0
Seat 1: wesol05 folded before Flop (didn't bet)
Seat 2: Dat'sGOOD collected (85000)
Seat 3: Peirak folded before Flop (didn't bet)
Seat 4: themasteryan folded before Flop (didn't bet)
Seat 5: walmer555 folded before Flop (didn't bet)
Seat 6: marval231 folded before Flop (didn't bet)
Seat 7: hichnick777 (button) folded before Flop (didn't bet)
Seat 8: Dredjke (small blind) folded before Flop
Seat 9: WizardOffAz (big blind) folded before Flop


*********** # 289 **************
PokerStars Hand #176679069783: Tournament #2054568934, $20+$2 USD Hold'em No Limit - Level XXXII (12500/25000) - 2017/10/09 5:12:41 MSK [2017/10/08 22:12:41 ET]
Table '2054568934 598' 9-max Seat #6 is the button
Seat 1: scabbyqueen (656653 in chips)
Seat 3: agustin_kv (66940 in chips)
Seat 4: 4time2warp0 (685306 in chips)
Seat 5: lupninox (1118447 in chips)
Seat 6: evgeniili90 (618840 in chips)
Seat 7: hichnick777 (1170586 in chips) out of hand (moved from another table into small blind)
Seat 8: ZamoS89 (324377 in chips)
Seat 9: Laska_Lisa (1032175 in chips)
scabbyqueen: posts the ante 2500
agustin_kv: posts the ante 2500
4time2warp0: posts the ante 2500
lupninox: posts the ante 2500
evgeniili90: posts the ante 2500
ZamoS89: posts the ante 2500
Laska_Lisa: posts the ante 2500
ZamoS89: posts small blind 12500
Laska_Lisa: posts big blind 25000
*** HOLE CARDS ***
scabbyqueen: folds
agustin_kv: folds
4time2warp0: folds
lupninox: folds
evgeniili90: folds
ZamoS89: folds
Uncalled bet (12500) returned to Laska_Lisa
Laska_Lisa collected 42500 from pot
Laska_Lisa: doesn't show hand
*** SUMMARY ***
Total pot 42500 | Rake 0
Seat 1: scabbyqueen folded before Flop (didn't bet)
Seat 3: agustin_kv folded before Flop (didn't bet)
Seat 4: 4time2warp0 folded before Flop (didn't bet)
Seat 5: lupninox folded before Flop (didn't bet)
Seat 6: evgeniili90 (button) folded before Flop (didn't bet)
Seat 8: ZamoS89 (small blind) folded before Flop
Seat 9: Laska_Lisa (big blind) collected (42500)


*********** # 290 **************
PokerStars Hand #176679080311: Tournament #2054568934, $20+$2 USD Hold'em No Limit - Level XXXII (12500/25000) - 2017/10/09 5:13:13 MSK [2017/10/08 22:13:13 ET]
Table '2054568934 598' 9-max Seat #8 is the button
Seat 1: scabbyqueen (654153 in chips)
Seat 3: agustin_kv (64440 in chips)
Seat 4: 4time2warp0 (682806 in chips)
Seat 5: lupninox (1115947 in chips)
Seat 6: evgeniili90 (616340 in chips)
Seat 7: hichnick777 (1170586 in chips)
Seat 8: ZamoS89 (309377 in chips)
Seat 9: Laska_Lisa (1059675 in chips)
scabbyqueen: posts the ante 2500
agustin_kv: posts the ante 2500
4time2warp0: posts the ante 2500
lupninox: posts the ante 2500
evgeniili90: posts the ante 2500
hichnick777: posts the ante 2500
ZamoS89: posts the ante 2500
Laska_Lisa: posts the ante 2500
Laska_Lisa: posts small blind 12500
scabbyqueen: posts big blind 25000
*** HOLE CARDS ***
Dealt to hichnick777 [4c Qd]
agustin_kv: raises 36528 to 61528
4time2warp0: folds
lupninox: folds
evgeniili90: folds
hichnick777: folds
ZamoS89: raises 245349 to 306877 and is all-in
Laska_Lisa: folds
scabbyqueen: folds
agustin_kv: calls 412 and is all-in
Uncalled bet (244937) returned to ZamoS89
*** FLOP *** [9d 4d 9c]
*** TURN *** [9d 4d 9c] [7s]
*** RIVER *** [9d 4d 9c 7s] [4h]
*** SHOW DOWN ***
agustin_kv: shows [8d Kd] (two pair, Nines and Fours)
ZamoS89: shows [Ad Qc] (two pair, Nines and Fours - Ace kicker)
ZamoS89 collected 181380 from pot
agustin_kv finished the tournament in 110th place and received $106.98.
*** SUMMARY ***
Total pot 181380 | Rake 0
Board [9d 4d 9c 7s 4h]
Seat 1: scabbyqueen (big blind) folded before Flop
Seat 3: agustin_kv showed [8d Kd] and lost with two pair, Nines and Fours
Seat 4: 4time2warp0 folded before Flop (didn't bet)
Seat 5: lupninox folded before Flop (didn't bet)
Seat 6: evgeniili90 folded before Flop (didn't bet)
Seat 7: hichnick777 folded before Flop (didn't bet)
Seat 8: ZamoS89 (button) showed [Ad Qc] and won (181380) with two pair, Nines and Fours
Seat 9: Laska_Lisa (small blind) folded before Flop


*********** # 291 **************
PokerStars Hand #176679100301: Tournament #2054568934, $20+$2 USD Hold'em No Limit - Level XXXIII (15000/30000) - 2017/10/09 5:14:14 MSK [2017/10/08 22:14:14 ET]
Table '2054568934 598' 9-max Seat #9 is the button
Seat 1: scabbyqueen (626653 in chips)
Seat 4: 4time2warp0 (680306 in chips)
Seat 5: lupninox (1113447 in chips)
Seat 6: evgeniili90 (613840 in chips)
Seat 7: hichnick777 (1168086 in chips)
Seat 8: ZamoS89 (426317 in chips)
Seat 9: Laska_Lisa (1044675 in chips)
scabbyqueen: posts the ante 3000
4time2warp0: posts the ante 3000
lupninox: posts the ante 3000
evgeniili90: posts the ante 3000
hichnick777: posts the ante 3000
ZamoS89: posts the ante 3000
Laska_Lisa: posts the ante 3000
scabbyqueen: posts small blind 15000
4time2warp0: posts big blind 30000
*** HOLE CARDS ***
Dealt to hichnick777 [Jh Kc]
lupninox: folds
evgeniili90: folds
hichnick777: raises 37500 to 67500
ZamoS89: folds
Laska_Lisa: folds
scabbyqueen: folds
4time2warp0: calls 37500
*** FLOP *** [9s 6d 8s]
4time2warp0: checks
hichnick777: checks
*** TURN *** [9s 6d 8s] [5c]
4time2warp0: bets 85500
hichnick777: folds
Uncalled bet (85500) returned to 4time2warp0
4time2warp0 collected 171000 from pot
4time2warp0: doesn't show hand
*** SUMMARY ***
Total pot 171000 | Rake 0
Board [9s 6d 8s 5c]
Seat 1: scabbyqueen (small blind) folded before Flop
Seat 4: 4time2warp0 (big blind) collected (171000)
Seat 5: lupninox folded before Flop (didn't bet)
Seat 6: evgeniili90 folded before Flop (didn't bet)
Seat 7: hichnick777 folded on the Turn
Seat 8: ZamoS89 folded before Flop (didn't bet)
Seat 9: Laska_Lisa (button) folded before Flop (didn't bet)


*********** # 292 **************
PokerStars Hand #176679115102: Tournament #2054568934, $20+$2 USD Hold'em No Limit - Level XXXIII (15000/30000) - 2017/10/09 5:15:00 MSK [2017/10/08 22:15:00 ET]
Table '2054568934 598' 9-max Seat #1 is the button
Seat 1: scabbyqueen (608653 in chips)
Seat 2: blackaces93 (1887346 in chips) out of hand (moved from another table into small blind)
Seat 4: 4time2warp0 (780806 in chips)
Seat 5: lupninox (1110447 in chips)
Seat 6: evgeniili90 (610840 in chips)
Seat 7: hichnick777 (1097586 in chips)
Seat 8: ZamoS89 (423317 in chips)
Seat 9: Laska_Lisa (1041675 in chips)
scabbyqueen: posts the ante 3000
4time2warp0: posts the ante 3000
lupninox: posts the ante 3000
evgeniili90: posts the ante 3000
hichnick777: posts the ante 3000
ZamoS89: posts the ante 3000
Laska_Lisa: posts the ante 3000
4time2warp0: posts small blind 15000
lupninox: posts big blind 30000
*** HOLE CARDS ***
Dealt to hichnick777 [5d 9s]
evgeniili90: folds
hichnick777: folds
ZamoS89: folds
Laska_Lisa: raises 30000 to 60000
scabbyqueen: raises 545653 to 605653 and is all-in
4time2warp0: folds
lupninox: folds
Laska_Lisa: folds
Uncalled bet (545653) returned to scabbyqueen
scabbyqueen collected 186000 from pot
scabbyqueen: doesn't show hand
*** SUMMARY ***
Total pot 186000 | Rake 0
Seat 1: scabbyqueen (button) collected (186000)
Seat 4: 4time2warp0 (small blind) folded before Flop
Seat 5: lupninox (big blind) folded before Flop
Seat 6: evgeniili90 folded before Flop (didn't bet)
Seat 7: hichnick777 folded before Flop (didn't bet)
Seat 8: ZamoS89 folded before Flop (didn't bet)
Seat 9: Laska_Lisa folded before Flop


*********** # 293 **************
PokerStars Hand #176679126614: Tournament #2054568934, $20+$2 USD Hold'em No Limit - Level XXXIII (15000/30000) - 2017/10/09 5:15:34 MSK [2017/10/08 22:15:34 ET]
Table '2054568934 598' 9-max Seat #4 is the button
Seat 1: scabbyqueen (731653 in chips)
Seat 2: blackaces93 (1887346 in chips)
Seat 4: 4time2warp0 (762806 in chips)
Seat 5: lupninox (1077447 in chips)
Seat 6: evgeniili90 (607840 in chips)
Seat 7: hichnick777 (1094586 in chips)
Seat 8: ZamoS89 (420317 in chips)
Seat 9: Laska_Lisa (978675 in chips)
scabbyqueen: posts the ante 3000
blackaces93: posts the ante 3000
4time2warp0: posts the ante 3000
lupninox: posts the ante 3000
evgeniili90: posts the ante 3000
hichnick777: posts the ante 3000
ZamoS89: posts the ante 3000
Laska_Lisa: posts the ante 3000
lupninox: posts small blind 15000
evgeniili90: posts big blind 30000
*** HOLE CARDS ***
Dealt to hichnick777 [7c 3c]
hichnick777: folds
ZamoS89: folds
Laska_Lisa: raises 30000 to 60000
scabbyqueen: raises 668653 to 728653 and is all-in
blackaces93: folds
4time2warp0: folds
lupninox: folds
evgeniili90: folds
Laska_Lisa: folds [Td Ah]
Uncalled bet (668653) returned to scabbyqueen
scabbyqueen collected 189000 from pot
scabbyqueen: doesn't show hand
*** SUMMARY ***
Total pot 189000 | Rake 0
Seat 1: scabbyqueen collected (189000)
Seat 2: blackaces93 folded before Flop (didn't bet)
Seat 4: 4time2warp0 (button) folded before Flop (didn't bet)
Seat 5: lupninox (small blind) folded before Flop
Seat 6: evgeniili90 (big blind) folded before Flop
Seat 7: hichnick777 folded before Flop (didn't bet)
Seat 8: ZamoS89 folded before Flop (didn't bet)
Seat 9: Laska_Lisa folded before Flop


*********** # 294 **************
PokerStars Hand #176679133470: Tournament #2054568934, $20+$2 USD Hold'em No Limit - Level XXXIII (15000/30000) - 2017/10/09 5:15:55 MSK [2017/10/08 22:15:55 ET]
Table '2054568934 598' 9-max Seat #5 is the button
Seat 1: scabbyqueen (857653 in chips)
Seat 2: blackaces93 (1884346 in chips)
Seat 3: Yusukeju (565739 in chips)
Seat 4: 4time2warp0 (759806 in chips)
Seat 5: lupninox (1059447 in chips)
Seat 6: evgeniili90 (574840 in chips)
Seat 7: hichnick777 (1091586 in chips)
Seat 8: ZamoS89 (417317 in chips)
Seat 9: Laska_Lisa (915675 in chips)
scabbyqueen: posts the ante 3000
blackaces93: posts the ante 3000
Yusukeju: posts the ante 3000
4time2warp0: posts the ante 3000
lupninox: posts the ante 3000
evgeniili90: posts the ante 3000
hichnick777: posts the ante 3000
ZamoS89: posts the ante 3000
Laska_Lisa: posts the ante 3000
evgeniili90: posts small blind 15000
hichnick777: posts big blind 30000
*** HOLE CARDS ***
Dealt to hichnick777 [5h 2c]
ZamoS89: raises 30300 to 60300
Laska_Lisa: folds
scabbyqueen: folds
blackaces93: folds
Yusukeju: folds
4time2warp0: folds
lupninox: raises 78900 to 139200
evgeniili90: folds
hichnick777: folds
ZamoS89: folds
Uncalled bet (78900) returned to lupninox
lupninox collected 192600 from pot
*** SUMMARY ***
Total pot 192600 | Rake 0
Seat 1: scabbyqueen folded before Flop (didn't bet)
Seat 2: blackaces93 folded before Flop (didn't bet)
Seat 3: Yusukeju folded before Flop (didn't bet)
Seat 4: 4time2warp0 folded before Flop (didn't bet)
Seat 5: lupninox (button) collected (192600)
Seat 6: evgeniili90 (small blind) folded before Flop
Seat 7: hichnick777 (big blind) folded before Flop
Seat 8: ZamoS89 folded before Flop
Seat 9: Laska_Lisa folded before Flop (didn't bet)


*********** # 295 **************
PokerStars Hand #176679153938: Tournament #2054568934, $20+$2 USD Hold'em No Limit - Level XXXIII (15000/30000) - 2017/10/09 5:16:58 MSK [2017/10/08 22:16:58 ET]
Table '2054568934 598' 9-max Seat #6 is the button
Seat 1: scabbyqueen (854653 in chips)
Seat 2: blackaces93 (1881346 in chips)
Seat 3: Yusukeju (562739 in chips)
Seat 4: 4time2warp0 (756806 in chips)
Seat 5: lupninox (1188747 in chips)
Seat 6: evgeniili90 (556840 in chips)
Seat 7: hichnick777 (1058586 in chips)
Seat 8: ZamoS89 (354017 in chips)
Seat 9: Laska_Lisa (912675 in chips)
scabbyqueen: posts the ante 3000
blackaces93: posts the ante 3000
Yusukeju: posts the ante 3000
4time2warp0: posts the ante 3000
lupninox: posts the ante 3000
evgeniili90: posts the ante 3000
hichnick777: posts the ante 3000
ZamoS89: posts the ante 3000
Laska_Lisa: posts the ante 3000
hichnick777: posts small blind 15000
ZamoS89: posts big blind 30000
*** HOLE CARDS ***
Dealt to hichnick777 [Jh 9h]
Laska_Lisa: folds
scabbyqueen: folds
blackaces93: folds
Yusukeju: folds
4time2warp0: folds
lupninox: folds
evgeniili90: raises 45000 to 75000
hichnick777: raises 980586 to 1055586 and is all-in
ZamoS89: folds
evgeniili90: calls 478840 and is all-in
Uncalled bet (501746) returned to hichnick777
*** FLOP *** [5h 6c 9c]
*** TURN *** [5h 6c 9c] [As]
*** RIVER *** [5h 6c 9c As] [Ks]
*** SHOW DOWN ***
hichnick777: shows [Jh 9h] (a pair of Nines)
evgeniili90: shows [8s 8d] (a pair of Eights)
hichnick777 collected 1164680 from pot
evgeniili90 finished the tournament in 101st place and received $125.06.
*** SUMMARY ***
Total pot 1164680 | Rake 0
Board [5h 6c 9c As Ks]
Seat 1: scabbyqueen folded before Flop (didn't bet)
Seat 2: blackaces93 folded before Flop (didn't bet)
Seat 3: Yusukeju folded before Flop (didn't bet)
Seat 4: 4time2warp0 folded before Flop (didn't bet)
Seat 5: lupninox folded before Flop (didn't bet)
Seat 6: evgeniili90 (button) showed [8s 8d] and lost with a pair of Eights
Seat 7: hichnick777 (small blind) showed [Jh 9h] and won (1164680) with a pair of Nines
Seat 8: ZamoS89 (big blind) folded before Flop
Seat 9: Laska_Lisa folded before Flop (didn't bet)


*********** # 296 **************
PokerStars Hand #176679172462: Tournament #2054568934, $20+$2 USD Hold'em No Limit - Level XXXIII (15000/30000) - 2017/10/09 5:17:54 MSK [2017/10/08 22:17:54 ET]
Table '2054568934 598' 9-max Seat #7 is the button
Seat 1: scabbyqueen (851653 in chips)
Seat 2: blackaces93 (1878346 in chips)
Seat 3: Yusukeju (559739 in chips)
Seat 4: 4time2warp0 (753806 in chips)
Seat 5: lupninox (1185747 in chips)
Seat 7: hichnick777 (1666426 in chips)
Seat 8: ZamoS89 (321017 in chips)
Seat 9: Laska_Lisa (909675 in chips)
scabbyqueen: posts the ante 3000
blackaces93: posts the ante 3000
Yusukeju: posts the ante 3000
4time2warp0: posts the ante 3000
lupninox: posts the ante 3000
hichnick777: posts the ante 3000
ZamoS89: posts the ante 3000
Laska_Lisa: posts the ante 3000
ZamoS89: posts small blind 15000
Laska_Lisa: posts big blind 30000
*** HOLE CARDS ***
Dealt to hichnick777 [6c 3h]
scabbyqueen: folds
blackaces93: raises 35100 to 65100
Yusukeju: folds
4time2warp0: folds
lupninox: folds
hichnick777: folds
ZamoS89: folds
Laska_Lisa: calls 35100
*** FLOP *** [4s Kc 3s]
Laska_Lisa: checks
blackaces93: bets 52604
Laska_Lisa: calls 52604
*** TURN *** [4s Kc 3s] [Tc]
Laska_Lisa: bets 137204
blackaces93: calls 137204
*** RIVER *** [4s Kc 3s Tc] [3d]
Laska_Lisa: bets 274408
blackaces93: calls 274408
*** SHOW DOWN ***
Laska_Lisa: shows [Ks Qc] (two pair, Kings and Threes)
blackaces93: mucks hand
Laska_Lisa collected 1097632 from pot
*** SUMMARY ***
Total pot 1097632 | Rake 0
Board [4s Kc 3s Tc 3d]
Seat 1: scabbyqueen folded before Flop (didn't bet)
Seat 2: blackaces93 mucked [Ah Th]
Seat 3: Yusukeju folded before Flop (didn't bet)
Seat 4: 4time2warp0 folded before Flop (didn't bet)
Seat 5: lupninox folded before Flop (didn't bet)
Seat 7: hichnick777 (button) folded before Flop (didn't bet)
Seat 8: ZamoS89 (small blind) folded before Flop
Seat 9: Laska_Lisa (big blind) showed [Ks Qc] and won (1097632) with two pair, Kings and Threes


*********** # 297 **************
PokerStars Hand #176679198895: Tournament #2054568934, $20+$2 USD Hold'em No Limit - Level XXXIII (15000/30000) - 2017/10/09 5:19:14 MSK [2017/10/08 22:19:14 ET]
Table '2054568934 598' 9-max Seat #8 is the button
Seat 1: scabbyqueen (848653 in chips)
Seat 2: blackaces93 (1346030 in chips)
Seat 3: Yusukeju (556739 in chips)
Seat 4: 4time2warp0 (750806 in chips)
Seat 5: lupninox (1182747 in chips)
Seat 6: marval231 (259699 in chips)
Seat 7: hichnick777 (1663426 in chips)
Seat 8: ZamoS89 (303017 in chips)
Seat 9: Laska_Lisa (1474991 in chips)
scabbyqueen: posts the ante 3000
blackaces93: posts the ante 3000
Yusukeju: posts the ante 3000
4time2warp0: posts the ante 3000
lupninox: posts the ante 3000
marval231: posts the ante 3000
hichnick777: posts the ante 3000
ZamoS89: posts the ante 3000
Laska_Lisa: posts the ante 3000
Laska_Lisa: posts small blind 15000
scabbyqueen: posts big blind 30000
*** HOLE CARDS ***
Dealt to hichnick777 [Js 2s]
blackaces93: folds
Yusukeju: folds
4time2warp0: folds
lupninox: raises 30457 to 60457
marval231: folds
hichnick777: folds
ZamoS89: folds
Laska_Lisa: folds
scabbyqueen: calls 30457
*** FLOP *** [Qd 7c 6h]
scabbyqueen: checks
lupninox: bets 53649
scabbyqueen: calls 53649
*** TURN *** [Qd 7c 6h] [3d]
scabbyqueen: checks
lupninox: bets 124298
scabbyqueen: calls 124298
*** RIVER *** [Qd 7c 6h 3d] [Td]
scabbyqueen: checks
lupninox: checks
*** SHOW DOWN ***
scabbyqueen: shows [6d 4h] (a pair of Sixes)
lupninox: shows [Qh Ad] (a pair of Queens)
lupninox collected 518808 from pot
*** SUMMARY ***
Total pot 518808 | Rake 0
Board [Qd 7c 6h 3d Td]
Seat 1: scabbyqueen (big blind) showed [6d 4h] and lost with a pair of Sixes
Seat 2: blackaces93 folded before Flop (didn't bet)
Seat 3: Yusukeju folded before Flop (didn't bet)
Seat 4: 4time2warp0 folded before Flop (didn't bet)
Seat 5: lupninox showed [Qh Ad] and won (518808) with a pair of Queens
Seat 6: marval231 folded before Flop (didn't bet)
Seat 7: hichnick777 folded before Flop (didn't bet)
Seat 8: ZamoS89 (button) folded before Flop (didn't bet)
Seat 9: Laska_Lisa (small blind) folded before Flop


*********** # 298 **************
PokerStars Hand #176679224026: Tournament #2054568934, $20+$2 USD Hold'em No Limit - Level XXXIII (15000/30000) - 2017/10/09 5:20:31 MSK [2017/10/08 22:20:31 ET]
Table '2054568934 598' 9-max Seat #9 is the button
Seat 1: scabbyqueen (607249 in chips)
Seat 2: blackaces93 (1343030 in chips)
Seat 4: 4time2warp0 (747806 in chips)
Seat 5: lupninox (1460151 in chips)
Seat 6: marval231 (256699 in chips)
Seat 7: hichnick777 (1660426 in chips)
Seat 8: ZamoS89 (300017 in chips)
Seat 9: Laska_Lisa (1456991 in chips)
scabbyqueen: posts the ante 3000
blackaces93: posts the ante 3000
4time2warp0: posts the ante 3000
lupninox: posts the ante 3000
marval231: posts the ante 3000
hichnick777: posts the ante 3000
ZamoS89: posts the ante 3000
Laska_Lisa: posts the ante 3000
scabbyqueen: posts small blind 15000
blackaces93: posts big blind 30000
*** HOLE CARDS ***
Dealt to hichnick777 [5s 9d]
4time2warp0: raises 30000 to 60000
lupninox: folds
marval231: folds
hichnick777: folds
ZamoS89: folds
Laska_Lisa: calls 60000
scabbyqueen: folds
blackaces93: calls 30000
*** FLOP *** [9c Ts 2h]
blackaces93: checks
4time2warp0: bets 120000
Laska_Lisa: calls 120000
blackaces93: folds
*** TURN *** [9c Ts 2h] [Jd]
4time2warp0: checks
Laska_Lisa: bets 229500
4time2warp0: folds
Uncalled bet (229500) returned to Laska_Lisa
Laska_Lisa collected 459000 from pot
Laska_Lisa: doesn't show hand
*** SUMMARY ***
Total pot 459000 | Rake 0
Board [9c Ts 2h Jd]
Seat 1: scabbyqueen (small blind) folded before Flop
Seat 2: blackaces93 (big blind) folded on the Flop
Seat 4: 4time2warp0 folded on the Turn
Seat 5: lupninox folded before Flop (didn't bet)
Seat 6: marval231 folded before Flop (didn't bet)
Seat 7: hichnick777 folded before Flop (didn't bet)
Seat 8: ZamoS89 folded before Flop (didn't bet)
Seat 9: Laska_Lisa (button) collected (459000)


*********** # 299 **************
PokerStars Hand #176679249988: Tournament #2054568934, $20+$2 USD Hold'em No Limit - Level XXXIII (15000/30000) - 2017/10/09 5:21:51 MSK [2017/10/08 22:21:51 ET]
Table '2054568934 598' 9-max Seat #1 is the button
Seat 1: scabbyqueen (589249 in chips)
Seat 2: blackaces93 (1280030 in chips)
Seat 4: 4time2warp0 (564806 in chips)
Seat 5: lupninox (1457151 in chips)
Seat 6: marval231 (253699 in chips)
Seat 7: hichnick777 (1657426 in chips)
Seat 8: ZamoS89 (297017 in chips)
Seat 9: Laska_Lisa (1732991 in chips)
scabbyqueen: posts the ante 3000
blackaces93: posts the ante 3000
4time2warp0: posts the ante 3000
lupninox: posts the ante 3000
marval231: posts the ante 3000
hichnick777: posts the ante 3000
ZamoS89: posts the ante 3000
Laska_Lisa: posts the ante 3000
blackaces93: posts small blind 15000
4time2warp0: posts big blind 30000
*** HOLE CARDS ***
Dealt to hichnick777 [9c 6h]
lupninox: folds
marval231: folds
hichnick777: folds
ZamoS89: folds
Laska_Lisa: folds
scabbyqueen: folds
blackaces93: raises 1247030 to 1277030 and is all-in
4time2warp0: folds
Uncalled bet (1247030) returned to blackaces93
blackaces93 collected 84000 from pot
blackaces93: doesn't show hand
*** SUMMARY ***
Total pot 84000 | Rake 0
Seat 1: scabbyqueen (button) folded before Flop (didn't bet)
Seat 2: blackaces93 (small blind) collected (84000)
Seat 4: 4time2warp0 (big blind) folded before Flop
Seat 5: lupninox folded before Flop (didn't bet)
Seat 6: marval231 folded before Flop (didn't bet)
Seat 7: hichnick777 folded before Flop (didn't bet)
Seat 8: ZamoS89 folded before Flop (didn't bet)
Seat 9: Laska_Lisa folded before Flop (didn't bet)


*********** # 300 **************
PokerStars Hand #176679268017: Tournament #2054568934, $20+$2 USD Hold'em No Limit - Level XXXIII (15000/30000) - 2017/10/09 5:22:49 MSK [2017/10/08 22:22:49 ET]
Table '2054568934 598' 9-max Seat #2 is the button
Seat 1: scabbyqueen (586249 in chips)
Seat 2: blackaces93 (1331030 in chips)
Seat 3: siggins22 (836051 in chips) out of hand (moved from another table into small blind)
Seat 4: 4time2warp0 (531806 in chips)
Seat 5: lupninox (1454151 in chips)
Seat 6: marval231 (250699 in chips)
Seat 7: hichnick777 (1654426 in chips)
Seat 8: ZamoS89 (294017 in chips)
Seat 9: Laska_Lisa (1729991 in chips)
scabbyqueen: posts the ante 3000
blackaces93: posts the ante 3000
4time2warp0: posts the ante 3000
lupninox: posts the ante 3000
marval231: posts the ante 3000
hichnick777: posts the ante 3000
ZamoS89: posts the ante 3000
Laska_Lisa: posts the ante 3000
4time2warp0: posts small blind 15000
lupninox: posts big blind 30000
*** HOLE CARDS ***
Dealt to hichnick777 [Th 6d]
marval231: folds
hichnick777: folds
ZamoS89: folds
Laska_Lisa: raises 60000 to 90000
scabbyqueen: raises 493249 to 583249 and is all-in
blackaces93: raises 744781 to 1328030 and is all-in
4time2warp0: folds
lupninox: folds
Laska_Lisa: calls 1238030
*** FLOP *** [Jd 3d Qd]
*** TURN *** [Jd 3d Qd] [2s]
*** RIVER *** [Jd 3d Qd 2s] [7s]
*** SHOW DOWN ***
Laska_Lisa: shows [Kh Ah] (high card Ace)
blackaces93: shows [9h 9d] (a pair of Nines)
blackaces93 collected 1489562 from side pot
scabbyqueen: shows [5c 5s] (a pair of Fives)
blackaces93 collected 1818747 from main pot
scabbyqueen finished the tournament in 87th place and received $125.06.
*** SUMMARY ***
Total pot 3308309 Main pot 1818747. Side pot 1489562. | Rake 0
Board [Jd 3d Qd 2s 7s]
Seat 1: scabbyqueen showed [5c 5s] and lost with a pair of Fives
Seat 2: blackaces93 (button) showed [9h 9d] and won (3308309) with a pair of Nines
Seat 4: 4time2warp0 (small blind) folded before Flop
Seat 5: lupninox (big blind) folded before Flop
Seat 6: marval231 folded before Flop (didn't bet)
Seat 7: hichnick777 folded before Flop (didn't bet)
Seat 8: ZamoS89 folded before Flop (didn't bet)
Seat 9: Laska_Lisa showed [Kh Ah] and lost with high card Ace


*********** # 301 **************
PokerStars Hand #176679281707: Tournament #2054568934, $20+$2 USD Hold'em No Limit - Level XXXIII (15000/30000) - 2017/10/09 5:23:32 MSK [2017/10/08 22:23:32 ET]
Table '2054568934 598' 9-max Seat #4 is the button
Seat 2: blackaces93 (3308309 in chips)
Seat 3: siggins22 (836051 in chips)
Seat 4: 4time2warp0 (513806 in chips)
Seat 5: lupninox (1421151 in chips)
Seat 6: marval231 (247699 in chips)
Seat 7: hichnick777 (1651426 in chips)
Seat 8: ZamoS89 (291017 in chips)
Seat 9: Laska_Lisa (398961 in chips)
blackaces93: posts the ante 3000
siggins22: posts the ante 3000
4time2warp0: posts the ante 3000
lupninox: posts the ante 3000
marval231: posts the ante 3000
hichnick777: posts the ante 3000
ZamoS89: posts the ante 3000
Laska_Lisa: posts the ante 3000
lupninox: posts small blind 15000
marval231: posts big blind 30000
*** HOLE CARDS ***
Dealt to hichnick777 [Ah As]
hichnick777: raises 37500 to 67500
ZamoS89: folds
Laska_Lisa: raises 328461 to 395961 and is all-in
blackaces93: folds
siggins22: folds
4time2warp0: folds
lupninox: folds
marval231: folds
hichnick777: calls 328461
*** FLOP *** [3c Qh 3s]
*** TURN *** [3c Qh 3s] [4s]
*** RIVER *** [3c Qh 3s 4s] [Qd]
*** SHOW DOWN ***
hichnick777: shows [Ah As] (two pair, Aces and Queens)
Laska_Lisa: shows [Ad Qc] (a full house, Queens full of Threes)
Laska_Lisa collected 860922 from pot
*** SUMMARY ***
Total pot 860922 | Rake 0
Board [3c Qh 3s 4s Qd]
Seat 2: blackaces93 folded before Flop (didn't bet)
Seat 3: siggins22 folded before Flop (didn't bet)
Seat 4: 4time2warp0 (button) folded before Flop (didn't bet)
Seat 5: lupninox (small blind) folded before Flop
Seat 6: marval231 (big blind) folded before Flop
Seat 7: hichnick777 showed [Ah As] and lost with two pair, Aces and Queens
Seat 8: ZamoS89 folded before Flop (didn't bet)
Seat 9: Laska_Lisa showed [Ad Qc] and won (860922) with a full house, Queens full of Threes


*********** # 302 **************
PokerStars Hand #176679295946: Tournament #2054568934, $20+$2 USD Hold'em No Limit - Level XXXIII (15000/30000) - 2017/10/09 5:24:17 MSK [2017/10/08 22:24:17 ET]
Table '2054568934 598' 9-max Seat #5 is the button
Seat 2: blackaces93 (3305309 in chips)
Seat 3: siggins22 (833051 in chips)
Seat 4: 4time2warp0 (510806 in chips)
Seat 5: lupninox (1403151 in chips)
Seat 6: marval231 (214699 in chips)
Seat 7: hichnick777 (1252465 in chips)
Seat 8: ZamoS89 (288017 in chips)
Seat 9: Laska_Lisa (860922 in chips)
blackaces93: posts the ante 3000
siggins22: posts the ante 3000
4time2warp0: posts the ante 3000
lupninox: posts the ante 3000
marval231: posts the ante 3000
hichnick777: posts the ante 3000
ZamoS89: posts the ante 3000
Laska_Lisa: posts the ante 3000
marval231: posts small blind 15000
hichnick777: posts big blind 30000
*** HOLE CARDS ***
Dealt to hichnick777 [9h 9s]
ZamoS89 said, "i had a Q"
ZamoS89: folds
Laska_Lisa: folds
blackaces93: folds
siggins22: folds
4time2warp0: folds
lupninox: folds
dotoclaudio [observer] said, "lol"
marval231: folds
Uncalled bet (15000) returned to hichnick777
hichnick777 collected 54000 from pot
hichnick777: doesn't show hand
*** SUMMARY ***
Total pot 54000 | Rake 0
Seat 2: blackaces93 folded before Flop (didn't bet)
Seat 3: siggins22 folded before Flop (didn't bet)
Seat 4: 4time2warp0 folded before Flop (didn't bet)
Seat 5: lupninox (button) folded before Flop (didn't bet)
Seat 6: marval231 (small blind) folded before Flop
Seat 7: hichnick777 (big blind) collected (54000)
Seat 8: ZamoS89 folded before Flop (didn't bet)
Seat 9: Laska_Lisa folded before Flop (didn't bet)


*********** # 303 **************
PokerStars Hand #176679305113: Tournament #2054568934, $20+$2 USD Hold'em No Limit - Level XXXIII (15000/30000) - 2017/10/09 5:24:46 MSK [2017/10/08 22:24:46 ET]
Table '2054568934 598' 9-max Seat #6 is the button
Seat 2: blackaces93 (3302309 in chips)
Seat 3: siggins22 (830051 in chips)
Seat 4: 4time2warp0 (507806 in chips)
Seat 5: lupninox (1400151 in chips)
Seat 6: marval231 (196699 in chips)
Seat 7: hichnick777 (1288465 in chips)
Seat 8: ZamoS89 (285017 in chips)
Seat 9: Laska_Lisa (857922 in chips)
blackaces93: posts the ante 3000
siggins22: posts the ante 3000
4time2warp0: posts the ante 3000
lupninox: posts the ante 3000
marval231: posts the ante 3000
hichnick777: posts the ante 3000
ZamoS89: posts the ante 3000
Laska_Lisa: posts the ante 3000
hichnick777: posts small blind 15000
ZamoS89: posts big blind 30000
*** HOLE CARDS ***
Dealt to hichnick777 [Qs 3c]
Laska_Lisa: folds
blackaces93: folds
siggins22: folds
4time2warp0: folds
lupninox: folds
marval231: folds
hichnick777: raises 1255465 to 1285465 and is all-in
ZamoS89: calls 252017 and is all-in
Uncalled bet (1003448) returned to hichnick777
*** FLOP *** [Qc 5c Ts]
*** TURN *** [Qc 5c Ts] [9s]
*** RIVER *** [Qc 5c Ts 9s] [Jd]
*** SHOW DOWN ***
hichnick777: shows [Qs 3c] (a pair of Queens)
ZamoS89: shows [2h Ks] (a straight, Nine to King)
ZamoS89 collected 588034 from pot
*** SUMMARY ***
Total pot 588034 | Rake 0
Board [Qc 5c Ts 9s Jd]
Seat 2: blackaces93 folded before Flop (didn't bet)
Seat 3: siggins22 folded before Flop (didn't bet)
Seat 4: 4time2warp0 folded before Flop (didn't bet)
Seat 5: lupninox folded before Flop (didn't bet)
Seat 6: marval231 (button) folded before Flop (didn't bet)
Seat 7: hichnick777 (small blind) showed [Qs 3c] and lost with a pair of Queens
Seat 8: ZamoS89 (big blind) showed [2h Ks] and won (588034) with a straight, Nine to King
Seat 9: Laska_Lisa folded before Flop (didn't bet)


*********** # 304 **************
PokerStars Hand #176679324434: Tournament #2054568934, $20+$2 USD Hold'em No Limit - Level XXXIV (17500/35000) - 2017/10/09 5:25:46 MSK [2017/10/08 22:25:46 ET]
Table '2054568934 598' 9-max Seat #7 is the button
Seat 2: blackaces93 (3299309 in chips)
Seat 3: siggins22 (827051 in chips)
Seat 4: 4time2warp0 (504806 in chips)
Seat 5: lupninox (1397151 in chips)
Seat 6: marval231 (193699 in chips)
Seat 7: hichnick777 (1003448 in chips)
Seat 8: ZamoS89 (588034 in chips)
Seat 9: Laska_Lisa (854922 in chips)
blackaces93: posts the ante 3500
siggins22: posts the ante 3500
4time2warp0: posts the ante 3500
lupninox: posts the ante 3500
marval231: posts the ante 3500
hichnick777: posts the ante 3500
ZamoS89: posts the ante 3500
Laska_Lisa: posts the ante 3500
ZamoS89: posts small blind 17500
Laska_Lisa: posts big blind 35000
*** HOLE CARDS ***
Dealt to hichnick777 [4h 7c]
blackaces93: folds
siggins22: raises 52500 to 87500
4time2warp0: folds
lupninox: folds
marval231: folds
hichnick777: folds
ZamoS89: folds
Laska_Lisa: folds
Uncalled bet (52500) returned to siggins22
siggins22 collected 115500 from pot
siggins22: doesn't show hand
*** SUMMARY ***
Total pot 115500 | Rake 0
Seat 2: blackaces93 folded before Flop (didn't bet)
Seat 3: siggins22 collected (115500)
Seat 4: 4time2warp0 folded before Flop (didn't bet)
Seat 5: lupninox folded before Flop (didn't bet)
Seat 6: marval231 folded before Flop (didn't bet)
Seat 7: hichnick777 (button) folded before Flop (didn't bet)
Seat 8: ZamoS89 (small blind) folded before Flop
Seat 9: Laska_Lisa (big blind) folded before Flop


*********** # 305 **************
PokerStars Hand #176679330318: Tournament #2054568934, $20+$2 USD Hold'em No Limit - Level XXXIV (17500/35000) - 2017/10/09 5:26:04 MSK [2017/10/08 22:26:04 ET]
Table '2054568934 598' 9-max Seat #8 is the button
Seat 2: blackaces93 (3295809 in chips)
Seat 3: siggins22 (904051 in chips)
Seat 4: 4time2warp0 (501306 in chips)
Seat 5: lupninox (1393651 in chips)
Seat 6: marval231 (190199 in chips)
Seat 7: hichnick777 (999948 in chips)
Seat 8: ZamoS89 (567034 in chips)
Seat 9: Laska_Lisa (816422 in chips)
blackaces93: posts the ante 3500
siggins22: posts the ante 3500
4time2warp0: posts the ante 3500
lupninox: posts the ante 3500
marval231: posts the ante 3500
hichnick777: posts the ante 3500
ZamoS89: posts the ante 3500
Laska_Lisa: posts the ante 3500
Laska_Lisa: posts small blind 17500
blackaces93: posts big blind 35000
*** HOLE CARDS ***
Dealt to hichnick777 [Jd 3s]
siggins22: folds
4time2warp0: folds
lupninox: folds
marval231: folds
hichnick777: folds
ZamoS89: folds
Laska_Lisa: folds
Uncalled bet (17500) returned to blackaces93
blackaces93 collected 63000 from pot
blackaces93: doesn't show hand
*** SUMMARY ***
Total pot 63000 | Rake 0
Seat 2: blackaces93 (big blind) collected (63000)
Seat 3: siggins22 folded before Flop (didn't bet)
Seat 4: 4time2warp0 folded before Flop (didn't bet)
Seat 5: lupninox folded before Flop (didn't bet)
Seat 6: marval231 folded before Flop (didn't bet)
Seat 7: hichnick777 folded before Flop (didn't bet)
Seat 8: ZamoS89 (button) folded before Flop (didn't bet)
Seat 9: Laska_Lisa (small blind) folded before Flop


*********** # 306 **************
PokerStars Hand #176679340033: Tournament #2054568934, $20+$2 USD Hold'em No Limit - Level XXXIV (17500/35000) - 2017/10/09 5:26:34 MSK [2017/10/08 22:26:34 ET]
Table '2054568934 598' 9-max Seat #9 is the button
Seat 2: blackaces93 (3337809 in chips)
Seat 3: siggins22 (900551 in chips)
Seat 4: 4time2warp0 (497806 in chips)
Seat 5: lupninox (1390151 in chips)
Seat 6: marval231 (186699 in chips)
Seat 7: hichnick777 (996448 in chips)
Seat 8: ZamoS89 (563534 in chips)
Seat 9: Laska_Lisa (795422 in chips)
blackaces93: posts the ante 3500
siggins22: posts the ante 3500
4time2warp0: posts the ante 3500
lupninox: posts the ante 3500
marval231: posts the ante 3500
hichnick777: posts the ante 3500
ZamoS89: posts the ante 3500
Laska_Lisa: posts the ante 3500
blackaces93: posts small blind 17500
siggins22: posts big blind 35000
*** HOLE CARDS ***
Dealt to hichnick777 [Ks 4s]
4time2warp0: folds
lupninox: folds
marval231: folds
hichnick777: folds
ZamoS89: folds
Laska_Lisa: folds
blackaces93: raises 57770 to 92770
siggins22: folds
Uncalled bet (57770) returned to blackaces93
blackaces93 collected 98000 from pot
blackaces93: doesn't show hand
*** SUMMARY ***
Total pot 98000 | Rake 0
Seat 2: blackaces93 (small blind) collected (98000)
Seat 3: siggins22 (big blind) folded before Flop
Seat 4: 4time2warp0 folded before Flop (didn't bet)
Seat 5: lupninox folded before Flop (didn't bet)
Seat 6: marval231 folded before Flop (didn't bet)
Seat 7: hichnick777 folded before Flop (didn't bet)
Seat 8: ZamoS89 folded before Flop (didn't bet)
Seat 9: Laska_Lisa (button) folded before Flop (didn't bet)


*********** # 307 **************
PokerStars Hand #176679352239: Tournament #2054568934, $20+$2 USD Hold'em No Limit - Level XXXIV (17500/35000) - 2017/10/09 5:27:12 MSK [2017/10/08 22:27:12 ET]
Table '2054568934 598' 9-max Seat #2 is the button
Seat 2: blackaces93 (3397309 in chips)
Seat 3: siggins22 (862051 in chips)
Seat 4: 4time2warp0 (494306 in chips)
Seat 5: lupninox (1386651 in chips)
Seat 6: marval231 (183199 in chips)
Seat 7: hichnick777 (992948 in chips)
Seat 8: ZamoS89 (560034 in chips)
Seat 9: Laska_Lisa (791922 in chips)
blackaces93: posts the ante 3500
siggins22: posts the ante 3500
4time2warp0: posts the ante 3500
lupninox: posts the ante 3500
marval231: posts the ante 3500
hichnick777: posts the ante 3500
ZamoS89: posts the ante 3500
Laska_Lisa: posts the ante 3500
siggins22: posts small blind 17500
4time2warp0: posts big blind 35000
*** HOLE CARDS ***
Dealt to hichnick777 [2c 9d]
lupninox: folds
marval231: folds
hichnick777: folds
ZamoS89: raises 35350 to 70350
Laska_Lisa: folds
blackaces93: folds
siggins22: folds
4time2warp0: raises 420456 to 490806 and is all-in
ZamoS89: folds
Uncalled bet (420456) returned to 4time2warp0
4time2warp0 collected 186200 from pot
4time2warp0: doesn't show hand
*** SUMMARY ***
Total pot 186200 | Rake 0
Seat 2: blackaces93 (button) folded before Flop (didn't bet)
Seat 3: siggins22 (small blind) folded before Flop
Seat 4: 4time2warp0 (big blind) collected (186200)
Seat 5: lupninox folded before Flop (didn't bet)
Seat 6: marval231 folded before Flop (didn't bet)
Seat 7: hichnick777 folded before Flop (didn't bet)
Seat 8: ZamoS89 folded before Flop
Seat 9: Laska_Lisa folded before Flop (didn't bet)


*********** # 308 **************
PokerStars Hand #176679364946: Tournament #2054568934, $20+$2 USD Hold'em No Limit - Level XXXIV (17500/35000) - 2017/10/09 5:27:52 MSK [2017/10/08 22:27:52 ET]
Table '2054568934 598' 9-max Seat #3 is the button
Seat 1: dogBq (895896 in chips)
Seat 2: blackaces93 (3393809 in chips)
Seat 3: siggins22 (841051 in chips)
Seat 4: 4time2warp0 (606656 in chips)
Seat 5: lupninox (1383151 in chips)
Seat 6: marval231 (179699 in chips)
Seat 7: hichnick777 (989448 in chips)
Seat 8: ZamoS89 (486184 in chips)
Seat 9: Laska_Lisa (788422 in chips)
dogBq: posts the ante 3500
blackaces93: posts the ante 3500
siggins22: posts the ante 3500
4time2warp0: posts the ante 3500
lupninox: posts the ante 3500
marval231: posts the ante 3500
hichnick777: posts the ante 3500
ZamoS89: posts the ante 3500
Laska_Lisa: posts the ante 3500
4time2warp0: posts small blind 17500
lupninox: posts big blind 35000
*** HOLE CARDS ***
Dealt to hichnick777 [7h Qd]
marval231: folds
hichnick777: folds
ZamoS89: folds
Laska_Lisa: folds
dogBq: folds
blackaces93: folds
siggins22: raises 70000 to 105000
4time2warp0: folds
lupninox: folds
Uncalled bet (70000) returned to siggins22
siggins22 collected 119000 from pot
siggins22: doesn't show hand
*** SUMMARY ***
Total pot 119000 | Rake 0
Seat 1: dogBq folded before Flop (didn't bet)
Seat 2: blackaces93 folded before Flop (didn't bet)
Seat 3: siggins22 (button) collected (119000)
Seat 4: 4time2warp0 (small blind) folded before Flop
Seat 5: lupninox (big blind) folded before Flop
Seat 6: marval231 folded before Flop (didn't bet)
Seat 7: hichnick777 folded before Flop (didn't bet)
Seat 8: ZamoS89 folded before Flop (didn't bet)
Seat 9: Laska_Lisa folded before Flop (didn't bet)


*********** # 309 **************
PokerStars Hand #176679378150: Tournament #2054568934, $20+$2 USD Hold'em No Limit - Level XXXIV (17500/35000) - 2017/10/09 5:28:33 MSK [2017/10/08 22:28:33 ET]
Table '2054568934 598' 9-max Seat #4 is the button
Seat 1: dogBq (892396 in chips)
Seat 2: blackaces93 (3390309 in chips)
Seat 3: siggins22 (921551 in chips)
Seat 4: 4time2warp0 (585656 in chips)
Seat 5: lupninox (1344651 in chips)
Seat 6: marval231 (176199 in chips)
Seat 7: hichnick777 (985948 in chips)
Seat 8: ZamoS89 (482684 in chips)
Seat 9: Laska_Lisa (784922 in chips)
dogBq: posts the ante 3500
blackaces93: posts the ante 3500
siggins22: posts the ante 3500
4time2warp0: posts the ante 3500
lupninox: posts the ante 3500
marval231: posts the ante 3500
hichnick777: posts the ante 3500
ZamoS89: posts the ante 3500
Laska_Lisa: posts the ante 3500
lupninox: posts small blind 17500
marval231: posts big blind 35000
*** HOLE CARDS ***
Dealt to hichnick777 [8s 3d]
hichnick777: folds
ZamoS89: folds
Laska_Lisa: folds
dogBq: folds
blackaces93: folds
siggins22: raises 70000 to 105000
4time2warp0: folds
lupninox: folds
marval231: folds
Uncalled bet (70000) returned to siggins22
siggins22 collected 119000 from pot
siggins22: doesn't show hand
*** SUMMARY ***
Total pot 119000 | Rake 0
Seat 1: dogBq folded before Flop (didn't bet)
Seat 2: blackaces93 folded before Flop (didn't bet)
Seat 3: siggins22 collected (119000)
Seat 4: 4time2warp0 (button) folded before Flop (didn't bet)
Seat 5: lupninox (small blind) folded before Flop
Seat 6: marval231 (big blind) folded before Flop
Seat 7: hichnick777 folded before Flop (didn't bet)
Seat 8: ZamoS89 folded before Flop (didn't bet)
Seat 9: Laska_Lisa folded before Flop (didn't bet)


*********** # 310 **************
PokerStars Hand #176679391537: Tournament #2054568934, $20+$2 USD Hold'em No Limit - Level XXXIV (17500/35000) - 2017/10/09 5:29:15 MSK [2017/10/08 22:29:15 ET]
Table '2054568934 598' 9-max Seat #5 is the button
Seat 1: dogBq (888896 in chips)
Seat 2: blackaces93 (3386809 in chips)
Seat 3: siggins22 (1002051 in chips)
Seat 4: 4time2warp0 (582156 in chips)
Seat 5: lupninox (1323651 in chips)
Seat 6: marval231 (137699 in chips)
Seat 7: hichnick777 (982448 in chips)
Seat 8: ZamoS89 (479184 in chips)
Seat 9: Laska_Lisa (781422 in chips)
dogBq: posts the ante 3500
blackaces93: posts the ante 3500
siggins22: posts the ante 3500
4time2warp0: posts the ante 3500
lupninox: posts the ante 3500
marval231: posts the ante 3500
hichnick777: posts the ante 3500
ZamoS89: posts the ante 3500
Laska_Lisa: posts the ante 3500
marval231: posts small blind 17500
hichnick777: posts big blind 35000
*** HOLE CARDS ***
Dealt to hichnick777 [6c 3h]
ZamoS89: folds
Laska_Lisa: folds
dogBq: folds
blackaces93: raises 37450 to 72450
siggins22: folds
4time2warp0: folds
lupninox: folds
marval231: raises 61749 to 134199 and is all-in
hichnick777: folds
blackaces93: calls 61749
*** FLOP *** [9s Ks Js]
*** TURN *** [9s Ks Js] [Jd]
*** RIVER *** [9s Ks Js Jd] [As]
*** SHOW DOWN ***
marval231: shows [Qd Qh] (two pair, Queens and Jacks)
blackaces93: shows [7s 5s] (a flush, Ace high)
blackaces93 collected 334898 from pot
marval231 finished the tournament in 80th place and received $125.06.
*** SUMMARY ***
Total pot 334898 | Rake 0
Board [9s Ks Js Jd As]
Seat 1: dogBq folded before Flop (didn't bet)
Seat 2: blackaces93 showed [7s 5s] and won (334898) with a flush, Ace high
Seat 3: siggins22 folded before Flop (didn't bet)
Seat 4: 4time2warp0 folded before Flop (didn't bet)
Seat 5: lupninox (button) folded before Flop (didn't bet)
Seat 6: marval231 (small blind) showed [Qd Qh] and lost with two pair, Queens and Jacks
Seat 7: hichnick777 (big blind) folded before Flop
Seat 8: ZamoS89 folded before Flop (didn't bet)
Seat 9: Laska_Lisa folded before Flop (didn't bet)


*********** # 311 **************
PokerStars Hand #176679403483: Tournament #2054568934, $20+$2 USD Hold'em No Limit - Level XXXIV (17500/35000) - 2017/10/09 5:29:53 MSK [2017/10/08 22:29:53 ET]
Table '2054568934 598' 9-max Seat #7 is the button
Seat 1: dogBq (885396 in chips)
Seat 2: blackaces93 (3584008 in chips)
Seat 3: siggins22 (998551 in chips)
Seat 4: 4time2warp0 (578656 in chips)
Seat 5: lupninox (1320151 in chips)
Seat 7: hichnick777 (943948 in chips)
Seat 8: ZamoS89 (475684 in chips)
Seat 9: Laska_Lisa (777922 in chips)
dogBq: posts the ante 3500
blackaces93: posts the ante 3500
siggins22: posts the ante 3500
4time2warp0: posts the ante 3500
lupninox: posts the ante 3500
hichnick777: posts the ante 3500
ZamoS89: posts the ante 3500
Laska_Lisa: posts the ante 3500
ZamoS89: posts small blind 17500
Laska_Lisa: posts big blind 35000
*** HOLE CARDS ***
Dealt to hichnick777 [Js Qc]
dogBq: folds
blackaces93: folds
siggins22: folds
4time2warp0: raises 540156 to 575156 and is all-in
lupninox: raises 741495 to 1316651 and is all-in
hichnick777: folds
ZamoS89: folds
Laska_Lisa: folds
Uncalled bet (741495) returned to lupninox
*** FLOP *** [9d Kc 3c]
*** TURN *** [9d Kc 3c] [8h]
*** RIVER *** [9d Kc 3c 8h] [5d]
*** SHOW DOWN ***
4time2warp0: shows [Ac Kd] (a pair of Kings)
lupninox: shows [Qh Qs] (a pair of Queens)
4time2warp0 collected 1230812 from pot
*** SUMMARY ***
Total pot 1230812 | Rake 0
Board [9d Kc 3c 8h 5d]
Seat 1: dogBq folded before Flop (didn't bet)
Seat 2: blackaces93 folded before Flop (didn't bet)
Seat 3: siggins22 folded before Flop (didn't bet)
Seat 4: 4time2warp0 showed [Ac Kd] and won (1230812) with a pair of Kings
Seat 5: lupninox showed [Qh Qs] and lost with a pair of Queens
Seat 7: hichnick777 (button) folded before Flop (didn't bet)
Seat 8: ZamoS89 (small blind) folded before Flop
Seat 9: Laska_Lisa (big blind) folded before Flop


*********** # 312 **************
PokerStars Hand #176679414117: Tournament #2054568934, $20+$2 USD Hold'em No Limit - Level XXXIV (17500/35000) - 2017/10/09 5:30:27 MSK [2017/10/08 22:30:27 ET]
Table '2054568934 598' 9-max Seat #8 is the button
Seat 1: dogBq (881896 in chips)
Seat 2: blackaces93 (3580508 in chips)
Seat 3: siggins22 (995051 in chips)
Seat 4: 4time2warp0 (1230812 in chips)
Seat 5: lupninox (741495 in chips)
Seat 7: hichnick777 (940448 in chips)
Seat 8: ZamoS89 (454684 in chips)
Seat 9: Laska_Lisa (739422 in chips)
dogBq: posts the ante 3500
blackaces93: posts the ante 3500
siggins22: posts the ante 3500
4time2warp0: posts the ante 3500
lupninox: posts the ante 3500
hichnick777: posts the ante 3500
ZamoS89: posts the ante 3500
Laska_Lisa: posts the ante 3500
Laska_Lisa: posts small blind 17500
dogBq: posts big blind 35000
*** HOLE CARDS ***
Dealt to hichnick777 [Ac 5h]
blackaces93: folds
siggins22: raises 52500 to 87500
4time2warp0: folds
lupninox: folds
hichnick777: folds
ZamoS89: folds
Laska_Lisa: folds
dogBq: folds
Uncalled bet (52500) returned to siggins22
siggins22 collected 115500 from pot
siggins22: doesn't show hand
*** SUMMARY ***
Total pot 115500 | Rake 0
Seat 1: dogBq (big blind) folded before Flop
Seat 2: blackaces93 folded before Flop (didn't bet)
Seat 3: siggins22 collected (115500)
Seat 4: 4time2warp0 folded before Flop (didn't bet)
Seat 5: lupninox folded before Flop (didn't bet)
Seat 7: hichnick777 folded before Flop (didn't bet)
Seat 8: ZamoS89 (button) folded before Flop (didn't bet)
Seat 9: Laska_Lisa (small blind) folded before Flop


*********** # 313 **************
PokerStars Hand #176679423836: Tournament #2054568934, $20+$2 USD Hold'em No Limit - Level XXXIV (17500/35000) - 2017/10/09 5:30:57 MSK [2017/10/08 22:30:57 ET]
Table '2054568934 598' 9-max Seat #9 is the button
Seat 1: dogBq (843396 in chips)
Seat 2: blackaces93 (3577008 in chips)
Seat 3: siggins22 (1072051 in chips)
Seat 4: 4time2warp0 (1227312 in chips)
Seat 5: lupninox (737995 in chips)
Seat 7: hichnick777 (936948 in chips)
Seat 8: ZamoS89 (451184 in chips)
Seat 9: Laska_Lisa (718422 in chips)
dogBq: posts the ante 3500
blackaces93: posts the ante 3500
siggins22: posts the ante 3500
4time2warp0: posts the ante 3500
lupninox: posts the ante 3500
hichnick777: posts the ante 3500
ZamoS89: posts the ante 3500
Laska_Lisa: posts the ante 3500
dogBq: posts small blind 17500
blackaces93: posts big blind 35000
*** HOLE CARDS ***
Dealt to hichnick777 [6c 7h]
siggins22: folds
4time2warp0: folds
lupninox: folds
hichnick777: folds
ZamoS89: folds
Laska_Lisa: raises 70000 to 105000
dogBq: folds
blackaces93: raises 3468508 to 3573508 and is all-in
Laska_Lisa: calls 609922 and is all-in
Uncalled bet (2858586) returned to blackaces93
*** FLOP *** [2c 3c Ac]
*** TURN *** [2c 3c Ac] [4c]
*** RIVER *** [2c 3c Ac 4c] [8d]
*** SHOW DOWN ***
blackaces93: shows [As Jc] (a flush, Ace high)
Laska_Lisa: shows [Ah Th] (a pair of Aces)
blackaces93 collected 1475344 from pot
Laska_Lisa finished the tournament in 75th place and received $125.06.
*** SUMMARY ***
Total pot 1475344 | Rake 0
Board [2c 3c Ac 4c 8d]
Seat 1: dogBq (small blind) folded before Flop
Seat 2: blackaces93 (big blind) showed [As Jc] and won (1475344) with a flush, Ace high
Seat 3: siggins22 folded before Flop (didn't bet)
Seat 4: 4time2warp0 folded before Flop (didn't bet)
Seat 5: lupninox folded before Flop (didn't bet)
Seat 7: hichnick777 folded before Flop (didn't bet)
Seat 8: ZamoS89 folded before Flop (didn't bet)
Seat 9: Laska_Lisa (button) showed [Ah Th] and lost with a pair of Aces


*********** # 314 **************
PokerStars Hand #176679439557: Tournament #2054568934, $20+$2 USD Hold'em No Limit - Level XXXIV (17500/35000) - 2017/10/09 5:31:47 MSK [2017/10/08 22:31:47 ET]
Table '2054568934 598' 9-max Seat #1 is the button
Seat 1: dogBq (822396 in chips)
Seat 2: blackaces93 (4333930 in chips)
Seat 3: siggins22 (1068551 in chips)
Seat 4: 4time2warp0 (1223812 in chips)
Seat 5: lupninox (734495 in chips)
Seat 7: hichnick777 (933448 in chips)
Seat 8: ZamoS89 (447684 in chips)
dogBq: posts the ante 3500
blackaces93: posts the ante 3500
siggins22: posts the ante 3500
4time2warp0: posts the ante 3500
lupninox: posts the ante 3500
hichnick777: posts the ante 3500
ZamoS89: posts the ante 3500
blackaces93: posts small blind 17500
siggins22: posts big blind 35000
*** HOLE CARDS ***
Dealt to hichnick777 [4s Ts]
4time2warp0: folds
lupninox: folds
hichnick777: folds
ZamoS89: raises 409184 to 444184 and is all-in
dogBq: folds
blackaces93: folds
siggins22: folds
Uncalled bet (409184) returned to ZamoS89
ZamoS89 collected 112000 from pot
*** SUMMARY ***
Total pot 112000 | Rake 0
Seat 1: dogBq (button) folded before Flop (didn't bet)
Seat 2: blackaces93 (small blind) folded before Flop
Seat 3: siggins22 (big blind) folded before Flop
Seat 4: 4time2warp0 folded before Flop (didn't bet)
Seat 5: lupninox folded before Flop (didn't bet)
Seat 7: hichnick777 folded before Flop (didn't bet)
Seat 8: ZamoS89 collected (112000)


*********** # 315 **************
PokerStars Hand #176679448129: Tournament #2054568934, $20+$2 USD Hold'em No Limit - Level XXXIV (17500/35000) - 2017/10/09 5:32:14 MSK [2017/10/08 22:32:14 ET]
Table '2054568934 598' 9-max Seat #2 is the button
Seat 1: dogBq (818896 in chips)
Seat 2: blackaces93 (4312930 in chips)
Seat 3: siggins22 (1030051 in chips)
Seat 4: 4time2warp0 (1220312 in chips)
Seat 5: lupninox (730995 in chips)
Seat 7: hichnick777 (929948 in chips)
Seat 8: ZamoS89 (521184 in chips)
Seat 9: TeddyKGB027 (2934975 in chips)
dogBq: posts the ante 3500
blackaces93: posts the ante 3500
siggins22: posts the ante 3500
4time2warp0: posts the ante 3500
lupninox: posts the ante 3500
hichnick777: posts the ante 3500
ZamoS89: posts the ante 3500
TeddyKGB027: posts the ante 3500
siggins22: posts small blind 17500
4time2warp0: posts big blind 35000
*** HOLE CARDS ***
Dealt to hichnick777 [6s 3h]
lupninox: folds
hichnick777: folds
ZamoS89: folds
TeddyKGB027: folds
dogBq: folds
blackaces93: folds
siggins22: folds
Uncalled bet (17500) returned to 4time2warp0
4time2warp0 collected 63000 from pot
4time2warp0: doesn't show hand
*** SUMMARY ***
Total pot 63000 | Rake 0
Seat 1: dogBq folded before Flop (didn't bet)
Seat 2: blackaces93 (button) folded before Flop (didn't bet)
Seat 3: siggins22 (small blind) folded before Flop
Seat 4: 4time2warp0 (big blind) collected (63000)
Seat 5: lupninox folded before Flop (didn't bet)
Seat 7: hichnick777 folded before Flop (didn't bet)
Seat 8: ZamoS89 folded before Flop (didn't bet)
Seat 9: TeddyKGB027 folded before Flop (didn't bet)


*********** # 316 **************
PokerStars Hand #176679456241: Tournament #2054568934, $20+$2 USD Hold'em No Limit - Level XXXIV (17500/35000) - 2017/10/09 5:32:40 MSK [2017/10/08 22:32:40 ET]
Table '2054568934 598' 9-max Seat #3 is the button
Seat 1: dogBq (815396 in chips)
Seat 2: blackaces93 (4309430 in chips)
Seat 3: siggins22 (1009051 in chips)
Seat 4: 4time2warp0 (1262312 in chips)
Seat 5: lupninox (727495 in chips)
Seat 7: hichnick777 (926448 in chips)
Seat 8: ZamoS89 (517684 in chips)
Seat 9: TeddyKGB027 (2931475 in chips)
dogBq: posts the ante 3500
blackaces93: posts the ante 3500
siggins22: posts the ante 3500
4time2warp0: posts the ante 3500
lupninox: posts the ante 3500
hichnick777: posts the ante 3500
ZamoS89: posts the ante 3500
TeddyKGB027: posts the ante 3500
4time2warp0: posts small blind 17500
lupninox: posts big blind 35000
*** HOLE CARDS ***
Dealt to hichnick777 [3c 4d]
hichnick777: folds
ZamoS89: folds
TeddyKGB027: folds
dogBq: raises 55000 to 90000
blackaces93: folds
siggins22: calls 90000
4time2warp0: folds
lupninox: folds
*** FLOP *** [Qd Jc As]
dogBq: checks
siggins22: checks
*** TURN *** [Qd Jc As] [8d]
dogBq: checks
siggins22: checks
*** RIVER *** [Qd Jc As 8d] [9s]
dogBq: checks
siggins22: checks
*** SHOW DOWN ***
dogBq: shows [Js Ks] (a pair of Jacks)
siggins22: shows [Qc 9c] (two pair, Queens and Nines)
siggins22 collected 260500 from pot
*** SUMMARY ***
Total pot 260500 | Rake 0
Board [Qd Jc As 8d 9s]
Seat 1: dogBq showed [Js Ks] and lost with a pair of Jacks
Seat 2: blackaces93 folded before Flop (didn't bet)
Seat 3: siggins22 (button) showed [Qc 9c] and won (260500) with two pair, Queens and Nines
Seat 4: 4time2warp0 (small blind) folded before Flop
Seat 5: lupninox (big blind) folded before Flop
Seat 7: hichnick777 folded before Flop (didn't bet)
Seat 8: ZamoS89 folded before Flop (didn't bet)
Seat 9: TeddyKGB027 folded before Flop (didn't bet)


*********** # 317 **************
PokerStars Hand #176679475886: Tournament #2054568934, $20+$2 USD Hold'em No Limit - Level XXXIV (17500/35000) - 2017/10/09 5:33:43 MSK [2017/10/08 22:33:43 ET]
Table '2054568934 598' 9-max Seat #4 is the button
Seat 1: dogBq (721896 in chips)
Seat 2: blackaces93 (4305930 in chips)
Seat 3: siggins22 (1176051 in chips)
Seat 4: 4time2warp0 (1241312 in chips)
Seat 5: lupninox (688995 in chips)
Seat 7: hichnick777 (922948 in chips)
Seat 8: ZamoS89 (514184 in chips)
Seat 9: TeddyKGB027 (2927975 in chips)
dogBq: posts the ante 3500
blackaces93: posts the ante 3500
siggins22: posts the ante 3500
4time2warp0: posts the ante 3500
lupninox: posts the ante 3500
hichnick777: posts the ante 3500
ZamoS89: posts the ante 3500
TeddyKGB027: posts the ante 3500
lupninox: posts small blind 17500
hichnick777: posts big blind 35000
*** HOLE CARDS ***
Dealt to hichnick777 [9c 7s]
ZamoS89: folds
TeddyKGB027: folds
dogBq: folds
blackaces93: raises 37770 to 72770
siggins22: folds
4time2warp0: folds
lupninox: folds
hichnick777: calls 37770
*** FLOP *** [5h Qc Ad]
hichnick777: checks
blackaces93: bets 55685
hichnick777: folds
Uncalled bet (55685) returned to blackaces93
blackaces93 collected 191040 from pot
blackaces93: doesn't show hand
*** SUMMARY ***
Total pot 191040 | Rake 0
Board [5h Qc Ad]
Seat 1: dogBq folded before Flop (didn't bet)
Seat 2: blackaces93 collected (191040)
Seat 3: siggins22 folded before Flop (didn't bet)
Seat 4: 4time2warp0 (button) folded before Flop (didn't bet)
Seat 5: lupninox (small blind) folded before Flop
Seat 7: hichnick777 (big blind) folded on the Flop
Seat 8: ZamoS89 folded before Flop (didn't bet)
Seat 9: TeddyKGB027 folded before Flop (didn't bet)


*********** # 318 **************
PokerStars Hand #176679494369: Tournament #2054568934, $20+$2 USD Hold'em No Limit - Level XXXIV (17500/35000) - 2017/10/09 5:34:41 MSK [2017/10/08 22:34:41 ET]
Table '2054568934 598' 9-max Seat #5 is the button
Seat 1: dogBq (718396 in chips)
Seat 2: blackaces93 (4420700 in chips)
Seat 3: siggins22 (1172551 in chips)
Seat 4: 4time2warp0 (1237812 in chips)
Seat 5: lupninox (667995 in chips)
Seat 7: hichnick777 (846678 in chips)
Seat 8: ZamoS89 (510684 in chips)
Seat 9: TeddyKGB027 (2924475 in chips)
dogBq: posts the ante 3500
blackaces93: posts the ante 3500
siggins22: posts the ante 3500
4time2warp0: posts the ante 3500
lupninox: posts the ante 3500
hichnick777: posts the ante 3500
ZamoS89: posts the ante 3500
TeddyKGB027: posts the ante 3500
hichnick777: posts small blind 17500
ZamoS89: posts big blind 35000
*** HOLE CARDS ***
Dealt to hichnick777 [Th Kh]
TeddyKGB027: folds
dogBq: folds
blackaces93: raises 39450 to 74450
siggins22: calls 74450
4time2warp0: folds
lupninox: folds
hichnick777: calls 56950
ZamoS89: calls 39450
*** FLOP *** [Qs 4h 5c]
hichnick777: checks
ZamoS89: checks
blackaces93: checks
siggins22: bets 125555
hichnick777: folds
ZamoS89: folds
blackaces93: folds
Uncalled bet (125555) returned to siggins22
siggins22 collected 325800 from pot
siggins22: doesn't show hand
*** SUMMARY ***
Total pot 325800 | Rake 0
Board [Qs 4h 5c]
Seat 1: dogBq folded before Flop (didn't bet)
Seat 2: blackaces93 folded on the Flop
Seat 3: siggins22 collected (325800)
Seat 4: 4time2warp0 folded before Flop (didn't bet)
Seat 5: lupninox (button) folded before Flop (didn't bet)
Seat 7: hichnick777 (small blind) folded on the Flop
Seat 8: ZamoS89 (big blind) folded on the Flop
Seat 9: TeddyKGB027 folded before Flop (didn't bet)


*********** # 319 **************
PokerStars Hand #176679521493: Tournament #2054568934, $20+$2 USD Hold'em No Limit - Level XXXIV (17500/35000) - 2017/10/09 5:36:08 MSK [2017/10/08 22:36:08 ET]
Table '2054568934 598' 9-max Seat #7 is the button
Seat 1: dogBq (714896 in chips)
Seat 2: blackaces93 (4342750 in chips)
Seat 3: siggins22 (1420401 in chips)
Seat 4: 4time2warp0 (1234312 in chips)
Seat 5: lupninox (664495 in chips)
Seat 7: hichnick777 (768728 in chips)
Seat 8: ZamoS89 (432734 in chips)
Seat 9: TeddyKGB027 (2920975 in chips)
dogBq: posts the ante 3500
blackaces93: posts the ante 3500
siggins22: posts the ante 3500
4time2warp0: posts the ante 3500
lupninox: posts the ante 3500
hichnick777: posts the ante 3500
ZamoS89: posts the ante 3500
TeddyKGB027: posts the ante 3500
ZamoS89: posts small blind 17500
TeddyKGB027: posts big blind 35000
*** HOLE CARDS ***
Dealt to hichnick777 [7c 6d]
dogBq: folds
blackaces93: folds
siggins22: folds
4time2warp0: folds
lupninox: folds
hichnick777: folds
ZamoS89: raises 394234 to 429234 and is all-in
TeddyKGB027: folds
Uncalled bet (394234) returned to ZamoS89
ZamoS89 collected 98000 from pot
*** SUMMARY ***
Total pot 98000 | Rake 0
Seat 1: dogBq folded before Flop (didn't bet)
Seat 2: blackaces93 folded before Flop (didn't bet)
Seat 3: siggins22 folded before Flop (didn't bet)
Seat 4: 4time2warp0 folded before Flop (didn't bet)
Seat 5: lupninox folded before Flop (didn't bet)
Seat 7: hichnick777 (button) folded before Flop (didn't bet)
Seat 8: ZamoS89 (small blind) collected (98000)
Seat 9: TeddyKGB027 (big blind) folded before Flop


*********** # 320 **************
PokerStars Hand #176679534796: Tournament #2054568934, $20+$2 USD Hold'em No Limit - Level XXXIV (17500/35000) - 2017/10/09 5:36:51 MSK [2017/10/08 22:36:51 ET]
Table '2054568934 598' 9-max Seat #8 is the button
Seat 1: dogBq (711396 in chips)
Seat 2: blackaces93 (4339250 in chips)
Seat 3: siggins22 (1416901 in chips)
Seat 4: 4time2warp0 (1230812 in chips)
Seat 5: lupninox (660995 in chips)
Seat 7: hichnick777 (765228 in chips)
Seat 8: ZamoS89 (492234 in chips)
Seat 9: TeddyKGB027 (2882475 in chips)
dogBq: posts the ante 3500
blackaces93: posts the ante 3500
siggins22: posts the ante 3500
4time2warp0: posts the ante 3500
lupninox: posts the ante 3500
hichnick777: posts the ante 3500
ZamoS89: posts the ante 3500
TeddyKGB027: posts the ante 3500
TeddyKGB027: posts small blind 17500
dogBq: posts big blind 35000
*** HOLE CARDS ***
Dealt to hichnick777 [3d Ad]
blackaces93: folds
siggins22: folds
4time2warp0: folds
lupninox: folds
hichnick777: raises 37800 to 72800
ZamoS89: raises 415934 to 488734 and is all-in
TeddyKGB027: folds
dogBq: folds
hichnick777: folds
Uncalled bet (415934) returned to ZamoS89
ZamoS89 collected 226100 from pot
*** SUMMARY ***
Total pot 226100 | Rake 0
Seat 1: dogBq (big blind) folded before Flop
Seat 2: blackaces93 folded before Flop (didn't bet)
Seat 3: siggins22 folded before Flop (didn't bet)
Seat 4: 4time2warp0 folded before Flop (didn't bet)
Seat 5: lupninox folded before Flop (didn't bet)
Seat 7: hichnick777 folded before Flop
Seat 8: ZamoS89 (button) collected (226100)
Seat 9: TeddyKGB027 (small blind) folded before Flop


*********** # 321 **************
PokerStars Hand #176679552386: Tournament #2054568934, $20+$2 USD Hold'em No Limit - Level XXXV (20000/40000) - 2017/10/09 5:37:47 MSK [2017/10/08 22:37:47 ET]
Table '2054568934 598' 9-max Seat #9 is the button
Seat 1: dogBq (672896 in chips)
Seat 2: blackaces93 (4335750 in chips)
Seat 3: siggins22 (1413401 in chips)
Seat 4: 4time2warp0 (1227312 in chips)
Seat 5: lupninox (657495 in chips)
Seat 6: garwoody777 (580942 in chips)
Seat 7: hichnick777 (688928 in chips)
Seat 8: ZamoS89 (642034 in chips)
Seat 9: TeddyKGB027 (2861475 in chips)
dogBq: posts the ante 4000
blackaces93: posts the ante 4000
siggins22: posts the ante 4000
4time2warp0: posts the ante 4000
lupninox: posts the ante 4000
garwoody777: posts the ante 4000
hichnick777: posts the ante 4000
ZamoS89: posts the ante 4000
TeddyKGB027: posts the ante 4000
dogBq: posts small blind 20000
blackaces93: posts big blind 40000
*** HOLE CARDS ***
Dealt to hichnick777 [Ks Qd]
siggins22: raises 60000 to 100000
4time2warp0: folds
lupninox: folds
garwoody777: folds
hichnick777: folds
ZamoS89: folds
TeddyKGB027: folds
dogBq: folds
blackaces93: calls 60000
*** FLOP *** [Kd Tc 7h]
blackaces93: checks
siggins22: bets 110000
blackaces93: folds
Uncalled bet (110000) returned to siggins22
siggins22 collected 256000 from pot
siggins22: doesn't show hand
*** SUMMARY ***
Total pot 256000 | Rake 0
Board [Kd Tc 7h]
Seat 1: dogBq (small blind) folded before Flop
Seat 2: blackaces93 (big blind) folded on the Flop
Seat 3: siggins22 collected (256000)
Seat 4: 4time2warp0 folded before Flop (didn't bet)
Seat 5: lupninox folded before Flop (didn't bet)
Seat 6: garwoody777 folded before Flop (didn't bet)
Seat 7: hichnick777 folded before Flop (didn't bet)
Seat 8: ZamoS89 folded before Flop (didn't bet)
Seat 9: TeddyKGB027 (button) folded before Flop (didn't bet)


*********** # 322 **************
PokerStars Hand #176679579993: Tournament #2054568934, $20+$2 USD Hold'em No Limit - Level XXXV (20000/40000) - 2017/10/09 5:38:56 MSK [2017/10/08 22:38:56 ET]
Table '2054568934 598' 9-max Seat #1 is the button
Seat 1: dogBq (648896 in chips)
Seat 2: blackaces93 (4231750 in chips)
Seat 3: siggins22 (1565401 in chips)
Seat 4: 4time2warp0 (1223312 in chips)
Seat 5: lupninox (653495 in chips)
Seat 6: garwoody777 (576942 in chips)
Seat 7: hichnick777 (684928 in chips)
Seat 8: ZamoS89 (638034 in chips)
Seat 9: TeddyKGB027 (2857475 in chips)
dogBq: posts the ante 4000
blackaces93: posts the ante 4000
siggins22: posts the ante 4000
4time2warp0: posts the ante 4000
lupninox: posts the ante 4000
garwoody777: posts the ante 4000
hichnick777: posts the ante 4000
ZamoS89: posts the ante 4000
TeddyKGB027: posts the ante 4000
blackaces93: posts small blind 20000
siggins22: posts big blind 40000
*** HOLE CARDS ***
Dealt to hichnick777 [Ts Qh]
4time2warp0: folds
lupninox: folds
garwoody777: folds
hichnick777: folds
ZamoS89: folds
TeddyKGB027: folds
dogBq: folds
blackaces93: raises 68788 to 108788
siggins22: calls 68788
*** FLOP *** [Jh Kd 8s]
blackaces93: bets 93823
siggins22: folds
Uncalled bet (93823) returned to blackaces93
blackaces93 collected 253576 from pot
blackaces93: doesn't show hand
*** SUMMARY ***
Total pot 253576 | Rake 0
Board [Jh Kd 8s]
Seat 1: dogBq (button) folded before Flop (didn't bet)
Seat 2: blackaces93 (small blind) collected (253576)
Seat 3: siggins22 (big blind) folded on the Flop
Seat 4: 4time2warp0 folded before Flop (didn't bet)
Seat 5: lupninox folded before Flop (didn't bet)
Seat 6: garwoody777 folded before Flop (didn't bet)
Seat 7: hichnick777 folded before Flop (didn't bet)
Seat 8: ZamoS89 folded before Flop (didn't bet)
Seat 9: TeddyKGB027 folded before Flop (didn't bet)


*********** # 323 **************
PokerStars Hand #176679601937: Tournament #2054568934, $20+$2 USD Hold'em No Limit - Level XXXV (20000/40000) - 2017/10/09 5:40:07 MSK [2017/10/08 22:40:07 ET]
Table '2054568934 598' 9-max Seat #2 is the button
Seat 1: dogBq (644896 in chips)
Seat 2: blackaces93 (4372538 in chips)
Seat 3: siggins22 (1452613 in chips)
Seat 4: 4time2warp0 (1219312 in chips)
Seat 5: lupninox (649495 in chips)
Seat 6: garwoody777 (572942 in chips)
Seat 7: hichnick777 (680928 in chips)
Seat 8: ZamoS89 (634034 in chips)
Seat 9: TeddyKGB027 (2853475 in chips)
dogBq: posts the ante 4000
blackaces93: posts the ante 4000
siggins22: posts the ante 4000
4time2warp0: posts the ante 4000
lupninox: posts the ante 4000
garwoody777: posts the ante 4000
hichnick777: posts the ante 4000
ZamoS89: posts the ante 4000
TeddyKGB027: posts the ante 4000
siggins22: posts small blind 20000
4time2warp0: posts big blind 40000
*** HOLE CARDS ***
Dealt to hichnick777 [7c 4h]
lupninox: folds
garwoody777: folds
hichnick777: folds
ZamoS89: folds
TeddyKGB027: folds
dogBq: folds
blackaces93: folds
siggins22: raises 60000 to 100000
4time2warp0: calls 60000
*** FLOP *** [6h Ts 2c]
siggins22: bets 118000
4time2warp0: raises 118000 to 236000
siggins22: folds
Uncalled bet (118000) returned to 4time2warp0
4time2warp0 collected 472000 from pot
4time2warp0: doesn't show hand
*** SUMMARY ***
Total pot 472000 | Rake 0
Board [6h Ts 2c]
Seat 1: dogBq folded before Flop (didn't bet)
Seat 2: blackaces93 (button) folded before Flop (didn't bet)
Seat 3: siggins22 (small blind) folded on the Flop
Seat 4: 4time2warp0 (big blind) collected (472000)
Seat 5: lupninox folded before Flop (didn't bet)
Seat 6: garwoody777 folded before Flop (didn't bet)
Seat 7: hichnick777 folded before Flop (didn't bet)
Seat 8: ZamoS89 folded before Flop (didn't bet)
Seat 9: TeddyKGB027 folded before Flop (didn't bet)


*********** # 324 **************
PokerStars Hand #176679621722: Tournament #2054568934, $20+$2 USD Hold'em No Limit - Level XXXV (20000/40000) - 2017/10/09 5:41:12 MSK [2017/10/08 22:41:12 ET]
Table '2054568934 598' 9-max Seat #3 is the button
Seat 1: dogBq (640896 in chips)
Seat 2: blackaces93 (4368538 in chips)
Seat 3: siggins22 (1230613 in chips)
Seat 4: 4time2warp0 (1469312 in chips)
Seat 5: lupninox (645495 in chips)
Seat 6: garwoody777 (568942 in chips)
Seat 7: hichnick777 (676928 in chips)
Seat 8: ZamoS89 (630034 in chips)
Seat 9: TeddyKGB027 (2849475 in chips)
dogBq: posts the ante 4000
blackaces93: posts the ante 4000
siggins22: posts the ante 4000
4time2warp0: posts the ante 4000
lupninox: posts the ante 4000
garwoody777: posts the ante 4000
hichnick777: posts the ante 4000
ZamoS89: posts the ante 4000
TeddyKGB027: posts the ante 4000
4time2warp0: posts small blind 20000
lupninox: posts big blind 40000
*** HOLE CARDS ***
Dealt to hichnick777 [2h Qs]
garwoody777: folds
hichnick777: folds
ZamoS89: folds
TeddyKGB027: folds
dogBq: folds
blackaces93: folds
siggins22: raises 60000 to 100000
4time2warp0: folds
lupninox: raises 541495 to 641495 and is all-in
siggins22: calls 541495
*** FLOP *** [9s 3d 2c]
*** TURN *** [9s 3d 2c] [3s]
*** RIVER *** [9s 3d 2c 3s] [7s]
*** SHOW DOWN ***
lupninox: shows [Jh Ah] (a pair of Threes)
siggins22: shows [Tc As] (a pair of Threes - lower kicker)
lupninox collected 1338990 from pot
*** SUMMARY ***
Total pot 1338990 | Rake 0
Board [9s 3d 2c 3s 7s]
Seat 1: dogBq folded before Flop (didn't bet)
Seat 2: blackaces93 folded before Flop (didn't bet)
Seat 3: siggins22 (button) showed [Tc As] and lost with a pair of Threes
Seat 4: 4time2warp0 (small blind) folded before Flop
Seat 5: lupninox (big blind) showed [Jh Ah] and won (1338990) with a pair of Threes
Seat 6: garwoody777 folded before Flop (didn't bet)
Seat 7: hichnick777 folded before Flop (didn't bet)
Seat 8: ZamoS89 folded before Flop (didn't bet)
Seat 9: TeddyKGB027 folded before Flop (didn't bet)


*********** # 325 **************
PokerStars Hand #176679640010: Tournament #2054568934, $20+$2 USD Hold'em No Limit - Level XXXV (20000/40000) - 2017/10/09 5:42:11 MSK [2017/10/08 22:42:11 ET]
Table '2054568934 598' 9-max Seat #4 is the button
Seat 1: dogBq (636896 in chips)
Seat 2: blackaces93 (4364538 in chips)
Seat 3: siggins22 (585118 in chips)
Seat 4: 4time2warp0 (1445312 in chips)
Seat 5: lupninox (1338990 in chips)
Seat 6: garwoody777 (564942 in chips)
Seat 7: hichnick777 (672928 in chips)
Seat 8: ZamoS89 (626034 in chips)
Seat 9: TeddyKGB027 (2845475 in chips)
dogBq: posts the ante 4000
blackaces93: posts the ante 4000
siggins22: posts the ante 4000
4time2warp0: posts the ante 4000
lupninox: posts the ante 4000
garwoody777: posts the ante 4000
hichnick777: posts the ante 4000
ZamoS89: posts the ante 4000
TeddyKGB027: posts the ante 4000
lupninox: posts small blind 20000
garwoody777: posts big blind 40000
*** HOLE CARDS ***
Dealt to hichnick777 [2h Th]
hichnick777: folds
ZamoS89: folds
TeddyKGB027: folds
dogBq: folds
blackaces93: raises 42770 to 82770
siggins22: folds
4time2warp0: folds
lupninox: folds
garwoody777: folds
Uncalled bet (42770) returned to blackaces93
blackaces93 collected 136000 from pot
blackaces93: doesn't show hand
*** SUMMARY ***
Total pot 136000 | Rake 0
Seat 1: dogBq folded before Flop (didn't bet)
Seat 2: blackaces93 collected (136000)
Seat 3: siggins22 folded before Flop (didn't bet)
Seat 4: 4time2warp0 (button) folded before Flop (didn't bet)
Seat 5: lupninox (small blind) folded before Flop
Seat 6: garwoody777 (big blind) folded before Flop
Seat 7: hichnick777 folded before Flop (didn't bet)
Seat 8: ZamoS89 folded before Flop (didn't bet)
Seat 9: TeddyKGB027 folded before Flop (didn't bet)


*********** # 326 **************
PokerStars Hand #176679653542: Tournament #2054568934, $20+$2 USD Hold'em No Limit - Level XXXV (20000/40000) - 2017/10/09 5:42:54 MSK [2017/10/08 22:42:54 ET]
Table '2054568934 598' 9-max Seat #5 is the button
Seat 1: dogBq (632896 in chips)
Seat 2: blackaces93 (4456538 in chips)
Seat 3: siggins22 (581118 in chips)
Seat 4: 4time2warp0 (1441312 in chips)
Seat 5: lupninox (1314990 in chips)
Seat 6: garwoody777 (520942 in chips)
Seat 7: hichnick777 (668928 in chips)
Seat 8: ZamoS89 (622034 in chips)
Seat 9: TeddyKGB027 (2841475 in chips)
dogBq: posts the ante 4000
blackaces93: posts the ante 4000
siggins22: posts the ante 4000
4time2warp0: posts the ante 4000
lupninox: posts the ante 4000
garwoody777: posts the ante 4000
hichnick777: posts the ante 4000
ZamoS89: posts the ante 4000
TeddyKGB027: posts the ante 4000
garwoody777: posts small blind 20000
hichnick777: posts big blind 40000
*** HOLE CARDS ***
Dealt to hichnick777 [4d Td]
ZamoS89: folds
TeddyKGB027: folds
dogBq: folds
blackaces93: raises 42770 to 82770
siggins22: folds
4time2warp0: folds
lupninox: folds
garwoody777: folds
hichnick777: calls 42770
*** FLOP *** [5s Ac 8h]
hichnick777: checks
blackaces93: bets 67800
hichnick777: folds
Uncalled bet (67800) returned to blackaces93
blackaces93 collected 221540 from pot
blackaces93: doesn't show hand
*** SUMMARY ***
Total pot 221540 | Rake 0
Board [5s Ac 8h]
Seat 1: dogBq folded before Flop (didn't bet)
Seat 2: blackaces93 collected (221540)
Seat 3: siggins22 folded before Flop (didn't bet)
Seat 4: 4time2warp0 folded before Flop (didn't bet)
Seat 5: lupninox (button) folded before Flop (didn't bet)
Seat 6: garwoody777 (small blind) folded before Flop
Seat 7: hichnick777 (big blind) folded on the Flop
Seat 8: ZamoS89 folded before Flop (didn't bet)
Seat 9: TeddyKGB027 folded before Flop (didn't bet)


*********** # 327 **************
PokerStars Hand #176679670471: Tournament #2054568934, $20+$2 USD Hold'em No Limit - Level XXXV (20000/40000) - 2017/10/09 5:43:49 MSK [2017/10/08 22:43:49 ET]
Table '2054568934 598' 9-max Seat #6 is the button
Seat 1: dogBq (628896 in chips)
Seat 2: blackaces93 (4591308 in chips)
Seat 3: siggins22 (577118 in chips)
Seat 4: 4time2warp0 (1437312 in chips)
Seat 5: lupninox (1310990 in chips)
Seat 6: garwoody777 (496942 in chips)
Seat 7: hichnick777 (582158 in chips)
Seat 8: ZamoS89 (618034 in chips)
Seat 9: TeddyKGB027 (2837475 in chips)
dogBq: posts the ante 4000
blackaces93: posts the ante 4000
siggins22: posts the ante 4000
4time2warp0: posts the ante 4000
lupninox: posts the ante 4000
garwoody777: posts the ante 4000
hichnick777: posts the ante 4000
ZamoS89: posts the ante 4000
TeddyKGB027: posts the ante 4000
hichnick777: posts small blind 20000
ZamoS89: posts big blind 40000
*** HOLE CARDS ***
Dealt to hichnick777 [Jd Kd]
TeddyKGB027: folds
dogBq: folds
blackaces93: folds
siggins22: folds
4time2warp0: folds
lupninox: folds
garwoody777: folds
hichnick777: raises 50000 to 90000
ZamoS89: folds
Uncalled bet (50000) returned to hichnick777
hichnick777 collected 116000 from pot
hichnick777: doesn't show hand
*** SUMMARY ***
Total pot 116000 | Rake 0
Seat 1: dogBq folded before Flop (didn't bet)
Seat 2: blackaces93 folded before Flop (didn't bet)
Seat 3: siggins22 folded before Flop (didn't bet)
Seat 4: 4time2warp0 folded before Flop (didn't bet)
Seat 5: lupninox folded before Flop (didn't bet)
Seat 6: garwoody777 (button) folded before Flop (didn't bet)
Seat 7: hichnick777 (small blind) collected (116000)
Seat 8: ZamoS89 (big blind) folded before Flop
Seat 9: TeddyKGB027 folded before Flop (didn't bet)


*********** # 328 **************
PokerStars Hand #176679686025: Tournament #2054568934, $20+$2 USD Hold'em No Limit - Level XXXV (20000/40000) - 2017/10/09 5:44:40 MSK [2017/10/08 22:44:40 ET]
Table '2054568934 598' 9-max Seat #7 is the button
Seat 1: dogBq (624896 in chips)
Seat 2: blackaces93 (4587308 in chips)
Seat 3: siggins22 (573118 in chips)
Seat 5: lupninox (1306990 in chips)
Seat 6: garwoody777 (492942 in chips)
Seat 7: hichnick777 (654158 in chips)
Seat 8: ZamoS89 (574034 in chips)
Seat 9: TeddyKGB027 (2833475 in chips)
dogBq: posts the ante 4000
blackaces93: posts the ante 4000
siggins22: posts the ante 4000
lupninox: posts the ante 4000
garwoody777: posts the ante 4000
hichnick777: posts the ante 4000
ZamoS89: posts the ante 4000
TeddyKGB027: posts the ante 4000
ZamoS89: posts small blind 20000
TeddyKGB027: posts big blind 40000
*** HOLE CARDS ***
Dealt to hichnick777 [Ks 2d]
dogBq: folds
blackaces93: folds
siggins22: folds
lupninox: folds
garwoody777: folds
hichnick777: folds
ZamoS89: calls 20000
TeddyKGB027: checks
*** FLOP *** [7d Qs Qh]
ZamoS89: checks
TeddyKGB027: bets 40000
ZamoS89: calls 40000
*** TURN *** [7d Qs Qh] [4h]
ZamoS89: checks
TeddyKGB027: checks
*** RIVER *** [7d Qs Qh 4h] [Ad]
ZamoS89: checks
TeddyKGB027: bets 109440
ZamoS89: calls 109440
*** SHOW DOWN ***
TeddyKGB027: shows [5d 2s] (a pair of Queens)
ZamoS89: shows [8c 7c] (two pair, Queens and Sevens)
ZamoS89 collected 410880 from pot
*** SUMMARY ***
Total pot 410880 | Rake 0
Board [7d Qs Qh 4h Ad]
Seat 1: dogBq folded before Flop (didn't bet)
Seat 2: blackaces93 folded before Flop (didn't bet)
Seat 3: siggins22 folded before Flop (didn't bet)
Seat 5: lupninox folded before Flop (didn't bet)
Seat 6: garwoody777 folded before Flop (didn't bet)
Seat 7: hichnick777 (button) folded before Flop (didn't bet)
Seat 8: ZamoS89 (small blind) showed [8c 7c] and won (410880) with two pair, Queens and Sevens
Seat 9: TeddyKGB027 (big blind) showed [5d 2s] and lost with a pair of Queens


*********** # 329 **************
PokerStars Hand #176679709430: Tournament #2054568934, $20+$2 USD Hold'em No Limit - Level XXXV (20000/40000) - 2017/10/09 5:45:57 MSK [2017/10/08 22:45:57 ET]
Table '2054568934 598' 9-max Seat #8 is the button
Seat 1: dogBq (620896 in chips)
Seat 2: blackaces93 (4583308 in chips)
Seat 3: siggins22 (569118 in chips)
Seat 5: lupninox (1302990 in chips)
Seat 6: garwoody777 (488942 in chips)
Seat 7: hichnick777 (650158 in chips)
Seat 8: ZamoS89 (791474 in chips)
Seat 9: TeddyKGB027 (2640035 in chips)
dogBq: posts the ante 4000
blackaces93: posts the ante 4000
siggins22: posts the ante 4000
lupninox: posts the ante 4000
garwoody777: posts the ante 4000
hichnick777: posts the ante 4000
ZamoS89: posts the ante 4000
TeddyKGB027: posts the ante 4000
TeddyKGB027: posts small blind 20000
dogBq: posts big blind 40000
*** HOLE CARDS ***
Dealt to hichnick777 [Qd 2d]
blackaces93: folds
siggins22: folds
lupninox: folds
garwoody777: folds
hichnick777: raises 43200 to 83200
ZamoS89: folds
TeddyKGB027: folds
dogBq: folds
Uncalled bet (43200) returned to hichnick777
hichnick777 collected 132000 from pot
hichnick777: doesn't show hand
*** SUMMARY ***
Total pot 132000 | Rake 0
Seat 1: dogBq (big blind) folded before Flop
Seat 2: blackaces93 folded before Flop (didn't bet)
Seat 3: siggins22 folded before Flop (didn't bet)
Seat 5: lupninox folded before Flop (didn't bet)
Seat 6: garwoody777 folded before Flop (didn't bet)
Seat 7: hichnick777 collected (132000)
Seat 8: ZamoS89 (button) folded before Flop (didn't bet)
Seat 9: TeddyKGB027 (small blind) folded before Flop


*********** # 330 **************
PokerStars Hand #176679722839: Tournament #2054568934, $20+$2 USD Hold'em No Limit - Level XXXV (20000/40000) - 2017/10/09 5:46:41 MSK [2017/10/08 22:46:41 ET]
Table '2054568934 598' 9-max Seat #9 is the button
Seat 1: dogBq (576896 in chips)
Seat 2: blackaces93 (4579308 in chips)
Seat 3: siggins22 (565118 in chips)
Seat 4: bustit360 (1951003 in chips)
Seat 5: lupninox (1298990 in chips)
Seat 6: garwoody777 (484942 in chips)
Seat 7: hichnick777 (738158 in chips)
Seat 8: ZamoS89 (787474 in chips)
Seat 9: TeddyKGB027 (2616035 in chips)
dogBq: posts the ante 4000
blackaces93: posts the ante 4000
siggins22: posts the ante 4000
bustit360: posts the ante 4000
lupninox: posts the ante 4000
garwoody777: posts the ante 4000
hichnick777: posts the ante 4000
ZamoS89: posts the ante 4000
TeddyKGB027: posts the ante 4000
dogBq: posts small blind 20000
blackaces93: posts big blind 40000
*** HOLE CARDS ***
Dealt to hichnick777 [5c 3c]
siggins22: folds
bustit360: raises 40000 to 80000
lupninox: folds
garwoody777: folds
hichnick777: folds
ZamoS89: folds
TeddyKGB027: folds
dogBq: folds
blackaces93: calls 40000
*** FLOP *** [5h 7d Ts]
blackaces93: checks
bustit360: bets 216000
blackaces93: folds
Uncalled bet (216000) returned to bustit360
bustit360 collected 216000 from pot
bustit360: doesn't show hand
*** SUMMARY ***
Total pot 216000 | Rake 0
Board [5h 7d Ts]
Seat 1: dogBq (small blind) folded before Flop
Seat 2: blackaces93 (big blind) folded on the Flop
Seat 3: siggins22 folded before Flop (didn't bet)
Seat 4: bustit360 collected (216000)
Seat 5: lupninox folded before Flop (didn't bet)
Seat 6: garwoody777 folded before Flop (didn't bet)
Seat 7: hichnick777 folded before Flop (didn't bet)
Seat 8: ZamoS89 folded before Flop (didn't bet)
Seat 9: TeddyKGB027 (button) folded before Flop (didn't bet)


*********** # 331 **************
PokerStars Hand #176679735939: Tournament #2054568934, $20+$2 USD Hold'em No Limit - Level XXXV (20000/40000) - 2017/10/09 5:47:25 MSK [2017/10/08 22:47:25 ET]
Table '2054568934 598' 9-max Seat #1 is the button
Seat 1: dogBq (552896 in chips)
Seat 2: blackaces93 (4495308 in chips)
Seat 3: siggins22 (561118 in chips)
Seat 4: bustit360 (2083003 in chips)
Seat 5: lupninox (1294990 in chips)
Seat 6: garwoody777 (480942 in chips)
Seat 7: hichnick777 (734158 in chips)
Seat 8: ZamoS89 (783474 in chips)
Seat 9: TeddyKGB027 (2612035 in chips)
dogBq: posts the ante 4000
blackaces93: posts the ante 4000
siggins22: posts the ante 4000
bustit360: posts the ante 4000
lupninox: posts the ante 4000
garwoody777: posts the ante 4000
hichnick777: posts the ante 4000
ZamoS89: posts the ante 4000
TeddyKGB027: posts the ante 4000
blackaces93: posts small blind 20000
siggins22: posts big blind 40000
*** HOLE CARDS ***
Dealt to hichnick777 [Jd Jh]
bustit360: raises 40000 to 80000
lupninox: folds
garwoody777: calls 80000
hichnick777: raises 650158 to 730158 and is all-in
ZamoS89: folds
TeddyKGB027: folds
dogBq: folds
blackaces93: folds
siggins22: folds
bustit360: folds
garwoody777: folds
Uncalled bet (650158) returned to hichnick777
hichnick777 collected 336000 from pot
hichnick777: doesn't show hand
*** SUMMARY ***
Total pot 336000 | Rake 0
Seat 1: dogBq (button) folded before Flop (didn't bet)
Seat 2: blackaces93 (small blind) folded before Flop
Seat 3: siggins22 (big blind) folded before Flop
Seat 4: bustit360 folded before Flop
Seat 5: lupninox folded before Flop (didn't bet)
Seat 6: garwoody777 folded before Flop
Seat 7: hichnick777 collected (336000)
Seat 8: ZamoS89 folded before Flop (didn't bet)
Seat 9: TeddyKGB027 folded before Flop (didn't bet)


*********** # 332 **************
PokerStars Hand #176679753554: Tournament #2054568934, $20+$2 USD Hold'em No Limit - Level XXXV (20000/40000) - 2017/10/09 5:48:24 MSK [2017/10/08 22:48:24 ET]
Table '2054568934 598' 9-max Seat #2 is the button
Seat 1: dogBq (548896 in chips)
Seat 2: blackaces93 (4471308 in chips)
Seat 3: siggins22 (517118 in chips)
Seat 4: bustit360 (1999003 in chips)
Seat 5: lupninox (1290990 in chips)
Seat 6: garwoody777 (396942 in chips)
Seat 7: hichnick777 (986158 in chips)
Seat 8: ZamoS89 (779474 in chips)
Seat 9: TeddyKGB027 (2608035 in chips)
dogBq: posts the ante 4000
blackaces93: posts the ante 4000
siggins22: posts the ante 4000
bustit360: posts the ante 4000
lupninox: posts the ante 4000
garwoody777: posts the ante 4000
hichnick777: posts the ante 4000
ZamoS89: posts the ante 4000
TeddyKGB027: posts the ante 4000
siggins22: posts small blind 20000
bustit360: posts big blind 40000
*** HOLE CARDS ***
Dealt to hichnick777 [Kd Ac]
lupninox: raises 40457 to 80457
garwoody777: folds
hichnick777: calls 80457
ZamoS89: folds
TeddyKGB027: folds
dogBq: folds
blackaces93: calls 80457
siggins22: folds
bustit360: folds
*** FLOP *** [3c 5s 9c]
lupninox: bets 219776
hichnick777: folds
blackaces93: folds
Uncalled bet (219776) returned to lupninox
lupninox collected 337371 from pot
*** SUMMARY ***
Total pot 337371 | Rake 0
Board [3c 5s 9c]
Seat 1: dogBq folded before Flop (didn't bet)
Seat 2: blackaces93 (button) folded on the Flop
Seat 3: siggins22 (small blind) folded before Flop
Seat 4: bustit360 (big blind) folded before Flop
Seat 5: lupninox collected (337371)
Seat 6: garwoody777 folded before Flop (didn't bet)
Seat 7: hichnick777 folded on the Flop
Seat 8: ZamoS89 folded before Flop (didn't bet)
Seat 9: TeddyKGB027 folded before Flop (didn't bet)


*********** # 333 **************
PokerStars Hand #176679790556: Tournament #2054568934, $20+$2 USD Hold'em No Limit - Level XXXVI (25000/50000) - 2017/10/09 5:50:29 MSK [2017/10/08 22:50:29 ET]
Table '2054568934 598' 9-max Seat #3 is the button
Seat 1: dogBq (544896 in chips)
Seat 2: blackaces93 (4386851 in chips)
Seat 3: siggins22 (493118 in chips)
Seat 4: bustit360 (1955003 in chips)
Seat 5: lupninox (1543904 in chips)
Seat 6: garwoody777 (392942 in chips)
Seat 7: hichnick777 (901701 in chips)
Seat 8: ZamoS89 (775474 in chips)
Seat 9: TeddyKGB027 (2604035 in chips)
dogBq: posts the ante 5000
blackaces93: posts the ante 5000
siggins22: posts the ante 5000
bustit360: posts the ante 5000
lupninox: posts the ante 5000
garwoody777: posts the ante 5000
hichnick777: posts the ante 5000
ZamoS89: posts the ante 5000
TeddyKGB027: posts the ante 5000
bustit360: posts small blind 25000
lupninox: posts big blind 50000
*** HOLE CARDS ***
Dealt to hichnick777 [Qh 9h]
garwoody777: folds
hichnick777: folds
ZamoS89: folds
TeddyKGB027: folds
dogBq: folds
blackaces93: raises 55250 to 105250
siggins22: folds
bustit360: folds
lupninox: folds
Uncalled bet (55250) returned to blackaces93
blackaces93 collected 170000 from pot
blackaces93: doesn't show hand
*** SUMMARY ***
Total pot 170000 | Rake 0
Seat 1: dogBq folded before Flop (didn't bet)
Seat 2: blackaces93 collected (170000)
Seat 3: siggins22 (button) folded before Flop (didn't bet)
Seat 4: bustit360 (small blind) folded before Flop
Seat 5: lupninox (big blind) folded before Flop
Seat 6: garwoody777 folded before Flop (didn't bet)
Seat 7: hichnick777 folded before Flop (didn't bet)
Seat 8: ZamoS89 folded before Flop (didn't bet)
Seat 9: TeddyKGB027 folded before Flop (didn't bet)


*********** # 334 **************
PokerStars Hand #176679801652: Tournament #2054568934, $20+$2 USD Hold'em No Limit - Level XXXVI (25000/50000) - 2017/10/09 5:51:06 MSK [2017/10/08 22:51:06 ET]
Table '2054568934 598' 9-max Seat #4 is the button
Seat 1: dogBq (539896 in chips)
Seat 2: blackaces93 (4501851 in chips)
Seat 3: siggins22 (488118 in chips)
Seat 4: bustit360 (1925003 in chips)
Seat 5: lupninox (1488904 in chips)
Seat 6: garwoody777 (387942 in chips)
Seat 7: hichnick777 (896701 in chips)
Seat 8: ZamoS89 (770474 in chips)
Seat 9: TeddyKGB027 (2599035 in chips)
dogBq: posts the ante 5000
blackaces93: posts the ante 5000
siggins22: posts the ante 5000
bustit360: posts the ante 5000
lupninox: posts the ante 5000
garwoody777: posts the ante 5000
hichnick777: posts the ante 5000
ZamoS89: posts the ante 5000
TeddyKGB027: posts the ante 5000
lupninox: posts small blind 25000
garwoody777: posts big blind 50000
*** HOLE CARDS ***
Dealt to hichnick777 [5c 4c]
hichnick777: folds
ZamoS89: folds
TeddyKGB027: folds
dogBq: folds
blackaces93: folds
siggins22: folds
bustit360: folds
lupninox: raises 342000 to 392000
garwoody777: calls 332942 and is all-in
Uncalled bet (9058) returned to lupninox
*** FLOP *** [Td Ad 7d]
*** TURN *** [Td Ad 7d] [Qd]
*** RIVER *** [Td Ad 7d Qd] [6s]
*** SHOW DOWN ***
lupninox: shows [3c Kc] (high card Ace)
garwoody777: shows [As 3s] (a pair of Aces)
garwoody777 collected 810884 from pot
*** SUMMARY ***
Total pot 810884 | Rake 0
Board [Td Ad 7d Qd 6s]
Seat 1: dogBq folded before Flop (didn't bet)
Seat 2: blackaces93 folded before Flop (didn't bet)
Seat 3: siggins22 folded before Flop (didn't bet)
Seat 4: bustit360 (button) folded before Flop (didn't bet)
Seat 5: lupninox (small blind) showed [3c Kc] and lost with high card Ace
Seat 6: garwoody777 (big blind) showed [As 3s] and won (810884) with a pair of Aces
Seat 7: hichnick777 folded before Flop (didn't bet)
Seat 8: ZamoS89 folded before Flop (didn't bet)
Seat 9: TeddyKGB027 folded before Flop (didn't bet)


*********** # 335 **************
PokerStars Hand #176679814783: Tournament #2054568934, $20+$2 USD Hold'em No Limit - Level XXXVI (25000/50000) - 2017/10/09 5:51:51 MSK [2017/10/08 22:51:51 ET]
Table '2054568934 598' 9-max Seat #5 is the button
Seat 1: dogBq (534896 in chips)
Seat 2: blackaces93 (4496851 in chips)
Seat 3: siggins22 (483118 in chips)
Seat 5: lupninox (1100962 in chips)
Seat 6: garwoody777 (810884 in chips)
Seat 7: hichnick777 (891701 in chips)
Seat 8: ZamoS89 (765474 in chips)
Seat 9: TeddyKGB027 (2594035 in chips)
dogBq: posts the ante 5000
blackaces93: posts the ante 5000
siggins22: posts the ante 5000
lupninox: posts the ante 5000
garwoody777: posts the ante 5000
hichnick777: posts the ante 5000
ZamoS89: posts the ante 5000
TeddyKGB027: posts the ante 5000
garwoody777: posts small blind 25000
hichnick777: posts big blind 50000
*** HOLE CARDS ***
Dealt to hichnick777 [Th Ac]
ZamoS89: folds
TeddyKGB027: folds
dogBq: folds
blackaces93: raises 55275 to 105275
siggins22: folds
lupninox: raises 990687 to 1095962 and is all-in
garwoody777: folds
hichnick777: folds
blackaces93: folds
Uncalled bet (990687) returned to lupninox
lupninox collected 325550 from pot
*** SUMMARY ***
Total pot 325550 | Rake 0
Seat 1: dogBq folded before Flop (didn't bet)
Seat 2: blackaces93 folded before Flop
Seat 3: siggins22 folded before Flop (didn't bet)
Seat 5: lupninox (button) collected (325550)
Seat 6: garwoody777 (small blind) folded before Flop
Seat 7: hichnick777 (big blind) folded before Flop
Seat 8: ZamoS89 folded before Flop (didn't bet)
Seat 9: TeddyKGB027 folded before Flop (didn't bet)


*********** # 336 **************
PokerStars Hand #176679827494: Tournament #2054568934, $20+$2 USD Hold'em No Limit - Level XXXVI (25000/50000) - 2017/10/09 5:52:33 MSK [2017/10/08 22:52:33 ET]
Table '2054568934 598' 9-max Seat #6 is the button
Seat 1: dogBq (529896 in chips)
Seat 2: blackaces93 (4386576 in chips)
Seat 3: siggins22 (478118 in chips)
Seat 5: lupninox (1316237 in chips)
Seat 6: garwoody777 (780884 in chips)
Seat 7: hichnick777 (836701 in chips)
Seat 8: ZamoS89 (760474 in chips)
Seat 9: TeddyKGB027 (2589035 in chips)
dogBq: posts the ante 5000
blackaces93: posts the ante 5000
siggins22: posts the ante 5000
lupninox: posts the ante 5000
garwoody777: posts the ante 5000
hichnick777: posts the ante 5000
ZamoS89: posts the ante 5000
TeddyKGB027: posts the ante 5000
hichnick777: posts small blind 25000
ZamoS89: posts big blind 50000
*** HOLE CARDS ***
Dealt to hichnick777 [5s Ad]
TeddyKGB027: raises 67500 to 117500
dogBq: folds
blackaces93: folds
siggins22: folds
lupninox: folds
garwoody777: folds
hichnick777: folds
ZamoS89: folds
Uncalled bet (67500) returned to TeddyKGB027
TeddyKGB027 collected 165000 from pot
TeddyKGB027: doesn't show hand
*** SUMMARY ***
Total pot 165000 | Rake 0
Seat 1: dogBq folded before Flop (didn't bet)
Seat 2: blackaces93 folded before Flop (didn't bet)
Seat 3: siggins22 folded before Flop (didn't bet)
Seat 5: lupninox folded before Flop (didn't bet)
Seat 6: garwoody777 (button) folded before Flop (didn't bet)
Seat 7: hichnick777 (small blind) folded before Flop
Seat 8: ZamoS89 (big blind) folded before Flop
Seat 9: TeddyKGB027 collected (165000)


*********** # 337 **************
PokerStars Hand #176679835209: Tournament #2054568934, $20+$2 USD Hold'em No Limit - Level XXXVI (25000/50000) - 2017/10/09 5:52:59 MSK [2017/10/08 22:52:59 ET]
Table '2054568934 598' 9-max Seat #7 is the button
Seat 1: dogBq (524896 in chips)
Seat 2: blackaces93 (4381576 in chips)
Seat 3: siggins22 (473118 in chips)
Seat 5: lupninox (1311237 in chips)
Seat 6: garwoody777 (775884 in chips)
Seat 7: hichnick777 (806701 in chips)
Seat 8: ZamoS89 (705474 in chips)
Seat 9: TeddyKGB027 (2699035 in chips)
dogBq: posts the ante 5000
blackaces93: posts the ante 5000
siggins22: posts the ante 5000
lupninox: posts the ante 5000
garwoody777: posts the ante 5000
hichnick777: posts the ante 5000
ZamoS89: posts the ante 5000
TeddyKGB027: posts the ante 5000
ZamoS89: posts small blind 25000
TeddyKGB027: posts big blind 50000
*** HOLE CARDS ***
Dealt to hichnick777 [Qs Jd]
dogBq: folds
blackaces93: folds
siggins22: folds
lupninox: raises 65000 to 115000
garwoody777: folds
hichnick777: folds
ZamoS89: folds
TeddyKGB027: calls 65000
*** FLOP *** [Tc 4d Kc]
TeddyKGB027: checks
lupninox: bets 106200
TeddyKGB027: calls 106200
*** TURN *** [Tc 4d Kc] [Qh]
TeddyKGB027: checks
lupninox: bets 313404
TeddyKGB027: folds
Uncalled bet (313404) returned to lupninox
lupninox collected 507400 from pot
*** SUMMARY ***
Total pot 507400 | Rake 0
Board [Tc 4d Kc Qh]
Seat 1: dogBq folded before Flop (didn't bet)
Seat 2: blackaces93 folded before Flop (didn't bet)
Seat 3: siggins22 folded before Flop (didn't bet)
Seat 5: lupninox collected (507400)
Seat 6: garwoody777 folded before Flop (didn't bet)
Seat 7: hichnick777 (button) folded before Flop (didn't bet)
Seat 8: ZamoS89 (small blind) folded before Flop
Seat 9: TeddyKGB027 (big blind) folded on the Turn


*********** # 338 **************
PokerStars Hand #176679992208: Tournament #2054568934, $20+$2 USD Hold'em No Limit - Level XXXVI (25000/50000) - 2017/10/09 6:02:43 MSK [2017/10/08 23:02:43 ET]
Table '2054568934 598' 9-max Seat #8 is the button
Seat 1: dogBq (519896 in chips)
Seat 2: blackaces93 (4376576 in chips)
Seat 3: siggins22 (468118 in chips)
Seat 4: khsgrizende (2236980 in chips)
Seat 5: lupninox (1592437 in chips)
Seat 6: garwoody777 (770884 in chips)
Seat 7: hichnick777 (801701 in chips)
Seat 8: ZamoS89 (675474 in chips)
Seat 9: TeddyKGB027 (2472835 in chips)
dogBq: posts the ante 5000
blackaces93: posts the ante 5000
siggins22: posts the ante 5000
khsgrizende: posts the ante 5000
lupninox: posts the ante 5000
garwoody777: posts the ante 5000
hichnick777: posts the ante 5000
ZamoS89: posts the ante 5000
TeddyKGB027: posts the ante 5000
TeddyKGB027: posts small blind 25000
dogBq: posts big blind 50000
*** HOLE CARDS ***
Dealt to hichnick777 [4d Qd]
blackaces93: raises 55750 to 105750
siggins22: folds
khsgrizende: folds
lupninox: raises 173750 to 279500
garwoody777: folds
hichnick777: folds
ZamoS89: folds
TeddyKGB027: folds
dogBq: folds
blackaces93: calls 173750
*** FLOP *** [3c 9h 5c]
blackaces93: checks
lupninox: bets 390198
blackaces93: folds
Uncalled bet (390198) returned to lupninox
lupninox collected 679000 from pot
*** SUMMARY ***
Total pot 679000 | Rake 0
Board [3c 9h 5c]
Seat 1: dogBq (big blind) folded before Flop
Seat 2: blackaces93 folded on the Flop
Seat 3: siggins22 folded before Flop (didn't bet)
Seat 4: khsgrizende folded before Flop (didn't bet)
Seat 5: lupninox collected (679000)
Seat 6: garwoody777 folded before Flop (didn't bet)
Seat 7: hichnick777 folded before Flop (didn't bet)
Seat 8: ZamoS89 (button) folded before Flop (didn't bet)
Seat 9: TeddyKGB027 (small blind) folded before Flop


*********** # 339 **************
PokerStars Hand #176680022848: Tournament #2054568934, $20+$2 USD Hold'em No Limit - Level XXXVI (25000/50000) - 2017/10/09 6:04:31 MSK [2017/10/08 23:04:31 ET]
Table '2054568934 598' 9-max Seat #9 is the button
Seat 1: dogBq (464896 in chips)
Seat 2: blackaces93 (4092076 in chips)
Seat 3: siggins22 (463118 in chips)
Seat 4: khsgrizende (2231980 in chips)
Seat 5: lupninox (1986937 in chips)
Seat 6: garwoody777 (765884 in chips)
Seat 7: hichnick777 (796701 in chips)
Seat 8: ZamoS89 (670474 in chips)
Seat 9: TeddyKGB027 (2442835 in chips)
dogBq: posts the ante 5000
blackaces93: posts the ante 5000
siggins22: posts the ante 5000
khsgrizende: posts the ante 5000
lupninox: posts the ante 5000
garwoody777: posts the ante 5000
hichnick777: posts the ante 5000
ZamoS89: posts the ante 5000
TeddyKGB027: posts the ante 5000
dogBq: posts small blind 25000
blackaces93: posts big blind 50000
*** HOLE CARDS ***
Dealt to hichnick777 [7d 5h]
siggins22: folds
khsgrizende: folds
lupninox: folds
garwoody777: folds
hichnick777: folds
ZamoS89: folds
TeddyKGB027: folds
dogBq: folds
Uncalled bet (25000) returned to blackaces93
blackaces93 collected 95000 from pot
blackaces93: doesn't show hand
*** SUMMARY ***
Total pot 95000 | Rake 0
Seat 1: dogBq (small blind) folded before Flop
Seat 2: blackaces93 (big blind) collected (95000)
Seat 3: siggins22 folded before Flop (didn't bet)
Seat 4: khsgrizende folded before Flop (didn't bet)
Seat 5: lupninox folded before Flop (didn't bet)
Seat 6: garwoody777 folded before Flop (didn't bet)
Seat 7: hichnick777 folded before Flop (didn't bet)
Seat 8: ZamoS89 folded before Flop (didn't bet)
Seat 9: TeddyKGB027 (button) folded before Flop (didn't bet)


*********** # 340 **************
PokerStars Hand #176680033029: Tournament #2054568934, $20+$2 USD Hold'em No Limit - Level XXXVI (25000/50000) - 2017/10/09 6:05:07 MSK [2017/10/08 23:05:07 ET]
Table '2054568934 598' 9-max Seat #1 is the button
Seat 1: dogBq (434896 in chips)
Seat 2: blackaces93 (4157076 in chips)
Seat 3: siggins22 (458118 in chips)
Seat 4: khsgrizende (2226980 in chips)
Seat 5: lupninox (1981937 in chips)
Seat 6: garwoody777 (760884 in chips)
Seat 7: hichnick777 (791701 in chips)
Seat 8: ZamoS89 (665474 in chips)
Seat 9: TeddyKGB027 (2437835 in chips)
dogBq: posts the ante 5000
blackaces93: posts the ante 5000
siggins22: posts the ante 5000
khsgrizende: posts the ante 5000
lupninox: posts the ante 5000
garwoody777: posts the ante 5000
hichnick777: posts the ante 5000
ZamoS89: posts the ante 5000
TeddyKGB027: posts the ante 5000
blackaces93: posts small blind 25000
siggins22: posts big blind 50000
*** HOLE CARDS ***
Dealt to hichnick777 [8h Jd]
khsgrizende: folds
lupninox: folds
garwoody777: folds
hichnick777: folds
ZamoS89: folds
TeddyKGB027: folds
dogBq: folds
blackaces93: raises 4102076 to 4152076 and is all-in
siggins22: calls 403118 and is all-in
Uncalled bet (3698958) returned to blackaces93
*** FLOP *** [9h 2c 6s]
*** TURN *** [9h 2c 6s] [4s]
*** RIVER *** [9h 2c 6s 4s] [3c]
*** SHOW DOWN ***
blackaces93: shows [8d Jh] (high card Jack)
siggins22: shows [Ah 5c] (a straight, Deuce to Six)
siggins22 collected 951236 from pot
*** SUMMARY ***
Total pot 951236 | Rake 0
Board [9h 2c 6s 4s 3c]
Seat 1: dogBq (button) folded before Flop (didn't bet)
Seat 2: blackaces93 (small blind) showed [8d Jh] and lost with high card Jack
Seat 3: siggins22 (big blind) showed [Ah 5c] and won (951236) with a straight, Deuce to Six
Seat 4: khsgrizende folded before Flop (didn't bet)
Seat 5: lupninox folded before Flop (didn't bet)
Seat 6: garwoody777 folded before Flop (didn't bet)
Seat 7: hichnick777 folded before Flop (didn't bet)
Seat 8: ZamoS89 folded before Flop (didn't bet)
Seat 9: TeddyKGB027 folded before Flop (didn't bet)


*********** # 341 **************
PokerStars Hand #176680043032: Tournament #2054568934, $20+$2 USD Hold'em No Limit - Level XXXVI (25000/50000) - 2017/10/09 6:05:42 MSK [2017/10/08 23:05:42 ET]
Table '2054568934 598' 9-max Seat #2 is the button
Seat 1: dogBq (429896 in chips)
Seat 2: blackaces93 (3698958 in chips)
Seat 3: siggins22 (951236 in chips)
Seat 4: khsgrizende (2221980 in chips)
Seat 5: lupninox (1976937 in chips)
Seat 6: garwoody777 (755884 in chips)
Seat 7: hichnick777 (786701 in chips)
Seat 8: ZamoS89 (660474 in chips)
Seat 9: TeddyKGB027 (2432835 in chips)
dogBq: posts the ante 5000
blackaces93: posts the ante 5000
siggins22: posts the ante 5000
khsgrizende: posts the ante 5000
lupninox: posts the ante 5000
garwoody777: posts the ante 5000
hichnick777: posts the ante 5000
ZamoS89: posts the ante 5000
TeddyKGB027: posts the ante 5000
siggins22: posts small blind 25000
khsgrizende: posts big blind 50000
*** HOLE CARDS ***
Dealt to hichnick777 [3h 2h]
lupninox: folds
garwoody777: folds
hichnick777: folds
ZamoS89: folds
TeddyKGB027: raises 67500 to 117500
dogBq: folds
blackaces93: folds
siggins22: calls 92500
khsgrizende: folds
*** FLOP *** [Ts Kd 2d]
siggins22: checks
TeddyKGB027: bets 115500
siggins22: folds
Uncalled bet (115500) returned to TeddyKGB027
TeddyKGB027 collected 330000 from pot
TeddyKGB027: doesn't show hand
*** SUMMARY ***
Total pot 330000 | Rake 0
Board [Ts Kd 2d]
Seat 1: dogBq folded before Flop (didn't bet)
Seat 2: blackaces93 (button) folded before Flop (didn't bet)
Seat 3: siggins22 (small blind) folded on the Flop
Seat 4: khsgrizende (big blind) folded before Flop
Seat 5: lupninox folded before Flop (didn't bet)
Seat 6: garwoody777 folded before Flop (didn't bet)
Seat 7: hichnick777 folded before Flop (didn't bet)
Seat 8: ZamoS89 folded before Flop (didn't bet)
Seat 9: TeddyKGB027 collected (330000)


*********** # 342 **************
PokerStars Hand #176680058003: Tournament #2054568934, $20+$2 USD Hold'em No Limit - Level XXXVI (25000/50000) - 2017/10/09 6:06:35 MSK [2017/10/08 23:06:35 ET]
Table '2054568934 598' 9-max Seat #3 is the button
Seat 1: dogBq (424896 in chips)
Seat 2: blackaces93 (3693958 in chips)
Seat 3: siggins22 (828736 in chips)
Seat 4: khsgrizende (2166980 in chips)
Seat 5: lupninox (1971937 in chips)
Seat 6: garwoody777 (750884 in chips)
Seat 7: hichnick777 (781701 in chips)
Seat 8: ZamoS89 (655474 in chips)
Seat 9: TeddyKGB027 (2640335 in chips)
dogBq: posts the ante 5000
blackaces93: posts the ante 5000
siggins22: posts the ante 5000
khsgrizende: posts the ante 5000
lupninox: posts the ante 5000
garwoody777: posts the ante 5000
hichnick777: posts the ante 5000
ZamoS89: posts the ante 5000
TeddyKGB027: posts the ante 5000
khsgrizende: posts small blind 25000
lupninox: posts big blind 50000
*** HOLE CARDS ***
Dealt to hichnick777 [6h Jd]
garwoody777: folds
hichnick777: folds
ZamoS89: folds
TeddyKGB027: folds
dogBq: folds
blackaces93: folds
siggins22: raises 75000 to 125000
khsgrizende: folds
lupninox: calls 75000
*** FLOP *** [Qc Qs 2s]
lupninox: checks
siggins22: bets 160000
lupninox: folds
Uncalled bet (160000) returned to siggins22
siggins22 collected 320000 from pot
siggins22: doesn't show hand
*** SUMMARY ***
Total pot 320000 | Rake 0
Board [Qc Qs 2s]
Seat 1: dogBq folded before Flop (didn't bet)
Seat 2: blackaces93 folded before Flop (didn't bet)
Seat 3: siggins22 (button) collected (320000)
Seat 4: khsgrizende (small blind) folded before Flop
Seat 5: lupninox (big blind) folded on the Flop
Seat 6: garwoody777 folded before Flop (didn't bet)
Seat 7: hichnick777 folded before Flop (didn't bet)
Seat 8: ZamoS89 folded before Flop (didn't bet)
Seat 9: TeddyKGB027 folded before Flop (didn't bet)


*********** # 343 **************
PokerStars Hand #176680077969: Tournament #2054568934, $20+$2 USD Hold'em No Limit - Level XXXVI (25000/50000) - 2017/10/09 6:07:46 MSK [2017/10/08 23:07:46 ET]
Table '2054568934 598' 9-max Seat #4 is the button
Seat 1: dogBq (419896 in chips)
Seat 2: blackaces93 (3688958 in chips)
Seat 3: siggins22 (1018736 in chips)
Seat 4: khsgrizende (2136980 in chips)
Seat 5: lupninox (1841937 in chips)
Seat 6: garwoody777 (745884 in chips)
Seat 7: hichnick777 (776701 in chips)
Seat 8: ZamoS89 (650474 in chips)
Seat 9: TeddyKGB027 (2635335 in chips)
dogBq: posts the ante 5000
blackaces93: posts the ante 5000
siggins22: posts the ante 5000
khsgrizende: posts the ante 5000
lupninox: posts the ante 5000
garwoody777: posts the ante 5000
hichnick777: posts the ante 5000
ZamoS89: posts the ante 5000
TeddyKGB027: posts the ante 5000
lupninox: posts small blind 25000
garwoody777: posts big blind 50000
*** HOLE CARDS ***
Dealt to hichnick777 [Qs Ts]
hichnick777: folds
ZamoS89: folds
TeddyKGB027: folds
dogBq: folds
blackaces93: raises 55750 to 105750
siggins22: folds
khsgrizende: folds
lupninox: folds
garwoody777: folds
Uncalled bet (55750) returned to blackaces93
blackaces93 collected 170000 from pot
*** SUMMARY ***
Total pot 170000 | Rake 0
Seat 1: dogBq folded before Flop (didn't bet)
Seat 2: blackaces93 collected (170000)
Seat 3: siggins22 folded before Flop (didn't bet)
Seat 4: khsgrizende (button) folded before Flop (didn't bet)
Seat 5: lupninox (small blind) folded before Flop
Seat 6: garwoody777 (big blind) folded before Flop
Seat 7: hichnick777 folded before Flop (didn't bet)
Seat 8: ZamoS89 folded before Flop (didn't bet)
Seat 9: TeddyKGB027 folded before Flop (didn't bet)


*********** # 344 **************
PokerStars Hand #176680097390: Tournament #2054568934, $20+$2 USD Hold'em No Limit - Level XXXVI (25000/50000) - 2017/10/09 6:08:26 MSK [2017/10/08 23:08:26 ET]
Table '2054568934 598' 9-max Seat #5 is the button
Seat 1: dogBq (414896 in chips)
Seat 2: blackaces93 (3803958 in chips)
Seat 3: siggins22 (1013736 in chips)
Seat 4: khsgrizende (2131980 in chips)
Seat 5: lupninox (1811937 in chips)
Seat 6: garwoody777 (690884 in chips)
Seat 7: hichnick777 (771701 in chips)
Seat 8: ZamoS89 (645474 in chips)
Seat 9: TeddyKGB027 (2630335 in chips)
dogBq: posts the ante 5000
blackaces93: posts the ante 5000
siggins22: posts the ante 5000
khsgrizende: posts the ante 5000
lupninox: posts the ante 5000
garwoody777: posts the ante 5000
hichnick777: posts the ante 5000
ZamoS89: posts the ante 5000
TeddyKGB027: posts the ante 5000
garwoody777: posts small blind 25000
hichnick777: posts big blind 50000
*** HOLE CARDS ***
Dealt to hichnick777 [Ad 5s]
ZamoS89: folds
TeddyKGB027: folds
dogBq: folds
blackaces93: folds
siggins22: folds
khsgrizende: raises 55000 to 105000
lupninox: folds
garwoody777: folds
hichnick777: calls 55000
*** FLOP *** [Kd 3c Qh]
hichnick777: checks
khsgrizende: bets 86800
hichnick777: folds
Uncalled bet (86800) returned to khsgrizende
khsgrizende collected 280000 from pot
khsgrizende: doesn't show hand
*** SUMMARY ***
Total pot 280000 | Rake 0
Board [Kd 3c Qh]
Seat 1: dogBq folded before Flop (didn't bet)
Seat 2: blackaces93 folded before Flop (didn't bet)
Seat 3: siggins22 folded before Flop (didn't bet)
Seat 4: khsgrizende collected (280000)
Seat 5: lupninox (button) folded before Flop (didn't bet)
Seat 6: garwoody777 (small blind) folded before Flop
Seat 7: hichnick777 (big blind) folded on the Flop
Seat 8: ZamoS89 folded before Flop (didn't bet)
Seat 9: TeddyKGB027 folded before Flop (didn't bet)


*********** # 345 **************
PokerStars Hand #176680119144: Tournament #2054568934, $20+$2 USD Hold'em No Limit - Level XXXVII (30000/60000) - 2017/10/09 6:09:44 MSK [2017/10/08 23:09:44 ET]
Table '2054568934 598' 9-max Seat #6 is the button
Seat 1: dogBq (409896 in chips)
Seat 2: blackaces93 (3798958 in chips)
Seat 3: siggins22 (1008736 in chips)
Seat 4: khsgrizende (2301980 in chips)
Seat 5: lupninox (1806937 in chips)
Seat 6: garwoody777 (660884 in chips)
Seat 7: hichnick777 (661701 in chips)
Seat 8: ZamoS89 (640474 in chips)
Seat 9: TeddyKGB027 (2625335 in chips)
dogBq: posts the ante 6000
blackaces93: posts the ante 6000
siggins22: posts the ante 6000
khsgrizende: posts the ante 6000
lupninox: posts the ante 6000
garwoody777: posts the ante 6000
hichnick777: posts the ante 6000
ZamoS89: posts the ante 6000
TeddyKGB027: posts the ante 6000
hichnick777: posts small blind 30000
ZamoS89: posts big blind 60000
*** HOLE CARDS ***
Dealt to hichnick777 [8c 6c]
TeddyKGB027: folds
dogBq: folds
blackaces93: folds
siggins22: raises 90000 to 150000
khsgrizende: folds
lupninox: folds
garwoody777: folds
hichnick777: folds
ZamoS89: folds
Uncalled bet (90000) returned to siggins22
siggins22 collected 204000 from pot
siggins22: doesn't show hand
*** SUMMARY ***
Total pot 204000 | Rake 0
Seat 1: dogBq folded before Flop (didn't bet)
Seat 2: blackaces93 folded before Flop (didn't bet)
Seat 3: siggins22 collected (204000)
Seat 4: khsgrizende folded before Flop (didn't bet)
Seat 5: lupninox folded before Flop (didn't bet)
Seat 6: garwoody777 (button) folded before Flop (didn't bet)
Seat 7: hichnick777 (small blind) folded before Flop
Seat 8: ZamoS89 (big blind) folded before Flop
Seat 9: TeddyKGB027 folded before Flop (didn't bet)


*********** # 346 **************
PokerStars Hand #176680138341: Tournament #2054568934, $20+$2 USD Hold'em No Limit - Level XXXVII (30000/60000) - 2017/10/09 6:10:51 MSK [2017/10/08 23:10:51 ET]
Table '2054568934 598' 9-max Seat #7 is the button
Seat 1: dogBq (403896 in chips)
Seat 2: blackaces93 (3792958 in chips)
Seat 3: siggins22 (1146736 in chips)
Seat 4: khsgrizende (2295980 in chips)
Seat 5: lupninox (1800937 in chips)
Seat 7: hichnick777 (625701 in chips)
Seat 8: ZamoS89 (574474 in chips)
Seat 9: TeddyKGB027 (2619335 in chips)
dogBq: posts the ante 6000
blackaces93: posts the ante 6000
siggins22: posts the ante 6000
khsgrizende: posts the ante 6000
lupninox: posts the ante 6000
hichnick777: posts the ante 6000
ZamoS89: posts the ante 6000
TeddyKGB027: posts the ante 6000
ZamoS89: posts small blind 30000
TeddyKGB027: posts big blind 60000
*** HOLE CARDS ***
Dealt to hichnick777 [As Ts]
dogBq: folds
blackaces93: raises 66200 to 126200
siggins22: folds
khsgrizende: folds
lupninox: folds
hichnick777: raises 493501 to 619701 and is all-in
ZamoS89: folds
TeddyKGB027: folds
blackaces93: folds
Uncalled bet (493501) returned to hichnick777
hichnick777 collected 390400 from pot
hichnick777: doesn't show hand
*** SUMMARY ***
Total pot 390400 | Rake 0
Seat 1: dogBq folded before Flop (didn't bet)
Seat 2: blackaces93 folded before Flop
Seat 3: siggins22 folded before Flop (didn't bet)
Seat 4: khsgrizende folded before Flop (didn't bet)
Seat 5: lupninox folded before Flop (didn't bet)
Seat 7: hichnick777 (button) collected (390400)
Seat 8: ZamoS89 (small blind) folded before Flop
Seat 9: TeddyKGB027 (big blind) folded before Flop


*********** # 347 **************
PokerStars Hand #176680150063: Tournament #2054568934, $20+$2 USD Hold'em No Limit - Level XXXVII (30000/60000) - 2017/10/09 6:11:34 MSK [2017/10/08 23:11:34 ET]
Table '2054568934 598' 9-max Seat #8 is the button
Seat 1: dogBq (397896 in chips)
Seat 2: blackaces93 (3660758 in chips)
Seat 3: siggins22 (1140736 in chips)
Seat 4: khsgrizende (2289980 in chips)
Seat 5: lupninox (1794937 in chips)
Seat 7: hichnick777 (883901 in chips)
Seat 8: ZamoS89 (538474 in chips)
Seat 9: TeddyKGB027 (2553335 in chips)
dogBq: posts the ante 6000
blackaces93: posts the ante 6000
siggins22: posts the ante 6000
khsgrizende: posts the ante 6000
lupninox: posts the ante 6000
hichnick777: posts the ante 6000
ZamoS89: posts the ante 6000
TeddyKGB027: posts the ante 6000
TeddyKGB027: posts small blind 30000
dogBq: posts big blind 60000
*** HOLE CARDS ***
Dealt to hichnick777 [Jc Kh]
blackaces93: folds
siggins22: folds
khsgrizende: folds
lupninox: folds
hichnick777: raises 817901 to 877901 and is all-in
ZamoS89: folds
TeddyKGB027: folds
dogBq: calls 331896 and is all-in
Uncalled bet (486005) returned to hichnick777
*** FLOP *** [Tc Kc 6c]
*** TURN *** [Tc Kc 6c] [4c]
*** RIVER *** [Tc Kc 6c 4c] [9d]
*** SHOW DOWN ***
dogBq: shows [Qd Ac] (a flush, Ace high)
hichnick777: shows [Jc Kh] (a flush, King high)
dogBq collected 861792 from pot
*** SUMMARY ***
Total pot 861792 | Rake 0
Board [Tc Kc 6c 4c 9d]
Seat 1: dogBq (big blind) showed [Qd Ac] and won (861792) with a flush, Ace high
Seat 2: blackaces93 folded before Flop (didn't bet)
Seat 3: siggins22 folded before Flop (didn't bet)
Seat 4: khsgrizende folded before Flop (didn't bet)
Seat 5: lupninox folded before Flop (didn't bet)
Seat 7: hichnick777 showed [Jc Kh] and lost with a flush, King high
Seat 8: ZamoS89 (button) folded before Flop (didn't bet)
Seat 9: TeddyKGB027 (small blind) folded before Flop


*********** # 348 **************
PokerStars Hand #176680160817: Tournament #2054568934, $20+$2 USD Hold'em No Limit - Level XXXVII (30000/60000) - 2017/10/09 6:12:12 MSK [2017/10/08 23:12:12 ET]
Table '2054568934 598' 9-max Seat #9 is the button
Seat 1: dogBq (861792 in chips)
Seat 2: blackaces93 (3654758 in chips)
Seat 3: siggins22 (1134736 in chips)
Seat 4: khsgrizende (2283980 in chips)
Seat 5: lupninox (1788937 in chips)
Seat 7: hichnick777 (486005 in chips)
Seat 8: ZamoS89 (532474 in chips)
Seat 9: TeddyKGB027 (2517335 in chips)
dogBq: posts the ante 6000
blackaces93: posts the ante 6000
siggins22: posts the ante 6000
khsgrizende: posts the ante 6000
lupninox: posts the ante 6000
hichnick777: posts the ante 6000
ZamoS89: posts the ante 6000
TeddyKGB027: posts the ante 6000
dogBq: posts small blind 30000
blackaces93: posts big blind 60000
*** HOLE CARDS ***
Dealt to hichnick777 [Kc Kd]
siggins22: raises 60000 to 120000
khsgrizende: calls 120000
lupninox: folds
hichnick777: raises 360005 to 480005 and is all-in
ZamoS89: folds
TeddyKGB027: folds
dogBq: folds
blackaces93: folds
siggins22: raises 648731 to 1128736 and is all-in
khsgrizende: folds
Uncalled bet (648731) returned to siggins22
*** FLOP *** [5d Js 9c]
*** TURN *** [5d Js 9c] [7s]
*** RIVER *** [5d Js 9c 7s] [9d]
*** SHOW DOWN ***
siggins22: shows [Ks Jh] (two pair, Jacks and Nines)
hichnick777: shows [Kc Kd] (two pair, Kings and Nines)
hichnick777 collected 1218010 from pot
*** SUMMARY ***
Total pot 1218010 | Rake 0
Board [5d Js 9c 7s 9d]
Seat 1: dogBq (small blind) folded before Flop
Seat 2: blackaces93 (big blind) folded before Flop
Seat 3: siggins22 showed [Ks Jh] and lost with two pair, Jacks and Nines
Seat 4: khsgrizende folded before Flop
Seat 5: lupninox folded before Flop (didn't bet)
Seat 7: hichnick777 showed [Kc Kd] and won (1218010) with two pair, Kings and Nines
Seat 8: ZamoS89 folded before Flop (didn't bet)
Seat 9: TeddyKGB027 (button) folded before Flop (didn't bet)


*********** # 349 **************
PokerStars Hand #176680177671: Tournament #2054568934, $20+$2 USD Hold'em No Limit - Level XXXVII (30000/60000) - 2017/10/09 6:13:12 MSK [2017/10/08 23:13:12 ET]
Table '2054568934 598' 9-max Seat #1 is the button
Seat 1: dogBq (825792 in chips)
Seat 2: blackaces93 (3588758 in chips)
Seat 3: siggins22 (648731 in chips)
Seat 4: khsgrizende (2157980 in chips)
Seat 5: lupninox (1782937 in chips)
Seat 7: hichnick777 (1218010 in chips)
Seat 8: ZamoS89 (526474 in chips)
Seat 9: TeddyKGB027 (2511335 in chips)
dogBq: posts the ante 6000
blackaces93: posts the ante 6000
siggins22: posts the ante 6000
khsgrizende: posts the ante 6000
lupninox: posts the ante 6000
hichnick777: posts the ante 6000
ZamoS89: posts the ante 6000
TeddyKGB027: posts the ante 6000
blackaces93: posts small blind 30000
siggins22: posts big blind 60000
*** HOLE CARDS ***
Dealt to hichnick777 [Js Qs]
khsgrizende: folds
lupninox: folds
hichnick777: raises 64800 to 124800
ZamoS89: folds
TeddyKGB027: folds
dogBq: folds
blackaces93: folds
siggins22: calls 64800
*** FLOP *** [6c Td Kd]
siggins22: checks
hichnick777: bets 108108
siggins22: calls 108108
*** TURN *** [6c Td Kd] [Ad]
siggins22: bets 409823 and is all-in
hichnick777: calls 409823
*** RIVER *** [6c Td Kd Ad] [Qd]
*** SHOW DOWN ***
siggins22: shows [Ah 6h] (two pair, Aces and Sixes)
hichnick777: shows [Js Qs] (a straight, Ten to Ace)
hichnick777 collected 1363462 from pot
siggins22 finished the tournament in 45th place and received $174.85.
*** SUMMARY ***
Total pot 1363462 | Rake 0
Board [6c Td Kd Ad Qd]
Seat 1: dogBq (button) folded before Flop (didn't bet)
Seat 2: blackaces93 (small blind) folded before Flop
Seat 3: siggins22 (big blind) showed [Ah 6h] and lost with two pair, Aces and Sixes
Seat 4: khsgrizende folded before Flop (didn't bet)
Seat 5: lupninox folded before Flop (didn't bet)
Seat 7: hichnick777 showed [Js Qs] and won (1363462) with a straight, Ten to Ace
Seat 8: ZamoS89 folded before Flop (didn't bet)
Seat 9: TeddyKGB027 folded before Flop (didn't bet)


*********** # 350 **************
PokerStars Hand #176680191649: Tournament #2054568934, $20+$2 USD Hold'em No Limit - Level XXXVII (30000/60000) - 2017/10/09 6:14:03 MSK [2017/10/08 23:14:03 ET]
Table '2054568934 598' 9-max Seat #2 is the button
Seat 1: dogBq (819792 in chips)
Seat 2: blackaces93 (3552758 in chips)
Seat 4: khsgrizende (2151980 in chips)
Seat 5: lupninox (1776937 in chips)
Seat 6: Maikil361 (2738491 in chips)
Seat 7: hichnick777 (1932741 in chips)
Seat 8: ZamoS89 (520474 in chips)
Seat 9: TeddyKGB027 (2505335 in chips)
dogBq: posts the ante 6000
blackaces93: posts the ante 6000
khsgrizende: posts the ante 6000
lupninox: posts the ante 6000
Maikil361: posts the ante 6000
hichnick777: posts the ante 6000
ZamoS89: posts the ante 6000
TeddyKGB027: posts the ante 6000
khsgrizende: posts small blind 30000
lupninox: posts big blind 60000
*** HOLE CARDS ***
Dealt to hichnick777 [6d Th]
Maikil361: folds
hichnick777: folds
ZamoS89: raises 454474 to 514474 and is all-in
TeddyKGB027: calls 514474
dogBq: folds
blackaces93: folds
khsgrizende: folds
lupninox: folds
*** FLOP *** [4h 2h 6h]
*** TURN *** [4h 2h 6h] [8d]
*** RIVER *** [4h 2h 6h 8d] [4d]
*** SHOW DOWN ***
ZamoS89: shows [Ts Ah] (a pair of Fours)
TeddyKGB027: shows [Qd As] (a pair of Fours - Ace+Queen kicker)
TeddyKGB027 collected 1166948 from pot
ZamoS89 finished the tournament in 44th place and received $254.29.
*** SUMMARY ***
Total pot 1166948 | Rake 0
Board [4h 2h 6h 8d 4d]
Seat 1: dogBq folded before Flop (didn't bet)
Seat 2: blackaces93 (button) folded before Flop (didn't bet)
Seat 4: khsgrizende (small blind) folded before Flop
Seat 5: lupninox (big blind) folded before Flop
Seat 6: Maikil361 folded before Flop (didn't bet)
Seat 7: hichnick777 folded before Flop (didn't bet)
Seat 8: ZamoS89 showed [Ts Ah] and lost with a pair of Fours
Seat 9: TeddyKGB027 showed [Qd As] and won (1166948) with a pair of Fours


*********** # 351 **************
PokerStars Hand #176680199663: Tournament #2054568934, $20+$2 USD Hold'em No Limit - Level XXXVII (30000/60000) - 2017/10/09 6:14:32 MSK [2017/10/08 23:14:32 ET]
Table '2054568934 598' 9-max Seat #4 is the button
Seat 1: dogBq (813792 in chips)
Seat 2: blackaces93 (3546758 in chips)
Seat 4: khsgrizende (2115980 in chips)
Seat 5: lupninox (1710937 in chips)
Seat 6: Maikil361 (2732491 in chips)
Seat 7: hichnick777 (1926741 in chips)
Seat 9: TeddyKGB027 (3151809 in chips)
dogBq: posts the ante 6000
blackaces93: posts the ante 6000
khsgrizende: posts the ante 6000
lupninox: posts the ante 6000
Maikil361: posts the ante 6000
hichnick777: posts the ante 6000
TeddyKGB027: posts the ante 6000
lupninox: posts small blind 30000
Maikil361: posts big blind 60000
*** HOLE CARDS ***
Dealt to hichnick777 [8s 6h]
hichnick777: folds
TeddyKGB027: folds
dogBq: folds
blackaces93: folds
khsgrizende: raises 66000 to 126000
lupninox: folds
Maikil361: calls 66000
*** FLOP *** [2s 6c 7s]
Maikil361: checks
khsgrizende: checks
*** TURN *** [2s 6c 7s] [Kh]
Maikil361: bets 130440
khsgrizende: calls 130440
*** RIVER *** [2s 6c 7s Kh] [Jd]
Maikil361: bets 201498
khsgrizende: folds
Uncalled bet (201498) returned to Maikil361
Maikil361 collected 584880 from pot
*** SUMMARY ***
Total pot 584880 | Rake 0
Board [2s 6c 7s Kh Jd]
Seat 1: dogBq folded before Flop (didn't bet)
Seat 2: blackaces93 folded before Flop (didn't bet)
Seat 4: khsgrizende (button) folded on the River
Seat 5: lupninox (small blind) folded before Flop
Seat 6: Maikil361 (big blind) collected (584880)
Seat 7: hichnick777 folded before Flop (didn't bet)
Seat 9: TeddyKGB027 folded before Flop (didn't bet)


*********** # 352 **************
PokerStars Hand #176680230278: Tournament #2054568934, $20+$2 USD Hold'em No Limit - Level XXXVII (30000/60000) - 2017/10/09 6:16:23 MSK [2017/10/08 23:16:23 ET]
Table '2054568934 598' 9-max Seat #5 is the button
Seat 1: dogBq (807792 in chips)
Seat 2: blackaces93 (3540758 in chips)
Seat 3: 4time2warp0 (2662624 in chips)
Seat 4: khsgrizende (1853540 in chips)
Seat 5: lupninox (1674937 in chips)
Seat 6: Maikil361 (3054931 in chips)
Seat 7: hichnick777 (1920741 in chips)
Seat 9: TeddyKGB027 (3145809 in chips)
dogBq: posts the ante 6000
blackaces93: posts the ante 6000
4time2warp0: posts the ante 6000
khsgrizende: posts the ante 6000
lupninox: posts the ante 6000
Maikil361: posts the ante 6000
hichnick777: posts the ante 6000
TeddyKGB027: posts the ante 6000
Maikil361: posts small blind 30000
hichnick777: posts big blind 60000
*** HOLE CARDS ***
Dealt to hichnick777 [3c Qc]
TeddyKGB027: folds
dogBq: folds
blackaces93: folds
4time2warp0: folds
lupninox is disconnected
khsgrizende: folds
lupninox is connected
lupninox: raises 72000 to 132000
Maikil361: folds
hichnick777: raises 228000 to 360000
lupninox: raises 1308937 to 1668937 and is all-in
hichnick777: folds
Uncalled bet (1308937) returned to lupninox
lupninox collected 798000 from pot
*** SUMMARY ***
Total pot 798000 | Rake 0
Seat 1: dogBq folded before Flop (didn't bet)
Seat 2: blackaces93 folded before Flop (didn't bet)
Seat 3: 4time2warp0 folded before Flop (didn't bet)
Seat 4: khsgrizende folded before Flop (didn't bet)
Seat 5: lupninox (button) collected (798000)
Seat 6: Maikil361 (small blind) folded before Flop
Seat 7: hichnick777 (big blind) folded before Flop
Seat 9: TeddyKGB027 folded before Flop (didn't bet)


*********** # 353 **************
PokerStars Hand #176680248536: Tournament #2054568934, $20+$2 USD Hold'em No Limit - Level XXXVII (30000/60000) - 2017/10/09 6:17:29 MSK [2017/10/08 23:17:29 ET]
Table '2054568934 598' 9-max Seat #6 is the button
Seat 1: dogBq (801792 in chips)
Seat 2: blackaces93 (3534758 in chips)
Seat 3: 4time2warp0 (2656624 in chips)
Seat 4: khsgrizende (1847540 in chips)
Seat 5: lupninox (2106937 in chips)
Seat 6: Maikil361 (3018931 in chips)
Seat 7: hichnick777 (1554741 in chips)
Seat 9: TeddyKGB027 (3139809 in chips)
dogBq: posts the ante 6000
blackaces93: posts the ante 6000
4time2warp0: posts the ante 6000
khsgrizende: posts the ante 6000
lupninox: posts the ante 6000
Maikil361: posts the ante 6000
hichnick777: posts the ante 6000
TeddyKGB027: posts the ante 6000
hichnick777: posts small blind 30000
TeddyKGB027: posts big blind 60000
*** HOLE CARDS ***
Dealt to hichnick777 [6c As]
dogBq: folds
blackaces93: raises 66200 to 126200
4time2warp0: folds
khsgrizende: raises 173800 to 300000
lupninox: folds
Maikil361: folds
hichnick777: folds
TeddyKGB027: folds
blackaces93: calls 173800
*** FLOP *** [2c 9h 2s]
blackaces93: checks
khsgrizende: bets 228780
blackaces93: calls 228780
*** TURN *** [2c 9h 2s] [3s]
blackaces93: checks
khsgrizende: checks
*** RIVER *** [2c 9h 2s 3s] [Ah]
blackaces93: checks
khsgrizende: checks
*** SHOW DOWN ***
blackaces93: shows [8h 8s] (two pair, Eights and Deuces)
khsgrizende: shows [Kh Ks] (two pair, Kings and Deuces)
khsgrizende collected 1195560 from pot
*** SUMMARY ***
Total pot 1195560 | Rake 0
Board [2c 9h 2s 3s Ah]
Seat 1: dogBq folded before Flop (didn't bet)
Seat 2: blackaces93 showed [8h 8s] and lost with two pair, Eights and Deuces
Seat 3: 4time2warp0 folded before Flop (didn't bet)
Seat 4: khsgrizende showed [Kh Ks] and won (1195560) with two pair, Kings and Deuces
Seat 5: lupninox folded before Flop (didn't bet)
Seat 6: Maikil361 (button) folded before Flop (didn't bet)
Seat 7: hichnick777 (small blind) folded before Flop
Seat 9: TeddyKGB027 (big blind) folded before Flop


*********** # 354 **************
PokerStars Hand #176680280361: Tournament #2054568934, $20+$2 USD Hold'em No Limit - Level XXXVII (30000/60000) - 2017/10/09 6:19:25 MSK [2017/10/08 23:19:25 ET]
Table '2054568934 598' 9-max Seat #7 is the button
Seat 1: dogBq (795792 in chips)
Seat 2: blackaces93 (2999978 in chips)
Seat 3: 4time2warp0 (2650624 in chips)
Seat 4: khsgrizende (2508320 in chips)
Seat 5: lupninox (2100937 in chips)
Seat 6: Maikil361 (3012931 in chips)
Seat 7: hichnick777 (1518741 in chips)
Seat 9: TeddyKGB027 (3073809 in chips)
dogBq: posts the ante 6000
blackaces93: posts the ante 6000
4time2warp0: posts the ante 6000
khsgrizende: posts the ante 6000
lupninox: posts the ante 6000
Maikil361: posts the ante 6000
hichnick777: posts the ante 6000
TeddyKGB027: posts the ante 6000
TeddyKGB027: posts small blind 30000
dogBq: posts big blind 60000
*** HOLE CARDS ***
Dealt to hichnick777 [9s Ks]
blackaces93: folds
4time2warp0: folds
khsgrizende: folds
lupninox: folds
Maikil361: folds
hichnick777: raises 64800 to 124800
TeddyKGB027: folds
dogBq: folds
Uncalled bet (64800) returned to hichnick777
hichnick777 collected 198000 from pot
hichnick777: doesn't show hand
*** SUMMARY ***
Total pot 198000 | Rake 0
Seat 1: dogBq (big blind) folded before Flop
Seat 2: blackaces93 folded before Flop (didn't bet)
Seat 3: 4time2warp0 folded before Flop (didn't bet)
Seat 4: khsgrizende folded before Flop (didn't bet)
Seat 5: lupninox folded before Flop (didn't bet)
Seat 6: Maikil361 folded before Flop (didn't bet)
Seat 7: hichnick777 (button) collected (198000)
Seat 9: TeddyKGB027 (small blind) folded before Flop


*********** # 355 **************
PokerStars Hand #176680294464: Tournament #2054568934, $20+$2 USD Hold'em No Limit - Level XXXVII (30000/60000) - 2017/10/09 6:20:16 MSK [2017/10/08 23:20:16 ET]
Table '2054568934 598' 9-max Seat #9 is the button
Seat 1: dogBq (729792 in chips)
Seat 2: blackaces93 (2993978 in chips)
Seat 3: 4time2warp0 (2644624 in chips)
Seat 4: khsgrizende (2502320 in chips)
Seat 5: lupninox (2094937 in chips)
Seat 6: Maikil361 (3006931 in chips)
Seat 7: hichnick777 (1650741 in chips)
Seat 9: TeddyKGB027 (3037809 in chips)
dogBq: posts the ante 6000
blackaces93: posts the ante 6000
4time2warp0: posts the ante 6000
khsgrizende: posts the ante 6000
lupninox: posts the ante 6000
Maikil361: posts the ante 6000
hichnick777: posts the ante 6000
TeddyKGB027: posts the ante 6000
dogBq: posts small blind 30000
blackaces93: posts big blind 60000
*** HOLE CARDS ***
Dealt to hichnick777 [5s Ts]
4time2warp0: folds
khsgrizende: folds
lupninox: raises 60457 to 120457
Maikil361: folds
hichnick777: folds
TeddyKGB027: folds
dogBq: folds
blackaces93: calls 60457
*** FLOP *** [7s 2c Ah]
blackaces93: checks
lupninox: bets 84809
blackaces93: folds
Uncalled bet (84809) returned to lupninox
lupninox collected 318914 from pot
*** SUMMARY ***
Total pot 318914 | Rake 0
Board [7s 2c Ah]
Seat 1: dogBq (small blind) folded before Flop
Seat 2: blackaces93 (big blind) folded on the Flop
Seat 3: 4time2warp0 folded before Flop (didn't bet)
Seat 4: khsgrizende folded before Flop (didn't bet)
Seat 5: lupninox collected (318914)
Seat 6: Maikil361 folded before Flop (didn't bet)
Seat 7: hichnick777 folded before Flop (didn't bet)
Seat 9: TeddyKGB027 (button) folded before Flop (didn't bet)


*********** # 356 **************
PokerStars Hand #176680312488: Tournament #2054568934, $20+$2 USD Hold'em No Limit - Level XXXVIII (35000/70000) - 2017/10/09 6:21:23 MSK [2017/10/08 23:21:23 ET]
Table '2054568934 598' 9-max Seat #1 is the button
Seat 1: dogBq (693792 in chips)
Seat 2: blackaces93 (2867521 in chips)
Seat 3: 4time2warp0 (2638624 in chips)
Seat 4: khsgrizende (2496320 in chips)
Seat 5: lupninox (2287394 in chips)
Seat 6: Maikil361 (3000931 in chips)
Seat 7: hichnick777 (1644741 in chips)
Seat 9: TeddyKGB027 (3031809 in chips)
dogBq: posts the ante 7000
blackaces93: posts the ante 7000
4time2warp0: posts the ante 7000
khsgrizende: posts the ante 7000
lupninox: posts the ante 7000
Maikil361: posts the ante 7000
hichnick777: posts the ante 7000
TeddyKGB027: posts the ante 7000
blackaces93: posts small blind 35000
4time2warp0: posts big blind 70000
*** HOLE CARDS ***
Dealt to hichnick777 [7s 6d]
khsgrizende: folds
lupninox: folds
Maikil361: raises 95200 to 165200
hichnick777: folds
TeddyKGB027: folds
dogBq: folds
blackaces93: folds
4time2warp0: folds
Uncalled bet (95200) returned to Maikil361
Maikil361 collected 231000 from pot
*** SUMMARY ***
Total pot 231000 | Rake 0
Seat 1: dogBq (button) folded before Flop (didn't bet)
Seat 2: blackaces93 (small blind) folded before Flop
Seat 3: 4time2warp0 (big blind) folded before Flop
Seat 4: khsgrizende folded before Flop (didn't bet)
Seat 5: lupninox folded before Flop (didn't bet)
Seat 6: Maikil361 collected (231000)
Seat 7: hichnick777 folded before Flop (didn't bet)
Seat 9: TeddyKGB027 folded before Flop (didn't bet)


*********** # 357 **************
PokerStars Hand #176680328094: Tournament #2054568934, $20+$2 USD Hold'em No Limit - Level XXXVIII (35000/70000) - 2017/10/09 6:22:21 MSK [2017/10/08 23:22:21 ET]
Table '2054568934 598' 9-max Seat #2 is the button
Seat 1: dogBq (686792 in chips)
Seat 2: blackaces93 (2825521 in chips)
Seat 3: 4time2warp0 (2561624 in chips)
Seat 4: khsgrizende (2489320 in chips)
Seat 5: lupninox (2280394 in chips)
Seat 6: Maikil361 (3154931 in chips)
Seat 7: hichnick777 (1637741 in chips)
Seat 9: TeddyKGB027 (3024809 in chips)
dogBq: posts the ante 7000
blackaces93: posts the ante 7000
4time2warp0: posts the ante 7000
khsgrizende: posts the ante 7000
lupninox: posts the ante 7000
Maikil361: posts the ante 7000
hichnick777: posts the ante 7000
TeddyKGB027: posts the ante 7000
4time2warp0: posts small blind 35000
khsgrizende: posts big blind 70000
*** HOLE CARDS ***
Dealt to hichnick777 [2d 5c]
lupninox: folds
Maikil361: folds
hichnick777: folds
TeddyKGB027: raises 94500 to 164500
dogBq: folds
blackaces93: folds
4time2warp0: folds
khsgrizende: raises 185500 to 350000
TeddyKGB027: folds
Uncalled bet (185500) returned to khsgrizende
khsgrizende collected 420000 from pot
khsgrizende: doesn't show hand
*** SUMMARY ***
Total pot 420000 | Rake 0
Seat 1: dogBq folded before Flop (didn't bet)
Seat 2: blackaces93 (button) folded before Flop (didn't bet)
Seat 3: 4time2warp0 (small blind) folded before Flop
Seat 4: khsgrizende (big blind) collected (420000)
Seat 5: lupninox folded before Flop (didn't bet)
Seat 6: Maikil361 folded before Flop (didn't bet)
Seat 7: hichnick777 folded before Flop (didn't bet)
Seat 9: TeddyKGB027 folded before Flop


*********** # 358 **************
PokerStars Hand #176680344538: Tournament #2054568934, $20+$2 USD Hold'em No Limit - Level XXXVIII (35000/70000) - 2017/10/09 6:23:22 MSK [2017/10/08 23:23:22 ET]
Table '2054568934 598' 9-max Seat #3 is the button
Seat 1: dogBq (679792 in chips)
Seat 2: blackaces93 (2818521 in chips)
Seat 3: 4time2warp0 (2519624 in chips)
Seat 4: khsgrizende (2737820 in chips)
Seat 5: lupninox (2273394 in chips)
Seat 6: Maikil361 (3147931 in chips)
Seat 7: hichnick777 (1630741 in chips)
Seat 9: TeddyKGB027 (2853309 in chips)
dogBq: posts the ante 7000
blackaces93: posts the ante 7000
4time2warp0: posts the ante 7000
khsgrizende: posts the ante 7000
lupninox: posts the ante 7000
Maikil361: posts the ante 7000
hichnick777: posts the ante 7000
TeddyKGB027: posts the ante 7000
khsgrizende: posts small blind 35000
lupninox: posts big blind 70000
*** HOLE CARDS ***
Dealt to hichnick777 [5d Jd]
Maikil361: folds
hichnick777: folds
TeddyKGB027: folds
dogBq: folds
blackaces93: raises 77880 to 147880
4time2warp0: folds
khsgrizende: folds
lupninox: folds
Uncalled bet (77880) returned to blackaces93
blackaces93 collected 231000 from pot
*** SUMMARY ***
Total pot 231000 | Rake 0
Seat 1: dogBq folded before Flop (didn't bet)
Seat 2: blackaces93 collected (231000)
Seat 3: 4time2warp0 (button) folded before Flop (didn't bet)
Seat 4: khsgrizende (small blind) folded before Flop
Seat 5: lupninox (big blind) folded before Flop
Seat 6: Maikil361 folded before Flop (didn't bet)
Seat 7: hichnick777 folded before Flop (didn't bet)
Seat 9: TeddyKGB027 folded before Flop (didn't bet)


*********** # 359 **************
PokerStars Hand #176680354499: Tournament #2054568934, $20+$2 USD Hold'em No Limit - Level XXXVIII (35000/70000) - 2017/10/09 6:23:59 MSK [2017/10/08 23:23:59 ET]
Table '2054568934 598' 9-max Seat #4 is the button
Seat 1: dogBq (672792 in chips)
Seat 2: blackaces93 (2972521 in chips)
Seat 3: 4time2warp0 (2512624 in chips)
Seat 4: khsgrizende (2695820 in chips)
Seat 5: lupninox (2196394 in chips)
Seat 6: Maikil361 (3140931 in chips)
Seat 7: hichnick777 (1623741 in chips)
Seat 9: TeddyKGB027 (2846309 in chips)
dogBq: posts the ante 7000
blackaces93: posts the ante 7000
4time2warp0: posts the ante 7000
khsgrizende: posts the ante 7000
lupninox: posts the ante 7000
Maikil361: posts the ante 7000
hichnick777: posts the ante 7000
TeddyKGB027: posts the ante 7000
lupninox: posts small blind 35000
Maikil361: posts big blind 70000
*** HOLE CARDS ***
Dealt to hichnick777 [7s Ks]
hichnick777: folds
TeddyKGB027: raises 94500 to 164500
dogBq: folds
blackaces93: raises 291075 to 455575
4time2warp0: folds
khsgrizende: folds
lupninox: folds
Maikil361: folds
TeddyKGB027: folds
Uncalled bet (291075) returned to blackaces93
blackaces93 collected 490000 from pot
*** SUMMARY ***
Total pot 490000 | Rake 0
Seat 1: dogBq folded before Flop (didn't bet)
Seat 2: blackaces93 collected (490000)
Seat 3: 4time2warp0 folded before Flop (didn't bet)
Seat 4: khsgrizende (button) folded before Flop (didn't bet)
Seat 5: lupninox (small blind) folded before Flop
Seat 6: Maikil361 (big blind) folded before Flop
Seat 7: hichnick777 folded before Flop (didn't bet)
Seat 9: TeddyKGB027 folded before Flop


*********** # 360 **************
PokerStars Hand #176680368573: Tournament #2054568934, $20+$2 USD Hold'em No Limit - Level XXXVIII (35000/70000) - 2017/10/09 6:24:52 MSK [2017/10/08 23:24:52 ET]
Table '2054568934 598' 9-max Seat #5 is the button
Seat 1: dogBq (665792 in chips)
Seat 2: blackaces93 (3291021 in chips)
Seat 3: 4time2warp0 (2505624 in chips)
Seat 4: khsgrizende (2688820 in chips)
Seat 5: lupninox (2154394 in chips)
Seat 6: Maikil361 (3063931 in chips)
Seat 7: hichnick777 (1616741 in chips)
Seat 9: TeddyKGB027 (2674809 in chips)
dogBq: posts the ante 7000
blackaces93: posts the ante 7000
4time2warp0: posts the ante 7000
khsgrizende: posts the ante 7000
lupninox: posts the ante 7000
Maikil361: posts the ante 7000
hichnick777: posts the ante 7000
TeddyKGB027: posts the ante 7000
Maikil361: posts small blind 35000
hichnick777: posts big blind 70000
*** HOLE CARDS ***
Dealt to hichnick777 [Qs Jh]
TeddyKGB027: folds
dogBq: folds
blackaces93: folds
4time2warp0: folds
khsgrizende: raises 77000 to 147000
lupninox: raises 194250 to 341250
Maikil361: folds
hichnick777: folds
khsgrizende: raises 2340570 to 2681820 and is all-in
lupninox: folds
Uncalled bet (2340570) returned to khsgrizende
khsgrizende collected 843500 from pot
khsgrizende: doesn't show hand
*** SUMMARY ***
Total pot 843500 | Rake 0
Seat 1: dogBq folded before Flop (didn't bet)
Seat 2: blackaces93 folded before Flop (didn't bet)
Seat 3: 4time2warp0 folded before Flop (didn't bet)
Seat 4: khsgrizende collected (843500)
Seat 5: lupninox (button) folded before Flop
Seat 6: Maikil361 (small blind) folded before Flop
Seat 7: hichnick777 (big blind) folded before Flop
Seat 9: TeddyKGB027 folded before Flop (didn't bet)


*********** # 361 **************
PokerStars Hand #176680386909: Tournament #2054568934, $20+$2 USD Hold'em No Limit - Level XXXVIII (35000/70000) - 2017/10/09 6:26:00 MSK [2017/10/08 23:26:00 ET]
Table '2054568934 598' 9-max Seat #6 is the button
Seat 1: dogBq (658792 in chips)
Seat 2: blackaces93 (3284021 in chips)
Seat 3: 4time2warp0 (2498624 in chips)
Seat 4: khsgrizende (3184070 in chips)
Seat 5: lupninox (1806144 in chips)
Seat 6: Maikil361 (3021931 in chips)
Seat 7: hichnick777 (1539741 in chips)
Seat 9: TeddyKGB027 (2667809 in chips)
dogBq: posts the ante 7000
blackaces93: posts the ante 7000
4time2warp0: posts the ante 7000
khsgrizende: posts the ante 7000
lupninox: posts the ante 7000
Maikil361: posts the ante 7000
hichnick777: posts the ante 7000
TeddyKGB027: posts the ante 7000
hichnick777: posts small blind 35000
TeddyKGB027: posts big blind 70000
*** HOLE CARDS ***
Dealt to hichnick777 [Ad 9s]
dogBq: folds
blackaces93: folds
4time2warp0: folds
khsgrizende: folds
lupninox: folds
Maikil361: raises 81200 to 151200
hichnick777: folds
TeddyKGB027: folds
Uncalled bet (81200) returned to Maikil361
Maikil361 collected 231000 from pot
*** SUMMARY ***
Total pot 231000 | Rake 0
Seat 1: dogBq folded before Flop (didn't bet)
Seat 2: blackaces93 folded before Flop (didn't bet)
Seat 3: 4time2warp0 folded before Flop (didn't bet)
Seat 4: khsgrizende folded before Flop (didn't bet)
Seat 5: lupninox folded before Flop (didn't bet)
Seat 6: Maikil361 (button) collected (231000)
Seat 7: hichnick777 (small blind) folded before Flop
Seat 9: TeddyKGB027 (big blind) folded before Flop


*********** # 362 **************
PokerStars Hand #176680402819: Tournament #2054568934, $20+$2 USD Hold'em No Limit - Level XXXVIII (35000/70000) - 2017/10/09 6:26:59 MSK [2017/10/08 23:26:59 ET]
Table '2054568934 598' 9-max Seat #7 is the button
Seat 1: dogBq (651792 in chips)
Seat 2: blackaces93 (3277021 in chips)
Seat 3: 4time2warp0 (2491624 in chips)
Seat 4: khsgrizende (3177070 in chips)
Seat 5: lupninox (1799144 in chips)
Seat 6: Maikil361 (3175931 in chips)
Seat 7: hichnick777 (1497741 in chips)
Seat 9: TeddyKGB027 (2590809 in chips)
dogBq: posts the ante 7000
blackaces93: posts the ante 7000
4time2warp0: posts the ante 7000
khsgrizende: posts the ante 7000
lupninox: posts the ante 7000
Maikil361: posts the ante 7000
hichnick777: posts the ante 7000
TeddyKGB027: posts the ante 7000
TeddyKGB027: posts small blind 35000
dogBq: posts big blind 70000
*** HOLE CARDS ***
Dealt to hichnick777 [Qd Kh]
blackaces93: folds
4time2warp0: raises 70000 to 140000
khsgrizende: folds
lupninox: folds
Maikil361: folds
hichnick777: folds
TeddyKGB027: folds
dogBq: calls 70000
*** FLOP *** [Ac 6h 2h]
dogBq: checks
4time2warp0: checks
*** TURN *** [Ac 6h 2h] [4s]
dogBq: checks
4time2warp0: bets 185500
dogBq: folds
Uncalled bet (185500) returned to 4time2warp0
4time2warp0 collected 371000 from pot
4time2warp0: doesn't show hand
*** SUMMARY ***
Total pot 371000 | Rake 0
Board [Ac 6h 2h 4s]
Seat 1: dogBq (big blind) folded on the Turn
Seat 2: blackaces93 folded before Flop (didn't bet)
Seat 3: 4time2warp0 collected (371000)
Seat 4: khsgrizende folded before Flop (didn't bet)
Seat 5: lupninox folded before Flop (didn't bet)
Seat 6: Maikil361 folded before Flop (didn't bet)
Seat 7: hichnick777 (button) folded before Flop (didn't bet)
Seat 9: TeddyKGB027 (small blind) folded before Flop


*********** # 363 **************
PokerStars Hand #176680420263: Tournament #2054568934, $20+$2 USD Hold'em No Limit - Level XXXVIII (35000/70000) - 2017/10/09 6:28:03 MSK [2017/10/08 23:28:03 ET]
Table '2054568934 598' 9-max Seat #9 is the button
Seat 1: dogBq (504792 in chips)
Seat 2: blackaces93 (3270021 in chips)
Seat 3: 4time2warp0 (2715624 in chips)
Seat 4: khsgrizende (3170070 in chips)
Seat 5: lupninox (1792144 in chips)
Seat 6: Maikil361 (3168931 in chips)
Seat 7: hichnick777 (1490741 in chips)
Seat 9: TeddyKGB027 (2548809 in chips)
dogBq: posts the ante 7000
blackaces93: posts the ante 7000
4time2warp0: posts the ante 7000
khsgrizende: posts the ante 7000
lupninox: posts the ante 7000
Maikil361: posts the ante 7000
hichnick777: posts the ante 7000
TeddyKGB027: posts the ante 7000
dogBq: posts small blind 35000
blackaces93: posts big blind 70000
*** HOLE CARDS ***
Dealt to hichnick777 [3h 5c]
4time2warp0: folds
khsgrizende: folds
lupninox: folds
Maikil361: folds
hichnick777: folds
TeddyKGB027: folds
dogBq: raises 427792 to 497792 and is all-in
blackaces93: calls 427792
*** FLOP *** [6c 8h 8d]
*** TURN *** [6c 8h 8d] [Th]
*** RIVER *** [6c 8h 8d Th] [7d]
*** SHOW DOWN ***
dogBq: shows [Tc Jd] (two pair, Tens and Eights)
blackaces93: shows [Ah 2h] (a pair of Eights)
dogBq collected 1051584 from pot
*** SUMMARY ***
Total pot 1051584 | Rake 0
Board [6c 8h 8d Th 7d]
Seat 1: dogBq (small blind) showed [Tc Jd] and won (1051584) with two pair, Tens and Eights
Seat 2: blackaces93 (big blind) showed [Ah 2h] and lost with a pair of Eights
Seat 3: 4time2warp0 folded before Flop (didn't bet)
Seat 4: khsgrizende folded before Flop (didn't bet)
Seat 5: lupninox folded before Flop (didn't bet)
Seat 6: Maikil361 folded before Flop (didn't bet)
Seat 7: hichnick777 folded before Flop (didn't bet)
Seat 9: TeddyKGB027 (button) folded before Flop (didn't bet)


*********** # 364 **************
PokerStars Hand #176680430526: Tournament #2054568934, $20+$2 USD Hold'em No Limit - Level XXXVIII (35000/70000) - 2017/10/09 6:28:42 MSK [2017/10/08 23:28:42 ET]
Table '2054568934 598' 9-max Seat #1 is the button
Seat 1: dogBq (1051584 in chips)
Seat 2: blackaces93 (2765229 in chips)
Seat 3: 4time2warp0 (2708624 in chips)
Seat 4: khsgrizende (3163070 in chips)
Seat 5: lupninox (1785144 in chips)
Seat 6: Maikil361 (3161931 in chips)
Seat 7: hichnick777 (1483741 in chips)
Seat 9: TeddyKGB027 (2541809 in chips)
dogBq: posts the ante 7000
blackaces93: posts the ante 7000
4time2warp0: posts the ante 7000
khsgrizende: posts the ante 7000
lupninox: posts the ante 7000
Maikil361: posts the ante 7000
hichnick777: posts the ante 7000
TeddyKGB027: posts the ante 7000
blackaces93: posts small blind 35000
4time2warp0: posts big blind 70000
*** HOLE CARDS ***
Dealt to hichnick777 [Kh Td]
khsgrizende: raises 77000 to 147000
lupninox: folds
Maikil361: folds
hichnick777: folds
TeddyKGB027: folds
dogBq: folds
blackaces93: folds
4time2warp0: folds
Uncalled bet (77000) returned to khsgrizende
khsgrizende collected 231000 from pot
khsgrizende: doesn't show hand
*** SUMMARY ***
Total pot 231000 | Rake 0
Seat 1: dogBq (button) folded before Flop (didn't bet)
Seat 2: blackaces93 (small blind) folded before Flop
Seat 3: 4time2warp0 (big blind) folded before Flop
Seat 4: khsgrizende collected (231000)
Seat 5: lupninox folded before Flop (didn't bet)
Seat 6: Maikil361 folded before Flop (didn't bet)
Seat 7: hichnick777 folded before Flop (didn't bet)
Seat 9: TeddyKGB027 folded before Flop (didn't bet)


*********** # 365 **************
PokerStars Hand #176680441388: Tournament #2054568934, $20+$2 USD Hold'em No Limit - Level XXXVIII (35000/70000) - 2017/10/09 6:29:23 MSK [2017/10/08 23:29:23 ET]
Table '2054568934 598' 9-max Seat #2 is the button
Seat 1: dogBq (1044584 in chips)
Seat 2: blackaces93 (2723229 in chips)
Seat 3: 4time2warp0 (2631624 in chips)
Seat 4: khsgrizende (3317070 in chips)
Seat 5: lupninox (1778144 in chips)
Seat 6: Maikil361 (3154931 in chips)
Seat 7: hichnick777 (1476741 in chips)
Seat 9: TeddyKGB027 (2534809 in chips)
dogBq: posts the ante 7000
blackaces93: posts the ante 7000
4time2warp0: posts the ante 7000
khsgrizende: posts the ante 7000
lupninox: posts the ante 7000
Maikil361: posts the ante 7000
hichnick777: posts the ante 7000
TeddyKGB027: posts the ante 7000
4time2warp0: posts small blind 35000
khsgrizende: posts big blind 70000
*** HOLE CARDS ***
Dealt to hichnick777 [Ks 2h]
lupninox: raises 70457 to 140457
Maikil361: folds
hichnick777: folds
TeddyKGB027: raises 209543 to 350000
dogBq: folds
blackaces93: folds
4time2warp0: folds
khsgrizende: folds
lupninox: folds
Uncalled bet (209543) returned to TeddyKGB027
TeddyKGB027 collected 441914 from pot
TeddyKGB027: doesn't show hand
*** SUMMARY ***
Total pot 441914 | Rake 0
Seat 1: dogBq folded before Flop (didn't bet)
Seat 2: blackaces93 (button) folded before Flop (didn't bet)
Seat 3: 4time2warp0 (small blind) folded before Flop
Seat 4: khsgrizende (big blind) folded before Flop
Seat 5: lupninox folded before Flop
Seat 6: Maikil361 folded before Flop (didn't bet)
Seat 7: hichnick777 folded before Flop (didn't bet)
Seat 9: TeddyKGB027 collected (441914)


*********** # 366 **************
PokerStars Hand #176680462131: Tournament #2054568934, $20+$2 USD Hold'em No Limit - Level XXXVIII (35000/70000) - 2017/10/09 6:30:41 MSK [2017/10/08 23:30:41 ET]
Table '2054568934 598' 9-max Seat #3 is the button
Seat 1: dogBq (1037584 in chips)
Seat 2: blackaces93 (2716229 in chips)
Seat 3: 4time2warp0 (2589624 in chips)
Seat 4: khsgrizende (3240070 in chips)
Seat 5: lupninox (1630687 in chips)
Seat 6: Maikil361 (3147931 in chips)
Seat 7: hichnick777 (1469741 in chips)
Seat 9: TeddyKGB027 (2829266 in chips)
dogBq: posts the ante 7000
blackaces93: posts the ante 7000
4time2warp0: posts the ante 7000
khsgrizende: posts the ante 7000
lupninox: posts the ante 7000
Maikil361: posts the ante 7000
hichnick777: posts the ante 7000
TeddyKGB027: posts the ante 7000
khsgrizende: posts small blind 35000
lupninox: posts big blind 70000
*** HOLE CARDS ***
Dealt to hichnick777 [8d 8s]
Maikil361: folds
hichnick777: raises 87500 to 157500
TeddyKGB027: folds
dogBq: folds
blackaces93: folds
4time2warp0: folds
khsgrizende: folds
lupninox: calls 87500
*** FLOP *** [3c 9h Jc]
lupninox: checks
hichnick777: checks
*** TURN *** [3c 9h Jc] [Ts]
lupninox: checks
hichnick777: checks
*** RIVER *** [3c 9h Jc Ts] [Jd]
lupninox: checks
hichnick777: checks
*** SHOW DOWN ***
lupninox: shows [Ac Qs] (a pair of Jacks)
hichnick777: shows [8d 8s] (two pair, Jacks and Eights)
hichnick777 collected 406000 from pot
*** SUMMARY ***
Total pot 406000 | Rake 0
Board [3c 9h Jc Ts Jd]
Seat 1: dogBq folded before Flop (didn't bet)
Seat 2: blackaces93 folded before Flop (didn't bet)
Seat 3: 4time2warp0 (button) folded before Flop (didn't bet)
Seat 4: khsgrizende (small blind) folded before Flop
Seat 5: lupninox (big blind) showed [Ac Qs] and lost with a pair of Jacks
Seat 6: Maikil361 folded before Flop (didn't bet)
Seat 7: hichnick777 showed [8d 8s] and won (406000) with two pair, Jacks and Eights
Seat 9: TeddyKGB027 folded before Flop (didn't bet)


*********** # 367 **************
PokerStars Hand #176680489818: Tournament #2054568934, $20+$2 USD Hold'em No Limit - Level XXXVIII (35000/70000) - 2017/10/09 6:32:26 MSK [2017/10/08 23:32:26 ET]
Table '2054568934 598' 9-max Seat #4 is the button
Seat 1: dogBq (1030584 in chips)
Seat 2: blackaces93 (2709229 in chips)
Seat 3: 4time2warp0 (2582624 in chips)
Seat 4: khsgrizende (3198070 in chips)
Seat 5: lupninox (1466187 in chips)
Seat 6: Maikil361 (3140931 in chips)
Seat 7: hichnick777 (1711241 in chips)
Seat 9: TeddyKGB027 (2822266 in chips)
dogBq: posts the ante 7000
blackaces93: posts the ante 7000
4time2warp0: posts the ante 7000
khsgrizende: posts the ante 7000
lupninox: posts the ante 7000
Maikil361: posts the ante 7000
hichnick777: posts the ante 7000
TeddyKGB027: posts the ante 7000
lupninox: posts small blind 35000
Maikil361: posts big blind 70000
*** HOLE CARDS ***
Dealt to hichnick777 [3s 9d]
hichnick777: folds
TeddyKGB027: raises 82500 to 152500
dogBq: folds
blackaces93: raises 283250 to 435750
4time2warp0: raises 2139874 to 2575624 and is all-in
khsgrizende: folds
lupninox: folds
Maikil361: folds
TeddyKGB027: folds
blackaces93: folds
Uncalled bet (2139874) returned to 4time2warp0
4time2warp0 collected 1185000 from pot
4time2warp0: doesn't show hand
*** SUMMARY ***
Total pot 1185000 | Rake 0
Seat 1: dogBq folded before Flop (didn't bet)
Seat 2: blackaces93 folded before Flop
Seat 3: 4time2warp0 collected (1185000)
Seat 4: khsgrizende (button) folded before Flop (didn't bet)
Seat 5: lupninox (small blind) folded before Flop
Seat 6: Maikil361 (big blind) folded before Flop
Seat 7: hichnick777 folded before Flop (didn't bet)
Seat 9: TeddyKGB027 folded before Flop


*********** # 368 **************
PokerStars Hand #176680517158: Tournament #2054568934, $20+$2 USD Hold'em No Limit - Level XXXIX (40000/80000) - 2017/10/09 6:34:10 MSK [2017/10/08 23:34:10 ET]
Table '2054568934 598' 9-max Seat #5 is the button
Seat 1: dogBq (1023584 in chips)
Seat 2: blackaces93 (2266479 in chips)
Seat 3: 4time2warp0 (3324874 in chips)
Seat 4: khsgrizende (3191070 in chips)
Seat 5: lupninox (1424187 in chips)
Seat 6: Maikil361 (3063931 in chips)
Seat 7: hichnick777 (1704241 in chips)
Seat 8: dimaggress (1469853 in chips)
Seat 9: TeddyKGB027 (2662766 in chips)
dogBq: posts the ante 8000
blackaces93: posts the ante 8000
4time2warp0: posts the ante 8000
khsgrizende: posts the ante 8000
lupninox: posts the ante 8000
Maikil361: posts the ante 8000
hichnick777: posts the ante 8000
dimaggress: posts the ante 8000
TeddyKGB027: posts the ante 8000
Maikil361: posts small blind 40000
hichnick777: posts big blind 80000
*** HOLE CARDS ***
Dealt to hichnick777 [2d Ah]
dimaggress: folds
TeddyKGB027: folds
dogBq: folds
blackaces93: folds
4time2warp0: folds
khsgrizende: folds
lupninox: folds
Maikil361: folds
Uncalled bet (40000) returned to hichnick777
hichnick777 collected 152000 from pot
hichnick777: doesn't show hand
*** SUMMARY ***
Total pot 152000 | Rake 0
Seat 1: dogBq folded before Flop (didn't bet)
Seat 2: blackaces93 folded before Flop (didn't bet)
Seat 3: 4time2warp0 folded before Flop (didn't bet)
Seat 4: khsgrizende folded before Flop (didn't bet)
Seat 5: lupninox (button) folded before Flop (didn't bet)
Seat 6: Maikil361 (small blind) folded before Flop
Seat 7: hichnick777 (big blind) collected (152000)
Seat 8: dimaggress folded before Flop (didn't bet)
Seat 9: TeddyKGB027 folded before Flop (didn't bet)


*********** # 369 **************
PokerStars Hand #176680523973: Tournament #2054568934, $20+$2 USD Hold'em No Limit - Level XXXIX (40000/80000) - 2017/10/09 6:34:36 MSK [2017/10/08 23:34:36 ET]
Table '2054568934 598' 9-max Seat #6 is the button
Seat 1: dogBq (1015584 in chips)
Seat 2: blackaces93 (2258479 in chips)
Seat 3: 4time2warp0 (3316874 in chips)
Seat 4: khsgrizende (3183070 in chips)
Seat 5: lupninox (1416187 in chips)
Seat 6: Maikil361 (3015931 in chips)
Seat 7: hichnick777 (1808241 in chips)
Seat 8: dimaggress (1461853 in chips)
Seat 9: TeddyKGB027 (2654766 in chips)
dogBq: posts the ante 8000
blackaces93: posts the ante 8000
4time2warp0: posts the ante 8000
khsgrizende: posts the ante 8000
lupninox: posts the ante 8000
Maikil361: posts the ante 8000
hichnick777: posts the ante 8000
dimaggress: posts the ante 8000
TeddyKGB027: posts the ante 8000
hichnick777: posts small blind 40000
dimaggress: posts big blind 80000
*** HOLE CARDS ***
Dealt to hichnick777 [3c 6s]
TeddyKGB027: folds
dogBq: folds
blackaces93: folds
4time2warp0: folds
khsgrizende: raises 88000 to 168000
lupninox: folds
Maikil361: raises 228000 to 396000
hichnick777: folds
dimaggress: folds
khsgrizende: folds
Uncalled bet (228000) returned to Maikil361
Maikil361 collected 528000 from pot
*** SUMMARY ***
Total pot 528000 | Rake 0
Seat 1: dogBq folded before Flop (didn't bet)
Seat 2: blackaces93 folded before Flop (didn't bet)
Seat 3: 4time2warp0 folded before Flop (didn't bet)
Seat 4: khsgrizende folded before Flop
Seat 5: lupninox folded before Flop (didn't bet)
Seat 6: Maikil361 (button) collected (528000)
Seat 7: hichnick777 (small blind) folded before Flop
Seat 8: dimaggress (big blind) folded before Flop
Seat 9: TeddyKGB027 folded before Flop (didn't bet)


*********** # 370 **************
PokerStars Hand #176680535381: Tournament #2054568934, $20+$2 USD Hold'em No Limit - Level XXXIX (40000/80000) - 2017/10/09 6:35:18 MSK [2017/10/08 23:35:18 ET]
Table '2054568934 598' 9-max Seat #7 is the button
Seat 1: dogBq (1007584 in chips)
Seat 2: blackaces93 (2250479 in chips)
Seat 3: 4time2warp0 (3308874 in chips)
Seat 4: khsgrizende (3007070 in chips)
Seat 5: lupninox (1408187 in chips)
Seat 6: Maikil361 (3367931 in chips)
Seat 7: hichnick777 (1760241 in chips)
Seat 8: dimaggress (1373853 in chips)
Seat 9: TeddyKGB027 (2646766 in chips)
dogBq: posts the ante 8000
blackaces93: posts the ante 8000
4time2warp0: posts the ante 8000
khsgrizende: posts the ante 8000
lupninox: posts the ante 8000
Maikil361: posts the ante 8000
hichnick777: posts the ante 8000
dimaggress: posts the ante 8000
TeddyKGB027: posts the ante 8000
dimaggress: posts small blind 40000
TeddyKGB027: posts big blind 80000
*** HOLE CARDS ***
Dealt to hichnick777 [4c 2h]
dogBq: folds
blackaces93: folds
4time2warp0: folds
khsgrizende: folds
lupninox: folds
Maikil361: folds
hichnick777: folds
dimaggress: folds
Uncalled bet (40000) returned to TeddyKGB027
TeddyKGB027 collected 152000 from pot
TeddyKGB027: doesn't show hand
*** SUMMARY ***
Total pot 152000 | Rake 0
Seat 1: dogBq folded before Flop (didn't bet)
Seat 2: blackaces93 folded before Flop (didn't bet)
Seat 3: 4time2warp0 folded before Flop (didn't bet)
Seat 4: khsgrizende folded before Flop (didn't bet)
Seat 5: lupninox folded before Flop (didn't bet)
Seat 6: Maikil361 folded before Flop (didn't bet)
Seat 7: hichnick777 (button) folded before Flop (didn't bet)
Seat 8: dimaggress (small blind) folded before Flop
Seat 9: TeddyKGB027 (big blind) collected (152000)


*********** # 371 **************
PokerStars Hand #176680543434: Tournament #2054568934, $20+$2 USD Hold'em No Limit - Level XXXIX (40000/80000) - 2017/10/09 6:35:48 MSK [2017/10/08 23:35:48 ET]
Table '2054568934 598' 9-max Seat #8 is the button
Seat 1: dogBq (999584 in chips)
Seat 2: blackaces93 (2242479 in chips)
Seat 3: 4time2warp0 (3300874 in chips)
Seat 4: khsgrizende (2999070 in chips)
Seat 5: lupninox (1400187 in chips)
Seat 6: Maikil361 (3359931 in chips)
Seat 7: hichnick777 (1752241 in chips)
Seat 8: dimaggress (1325853 in chips)
Seat 9: TeddyKGB027 (2750766 in chips)
dogBq: posts the ante 8000
blackaces93: posts the ante 8000
4time2warp0: posts the ante 8000
khsgrizende: posts the ante 8000
lupninox: posts the ante 8000
Maikil361: posts the ante 8000
hichnick777: posts the ante 8000
dimaggress: posts the ante 8000
TeddyKGB027: posts the ante 8000
TeddyKGB027: posts small blind 40000
dogBq: posts big blind 80000
*** HOLE CARDS ***
Dealt to hichnick777 [Tc 7c]
blackaces93: folds
4time2warp0: folds
khsgrizende: folds
lupninox: folds
Maikil361: folds
hichnick777: raises 86400 to 166400
dimaggress: folds
TeddyKGB027: folds
dogBq: folds
Uncalled bet (86400) returned to hichnick777
hichnick777 collected 272000 from pot
hichnick777: doesn't show hand
*** SUMMARY ***
Total pot 272000 | Rake 0
Seat 1: dogBq (big blind) folded before Flop
Seat 2: blackaces93 folded before Flop (didn't bet)
Seat 3: 4time2warp0 folded before Flop (didn't bet)
Seat 4: khsgrizende folded before Flop (didn't bet)
Seat 5: lupninox folded before Flop (didn't bet)
Seat 6: Maikil361 folded before Flop (didn't bet)
Seat 7: hichnick777 collected (272000)
Seat 8: dimaggress (button) folded before Flop (didn't bet)
Seat 9: TeddyKGB027 (small blind) folded before Flop


*********** # 372 **************
PokerStars Hand #176680549788: Tournament #2054568934, $20+$2 USD Hold'em No Limit - Level XXXIX (40000/80000) - 2017/10/09 6:36:12 MSK [2017/10/08 23:36:12 ET]
Table '2054568934 598' 9-max Seat #9 is the button
Seat 1: dogBq (911584 in chips)
Seat 2: blackaces93 (2234479 in chips)
Seat 3: 4time2warp0 (3292874 in chips)
Seat 4: khsgrizende (2991070 in chips)
Seat 5: lupninox (1392187 in chips)
Seat 6: Maikil361 (3351931 in chips)
Seat 7: hichnick777 (1936241 in chips)
Seat 8: dimaggress (1317853 in chips)
Seat 9: TeddyKGB027 (2702766 in chips)
dogBq: posts the ante 8000
blackaces93: posts the ante 8000
4time2warp0: posts the ante 8000
khsgrizende: posts the ante 8000
lupninox: posts the ante 8000
Maikil361: posts the ante 8000
hichnick777: posts the ante 8000
dimaggress: posts the ante 8000
TeddyKGB027: posts the ante 8000
dogBq: posts small blind 40000
blackaces93: posts big blind 80000
*** HOLE CARDS ***
Dealt to hichnick777 [5c 3d]
4time2warp0: folds
khsgrizende: folds
lupninox: folds
Maikil361: raises 101800 to 181800
hichnick777: folds
dimaggress: folds
TeddyKGB027: folds
dogBq: folds
blackaces93: folds
Uncalled bet (101800) returned to Maikil361
Maikil361 collected 272000 from pot
*** SUMMARY ***
Total pot 272000 | Rake 0
Seat 1: dogBq (small blind) folded before Flop
Seat 2: blackaces93 (big blind) folded before Flop
Seat 3: 4time2warp0 folded before Flop (didn't bet)
Seat 4: khsgrizende folded before Flop (didn't bet)
Seat 5: lupninox folded before Flop (didn't bet)
Seat 6: Maikil361 collected (272000)
Seat 7: hichnick777 folded before Flop (didn't bet)
Seat 8: dimaggress folded before Flop (didn't bet)
Seat 9: TeddyKGB027 (button) folded before Flop (didn't bet)


*********** # 373 **************
PokerStars Hand #176680558940: Tournament #2054568934, $20+$2 USD Hold'em No Limit - Level XXXIX (40000/80000) - 2017/10/09 6:36:47 MSK [2017/10/08 23:36:47 ET]
Table '2054568934 598' 9-max Seat #1 is the button
Seat 1: dogBq (863584 in chips)
Seat 2: blackaces93 (2146479 in chips)
Seat 3: 4time2warp0 (3284874 in chips)
Seat 4: khsgrizende (2983070 in chips)
Seat 5: lupninox (1384187 in chips)
Seat 6: Maikil361 (3535931 in chips)
Seat 7: hichnick777 (1928241 in chips)
Seat 8: dimaggress (1309853 in chips)
Seat 9: TeddyKGB027 (2694766 in chips)
dogBq: posts the ante 8000
blackaces93: posts the ante 8000
4time2warp0: posts the ante 8000
khsgrizende: posts the ante 8000
lupninox: posts the ante 8000
Maikil361: posts the ante 8000
hichnick777: posts the ante 8000
dimaggress: posts the ante 8000
TeddyKGB027: posts the ante 8000
blackaces93: posts small blind 40000
4time2warp0: posts big blind 80000
*** HOLE CARDS ***
Dealt to hichnick777 [9h Th]
khsgrizende: folds
lupninox: folds
Maikil361: folds
hichnick777: raises 100000 to 180000
dimaggress: folds
TeddyKGB027: folds
dogBq: folds
blackaces93: folds
4time2warp0: folds
Uncalled bet (100000) returned to hichnick777
hichnick777 collected 272000 from pot
hichnick777: doesn't show hand
*** SUMMARY ***
Total pot 272000 | Rake 0
Seat 1: dogBq (button) folded before Flop (didn't bet)
Seat 2: blackaces93 (small blind) folded before Flop
Seat 3: 4time2warp0 (big blind) folded before Flop
Seat 4: khsgrizende folded before Flop (didn't bet)
Seat 5: lupninox folded before Flop (didn't bet)
Seat 6: Maikil361 folded before Flop (didn't bet)
Seat 7: hichnick777 collected (272000)
Seat 8: dimaggress folded before Flop (didn't bet)
Seat 9: TeddyKGB027 folded before Flop (didn't bet)


*********** # 374 **************
PokerStars Hand #176680572458: Tournament #2054568934, $20+$2 USD Hold'em No Limit - Level XXXIX (40000/80000) - 2017/10/09 6:37:38 MSK [2017/10/08 23:37:38 ET]
Table '2054568934 598' 9-max Seat #2 is the button
Seat 1: dogBq (855584 in chips)
Seat 2: blackaces93 (2098479 in chips)
Seat 3: 4time2warp0 (3196874 in chips)
Seat 4: khsgrizende (2975070 in chips)
Seat 5: lupninox (1376187 in chips)
Seat 6: Maikil361 (3527931 in chips)
Seat 7: hichnick777 (2112241 in chips)
Seat 8: dimaggress (1301853 in chips)
Seat 9: TeddyKGB027 (2686766 in chips)
dogBq: posts the ante 8000
blackaces93: posts the ante 8000
4time2warp0: posts the ante 8000
khsgrizende: posts the ante 8000
lupninox: posts the ante 8000
Maikil361: posts the ante 8000
hichnick777: posts the ante 8000
dimaggress: posts the ante 8000
TeddyKGB027: posts the ante 8000
4time2warp0: posts small blind 40000
khsgrizende: posts big blind 80000
*** HOLE CARDS ***
Dealt to hichnick777 [6h 5h]
lupninox: folds
Maikil361: folds
hichnick777: folds
dimaggress: raises 1213853 to 1293853 and is all-in
TeddyKGB027: folds
dogBq: folds
blackaces93: folds
4time2warp0: folds
khsgrizende: folds
Uncalled bet (1213853) returned to dimaggress
dimaggress collected 272000 from pot
dimaggress: doesn't show hand
*** SUMMARY ***
Total pot 272000 | Rake 0
Seat 1: dogBq folded before Flop (didn't bet)
Seat 2: blackaces93 (button) folded before Flop (didn't bet)
Seat 3: 4time2warp0 (small blind) folded before Flop
Seat 4: khsgrizende (big blind) folded before Flop
Seat 5: lupninox folded before Flop (didn't bet)
Seat 6: Maikil361 folded before Flop (didn't bet)
Seat 7: hichnick777 folded before Flop (didn't bet)
Seat 8: dimaggress collected (272000)
Seat 9: TeddyKGB027 folded before Flop (didn't bet)


*********** # 375 **************
PokerStars Hand #176680582202: Tournament #2054568934, $20+$2 USD Hold'em No Limit - Level XXXIX (40000/80000) - 2017/10/09 6:38:15 MSK [2017/10/08 23:38:15 ET]
Table '2054568934 598' 9-max Seat #3 is the button
Seat 1: dogBq (847584 in chips)
Seat 2: blackaces93 (2090479 in chips)
Seat 3: 4time2warp0 (3148874 in chips)
Seat 4: khsgrizende (2887070 in chips)
Seat 5: lupninox (1368187 in chips)
Seat 6: Maikil361 (3519931 in chips)
Seat 7: hichnick777 (2104241 in chips)
Seat 8: dimaggress (1485853 in chips)
Seat 9: TeddyKGB027 (2678766 in chips)
dogBq: posts the ante 8000
blackaces93: posts the ante 8000
4time2warp0: posts the ante 8000
khsgrizende: posts the ante 8000
lupninox: posts the ante 8000
Maikil361: posts the ante 8000
hichnick777: posts the ante 8000
dimaggress: posts the ante 8000
TeddyKGB027: posts the ante 8000
khsgrizende: posts small blind 40000
lupninox: posts big blind 80000
*** HOLE CARDS ***
Dealt to hichnick777 [Ah 3c]
Maikil361: folds
hichnick777: folds
dimaggress: folds
TeddyKGB027: folds
dogBq: raises 759584 to 839584 and is all-in
blackaces93: folds
4time2warp0: folds
khsgrizende: folds
lupninox: folds
Uncalled bet (759584) returned to dogBq
dogBq collected 272000 from pot
dogBq: doesn't show hand
*** SUMMARY ***
Total pot 272000 | Rake 0
Seat 1: dogBq collected (272000)
Seat 2: blackaces93 folded before Flop (didn't bet)
Seat 3: 4time2warp0 (button) folded before Flop (didn't bet)
Seat 4: khsgrizende (small blind) folded before Flop
Seat 5: lupninox (big blind) folded before Flop
Seat 6: Maikil361 folded before Flop (didn't bet)
Seat 7: hichnick777 folded before Flop (didn't bet)
Seat 8: dimaggress folded before Flop (didn't bet)
Seat 9: TeddyKGB027 folded before Flop (didn't bet)


*********** # 376 **************
PokerStars Hand #176680588278: Tournament #2054568934, $20+$2 USD Hold'em No Limit - Level XXXIX (40000/80000) - 2017/10/09 6:38:37 MSK [2017/10/08 23:38:37 ET]
Table '2054568934 598' 9-max Seat #4 is the button
Seat 1: dogBq (1031584 in chips)
Seat 2: blackaces93 (2082479 in chips)
Seat 3: 4time2warp0 (3140874 in chips)
Seat 4: khsgrizende (2839070 in chips)
Seat 5: lupninox (1280187 in chips)
Seat 6: Maikil361 (3511931 in chips)
Seat 7: hichnick777 (2096241 in chips)
Seat 8: dimaggress (1477853 in chips)
Seat 9: TeddyKGB027 (2670766 in chips)
dogBq: posts the ante 8000
blackaces93: posts the ante 8000
4time2warp0: posts the ante 8000
khsgrizende: posts the ante 8000
lupninox: posts the ante 8000
Maikil361: posts the ante 8000
hichnick777: posts the ante 8000
dimaggress: posts the ante 8000
TeddyKGB027: posts the ante 8000
lupninox: posts small blind 40000
Maikil361: posts big blind 80000
*** HOLE CARDS ***
Dealt to hichnick777 [2d 4d]
hichnick777: folds
dimaggress: folds
TeddyKGB027: folds
dogBq: folds
blackaces93: folds
4time2warp0: folds
khsgrizende: raises 88000 to 168000
lupninox: folds
Maikil361: folds
Uncalled bet (88000) returned to khsgrizende
khsgrizende collected 272000 from pot
khsgrizende: doesn't show hand
*** SUMMARY ***
Total pot 272000 | Rake 0
Seat 1: dogBq folded before Flop (didn't bet)
Seat 2: blackaces93 folded before Flop (didn't bet)
Seat 3: 4time2warp0 folded before Flop (didn't bet)
Seat 4: khsgrizende (button) collected (272000)
Seat 5: lupninox (small blind) folded before Flop
Seat 6: Maikil361 (big blind) folded before Flop
Seat 7: hichnick777 folded before Flop (didn't bet)
Seat 8: dimaggress folded before Flop (didn't bet)
Seat 9: TeddyKGB027 folded before Flop (didn't bet)


*********** # 377 **************
PokerStars Hand #176680604603: Tournament #2054568934, $20+$2 USD Hold'em No Limit - Level XXXIX (40000/80000) - 2017/10/09 6:39:40 MSK [2017/10/08 23:39:40 ET]
Table '2054568934 598' 9-max Seat #5 is the button
Seat 1: dogBq (1023584 in chips)
Seat 2: blackaces93 (2074479 in chips)
Seat 3: 4time2warp0 (3132874 in chips)
Seat 4: khsgrizende (3023070 in chips)
Seat 5: lupninox (1232187 in chips)
Seat 6: Maikil361 (3423931 in chips)
Seat 7: hichnick777 (2088241 in chips)
Seat 8: dimaggress (1469853 in chips)
Seat 9: TeddyKGB027 (2662766 in chips)
dogBq: posts the ante 8000
blackaces93: posts the ante 8000
4time2warp0: posts the ante 8000
khsgrizende: posts the ante 8000
lupninox: posts the ante 8000
Maikil361: posts the ante 8000
hichnick777: posts the ante 8000
dimaggress: posts the ante 8000
TeddyKGB027: posts the ante 8000
Maikil361: posts small blind 40000
hichnick777: posts big blind 80000
*** HOLE CARDS ***
Dealt to hichnick777 [3s Ad]
dimaggress: folds
TeddyKGB027: folds
dogBq: folds
blackaces93: folds
4time2warp0: folds
khsgrizende: folds
lupninox: raises 1144187 to 1224187 and is all-in
Maikil361: folds
hichnick777: folds
Uncalled bet (1144187) returned to lupninox
lupninox collected 272000 from pot
*** SUMMARY ***
Total pot 272000 | Rake 0
Seat 1: dogBq folded before Flop (didn't bet)
Seat 2: blackaces93 folded before Flop (didn't bet)
Seat 3: 4time2warp0 folded before Flop (didn't bet)
Seat 4: khsgrizende folded before Flop (didn't bet)
Seat 5: lupninox (button) collected (272000)
Seat 6: Maikil361 (small blind) folded before Flop
Seat 7: hichnick777 (big blind) folded before Flop
Seat 8: dimaggress folded before Flop (didn't bet)
Seat 9: TeddyKGB027 folded before Flop (didn't bet)


*********** # 378 **************
PokerStars Hand #176680614919: Tournament #2054568934, $20+$2 USD Hold'em No Limit - Level XXXIX (40000/80000) - 2017/10/09 6:40:19 MSK [2017/10/08 23:40:19 ET]
Table '2054568934 598' 9-max Seat #6 is the button
Seat 1: dogBq (1015584 in chips)
Seat 2: blackaces93 (2066479 in chips)
Seat 3: 4time2warp0 (3124874 in chips)
Seat 4: khsgrizende (3015070 in chips)
Seat 5: lupninox (1416187 in chips)
Seat 6: Maikil361 (3375931 in chips)
Seat 7: hichnick777 (2000241 in chips)
Seat 8: dimaggress (1461853 in chips)
Seat 9: TeddyKGB027 (2654766 in chips)
dogBq: posts the ante 8000
blackaces93: posts the ante 8000
4time2warp0: posts the ante 8000
khsgrizende: posts the ante 8000
lupninox: posts the ante 8000
Maikil361: posts the ante 8000
hichnick777: posts the ante 8000
dimaggress: posts the ante 8000
TeddyKGB027: posts the ante 8000
hichnick777: posts small blind 40000
dimaggress: posts big blind 80000
*** HOLE CARDS ***
Dealt to hichnick777 [9h Qc]
TeddyKGB027: folds
dogBq: folds
blackaces93: folds
4time2warp0: folds
khsgrizende: folds
lupninox: folds
Maikil361: folds
hichnick777: raises 101111 to 181111
dimaggress: folds
Uncalled bet (101111) returned to hichnick777
hichnick777 collected 232000 from pot
hichnick777: doesn't show hand
*** SUMMARY ***
Total pot 232000 | Rake 0
Seat 1: dogBq folded before Flop (didn't bet)
Seat 2: blackaces93 folded before Flop (didn't bet)
Seat 3: 4time2warp0 folded before Flop (didn't bet)
Seat 4: khsgrizende folded before Flop (didn't bet)
Seat 5: lupninox folded before Flop (didn't bet)
Seat 6: Maikil361 (button) folded before Flop (didn't bet)
Seat 7: hichnick777 (small blind) collected (232000)
Seat 8: dimaggress (big blind) folded before Flop
Seat 9: TeddyKGB027 folded before Flop (didn't bet)


*********** # 379 **************
PokerStars Hand #176680625988: Tournament #2054568934, $20+$2 USD Hold'em No Limit - Level XXXIX (40000/80000) - 2017/10/09 6:41:02 MSK [2017/10/08 23:41:02 ET]
Table '2054568934 598' 9-max Seat #7 is the button
Seat 1: dogBq (1007584 in chips)
Seat 2: blackaces93 (2058479 in chips)
Seat 3: 4time2warp0 (3116874 in chips)
Seat 4: khsgrizende (3007070 in chips)
Seat 5: lupninox (1408187 in chips)
Seat 6: Maikil361 (3367931 in chips)
Seat 7: hichnick777 (2144241 in chips)
Seat 8: dimaggress (1373853 in chips)
Seat 9: TeddyKGB027 (2646766 in chips)
dogBq: posts the ante 8000
blackaces93: posts the ante 8000
4time2warp0: posts the ante 8000
khsgrizende: posts the ante 8000
lupninox: posts the ante 8000
Maikil361: posts the ante 8000
hichnick777: posts the ante 8000
dimaggress: posts the ante 8000
TeddyKGB027: posts the ante 8000
dimaggress: posts small blind 40000
TeddyKGB027: posts big blind 80000
*** HOLE CARDS ***
Dealt to hichnick777 [6c 4d]
dogBq: folds
blackaces93: folds
4time2warp0: raises 80000 to 160000
khsgrizende: folds
lupninox: folds
Maikil361: folds
hichnick777: folds
dimaggress: folds
TeddyKGB027: folds
Uncalled bet (80000) returned to 4time2warp0
4time2warp0 collected 272000 from pot
4time2warp0: doesn't show hand
*** SUMMARY ***
Total pot 272000 | Rake 0
Seat 1: dogBq folded before Flop (didn't bet)
Seat 2: blackaces93 folded before Flop (didn't bet)
Seat 3: 4time2warp0 collected (272000)
Seat 4: khsgrizende folded before Flop (didn't bet)
Seat 5: lupninox folded before Flop (didn't bet)
Seat 6: Maikil361 folded before Flop (didn't bet)
Seat 7: hichnick777 (button) folded before Flop (didn't bet)
Seat 8: dimaggress (small blind) folded before Flop
Seat 9: TeddyKGB027 (big blind) folded before Flop


*********** # 380 **************
PokerStars Hand #176680632556: Tournament #2054568934, $20+$2 USD Hold'em No Limit - Level XXXIX (40000/80000) - 2017/10/09 6:41:27 MSK [2017/10/08 23:41:27 ET]
Table '2054568934 598' 9-max Seat #8 is the button
Seat 1: dogBq (999584 in chips)
Seat 2: blackaces93 (2050479 in chips)
Seat 3: 4time2warp0 (3300874 in chips)
Seat 4: khsgrizende (2999070 in chips)
Seat 5: lupninox (1400187 in chips)
Seat 6: Maikil361 (3359931 in chips)
Seat 7: hichnick777 (2136241 in chips)
Seat 8: dimaggress (1325853 in chips)
Seat 9: TeddyKGB027 (2558766 in chips)
dogBq: posts the ante 8000
blackaces93: posts the ante 8000
4time2warp0: posts the ante 8000
khsgrizende: posts the ante 8000
lupninox: posts the ante 8000
Maikil361: posts the ante 8000
hichnick777: posts the ante 8000
dimaggress: posts the ante 8000
TeddyKGB027: posts the ante 8000
TeddyKGB027: posts small blind 40000
dogBq: posts big blind 80000
*** HOLE CARDS ***
Dealt to hichnick777 [9s 7h]
blackaces93: folds
4time2warp0: folds
khsgrizende: folds
lupninox: folds
Maikil361: folds
hichnick777: raises 86400 to 166400
dimaggress: folds
TeddyKGB027: raises 2384366 to 2550766 and is all-in
dogBq: folds
hichnick777: folds
Uncalled bet (2384366) returned to TeddyKGB027
TeddyKGB027 collected 484800 from pot
TeddyKGB027: doesn't show hand
*** SUMMARY ***
Total pot 484800 | Rake 0
Seat 1: dogBq (big blind) folded before Flop
Seat 2: blackaces93 folded before Flop (didn't bet)
Seat 3: 4time2warp0 folded before Flop (didn't bet)
Seat 4: khsgrizende folded before Flop (didn't bet)
Seat 5: lupninox folded before Flop (didn't bet)
Seat 6: Maikil361 folded before Flop (didn't bet)
Seat 7: hichnick777 folded before Flop
Seat 8: dimaggress (button) folded before Flop (didn't bet)
Seat 9: TeddyKGB027 (small blind) collected (484800)


*********** # 381 **************
PokerStars Hand #176680643650: Tournament #2054568934, $20+$2 USD Hold'em No Limit - Level XXXIX (40000/80000) - 2017/10/09 6:42:09 MSK [2017/10/08 23:42:09 ET]
Table '2054568934 598' 9-max Seat #9 is the button
Seat 1: dogBq (911584 in chips)
Seat 2: blackaces93 (2042479 in chips)
Seat 3: 4time2warp0 (3292874 in chips)
Seat 4: khsgrizende (2991070 in chips)
Seat 5: lupninox (1392187 in chips)
Seat 6: Maikil361 (3351931 in chips)
Seat 7: hichnick777 (1961841 in chips)
Seat 8: dimaggress (1317853 in chips)
Seat 9: TeddyKGB027 (2869166 in chips)
dogBq: posts the ante 8000
blackaces93: posts the ante 8000
4time2warp0: posts the ante 8000
khsgrizende: posts the ante 8000
lupninox: posts the ante 8000
Maikil361: posts the ante 8000
hichnick777: posts the ante 8000
dimaggress: posts the ante 8000
TeddyKGB027: posts the ante 8000
dogBq: posts small blind 40000
blackaces93: posts big blind 80000
*** HOLE CARDS ***
Dealt to hichnick777 [Ks 5h]
4time2warp0: folds
khsgrizende: folds
lupninox: raises 96000 to 176000
Maikil361: folds
hichnick777: folds
dimaggress: folds
TeddyKGB027: folds
dogBq: folds
blackaces93: raises 1858479 to 2034479 and is all-in
lupninox: folds
Uncalled bet (1858479) returned to blackaces93
blackaces93 collected 464000 from pot
*** SUMMARY ***
Total pot 464000 | Rake 0
Seat 1: dogBq (small blind) folded before Flop
Seat 2: blackaces93 (big blind) collected (464000)
Seat 3: 4time2warp0 folded before Flop (didn't bet)
Seat 4: khsgrizende folded before Flop (didn't bet)
Seat 5: lupninox folded before Flop
Seat 6: Maikil361 folded before Flop (didn't bet)
Seat 7: hichnick777 folded before Flop (didn't bet)
Seat 8: dimaggress folded before Flop (didn't bet)
Seat 9: TeddyKGB027 (button) folded before Flop (didn't bet)


*********** # 382 **************
PokerStars Hand #176680656147: Tournament #2054568934, $20+$2 USD Hold'em No Limit - Level XXXIX (40000/80000) - 2017/10/09 6:42:58 MSK [2017/10/08 23:42:58 ET]
Table '2054568934 598' 9-max Seat #1 is the button
Seat 1: dogBq (863584 in chips)
Seat 2: blackaces93 (2322479 in chips)
Seat 3: 4time2warp0 (3284874 in chips)
Seat 4: khsgrizende (2983070 in chips)
Seat 5: lupninox (1208187 in chips)
Seat 6: Maikil361 (3343931 in chips)
Seat 7: hichnick777 (1953841 in chips)
Seat 8: dimaggress (1309853 in chips)
Seat 9: TeddyKGB027 (2861166 in chips)
dogBq: posts the ante 8000
blackaces93: posts the ante 8000
4time2warp0: posts the ante 8000
khsgrizende: posts the ante 8000
lupninox: posts the ante 8000
Maikil361: posts the ante 8000
hichnick777: posts the ante 8000
dimaggress: posts the ante 8000
TeddyKGB027: posts the ante 8000
blackaces93: posts small blind 40000
4time2warp0: posts big blind 80000
*** HOLE CARDS ***
Dealt to hichnick777 [8h Th]
khsgrizende: folds
lupninox: folds
Maikil361: folds
hichnick777: folds
dimaggress: folds
TeddyKGB027: folds
dogBq: folds
blackaces93: calls 40000
4time2warp0: checks
*** FLOP *** [Jc 3c 3s]
blackaces93: bets 80000
4time2warp0: folds
Uncalled bet (80000) returned to blackaces93
blackaces93 collected 232000 from pot
*** SUMMARY ***
Total pot 232000 | Rake 0
Board [Jc 3c 3s]
Seat 1: dogBq (button) folded before Flop (didn't bet)
Seat 2: blackaces93 (small blind) collected (232000)
Seat 3: 4time2warp0 (big blind) folded on the Flop
Seat 4: khsgrizende folded before Flop (didn't bet)
Seat 5: lupninox folded before Flop (didn't bet)
Seat 6: Maikil361 folded before Flop (didn't bet)
Seat 7: hichnick777 folded before Flop (didn't bet)
Seat 8: dimaggress folded before Flop (didn't bet)
Seat 9: TeddyKGB027 folded before Flop (didn't bet)


*********** # 383 **************
PokerStars Hand #176680673000: Tournament #2054568934, $20+$2 USD Hold'em No Limit - Level XXXIX (40000/80000) - 2017/10/09 6:44:03 MSK [2017/10/08 23:44:03 ET]
Table '2054568934 598' 9-max Seat #2 is the button
Seat 1: dogBq (855584 in chips)
Seat 2: blackaces93 (2466479 in chips)
Seat 3: 4time2warp0 (3196874 in chips)
Seat 4: khsgrizende (2975070 in chips)
Seat 5: lupninox (1200187 in chips)
Seat 6: Maikil361 (3335931 in chips)
Seat 7: hichnick777 (1945841 in chips)
Seat 8: dimaggress (1301853 in chips)
dogBq: posts the ante 8000
blackaces93: posts the ante 8000
4time2warp0: posts the ante 8000
khsgrizende: posts the ante 8000
lupninox: posts the ante 8000
Maikil361: posts the ante 8000
hichnick777: posts the ante 8000
dimaggress: posts the ante 8000
4time2warp0: posts small blind 40000
khsgrizende: posts big blind 80000
*** HOLE CARDS ***
Dealt to hichnick777 [7s 5c]
lupninox: folds
Maikil361: folds
hichnick777: folds
dimaggress: folds
dogBq: folds
blackaces93: folds
4time2warp0: folds
Uncalled bet (40000) returned to khsgrizende
khsgrizende collected 144000 from pot
khsgrizende: doesn't show hand
*** SUMMARY ***
Total pot 144000 | Rake 0
Seat 1: dogBq folded before Flop (didn't bet)
Seat 2: blackaces93 (button) folded before Flop (didn't bet)
Seat 3: 4time2warp0 (small blind) folded before Flop
Seat 4: khsgrizende (big blind) collected (144000)
Seat 5: lupninox folded before Flop (didn't bet)
Seat 6: Maikil361 folded before Flop (didn't bet)
Seat 7: hichnick777 folded before Flop (didn't bet)
Seat 8: dimaggress folded before Flop (didn't bet)


*********** # 384 **************
PokerStars Hand #176680678315: Tournament #2054568934, $20+$2 USD Hold'em No Limit - Level XXXIX (40000/80000) - 2017/10/09 6:44:25 MSK [2017/10/08 23:44:25 ET]
Table '2054568934 598' 9-max Seat #3 is the button
Seat 1: dogBq (847584 in chips)
Seat 2: blackaces93 (2458479 in chips)
Seat 3: 4time2warp0 (3148874 in chips)
Seat 4: khsgrizende (3071070 in chips)
Seat 5: lupninox (1192187 in chips)
Seat 6: Maikil361 (3327931 in chips)
Seat 7: hichnick777 (1937841 in chips)
Seat 8: dimaggress (1293853 in chips)
dogBq: posts the ante 8000
blackaces93: posts the ante 8000
4time2warp0: posts the ante 8000
khsgrizende: posts the ante 8000
lupninox: posts the ante 8000
Maikil361: posts the ante 8000
hichnick777: posts the ante 8000
dimaggress: posts the ante 8000
khsgrizende: posts small blind 40000
lupninox: posts big blind 80000
*** HOLE CARDS ***
Dealt to hichnick777 [4h Kc]
Maikil361: folds
hichnick777: folds
dimaggress: folds
dogBq: folds
blackaces93: raises 87770 to 167770
4time2warp0: folds
khsgrizende: folds
lupninox: folds
Uncalled bet (87770) returned to blackaces93
blackaces93 collected 264000 from pot
*** SUMMARY ***
Total pot 264000 | Rake 0
Seat 1: dogBq folded before Flop (didn't bet)
Seat 2: blackaces93 collected (264000)
Seat 3: 4time2warp0 (button) folded before Flop (didn't bet)
Seat 4: khsgrizende (small blind) folded before Flop
Seat 5: lupninox (big blind) folded before Flop
Seat 6: Maikil361 folded before Flop (didn't bet)
Seat 7: hichnick777 folded before Flop (didn't bet)
Seat 8: dimaggress folded before Flop (didn't bet)


*********** # 385 **************
PokerStars Hand #176680690231: Tournament #2054568934, $20+$2 USD Hold'em No Limit - Level XL (45000/90000) - 2017/10/09 6:45:12 MSK [2017/10/08 23:45:12 ET]
Table '2054568934 598' 9-max Seat #4 is the button
Seat 1: dogBq (839584 in chips)
Seat 2: blackaces93 (2634479 in chips)
Seat 3: 4time2warp0 (3140874 in chips)
Seat 4: khsgrizende (3023070 in chips)
Seat 5: lupninox (1104187 in chips)
Seat 6: Maikil361 (3319931 in chips)
Seat 7: hichnick777 (1929841 in chips)
Seat 8: dimaggress (1285853 in chips)
dogBq: posts the ante 9000
blackaces93: posts the ante 9000
4time2warp0: posts the ante 9000
khsgrizende: posts the ante 9000
lupninox: posts the ante 9000
Maikil361: posts the ante 9000
hichnick777: posts the ante 9000
dimaggress: posts the ante 9000
lupninox: posts small blind 45000
Maikil361: posts big blind 90000
*** HOLE CARDS ***
Dealt to hichnick777 [Qs 2d]
hichnick777: folds
dimaggress: folds
dogBq: folds
blackaces93: raises 97770 to 187770
4time2warp0: folds
khsgrizende: folds
lupninox: raises 907417 to 1095187 and is all-in
Maikil361: folds
blackaces93: folds
Uncalled bet (907417) returned to lupninox
lupninox collected 537540 from pot
*** SUMMARY ***
Total pot 537540 | Rake 0
Seat 1: dogBq folded before Flop (didn't bet)
Seat 2: blackaces93 folded before Flop
Seat 3: 4time2warp0 folded before Flop (didn't bet)
Seat 4: khsgrizende (button) folded before Flop (didn't bet)
Seat 5: lupninox (small blind) collected (537540)
Seat 6: Maikil361 (big blind) folded before Flop
Seat 7: hichnick777 folded before Flop (didn't bet)
Seat 8: dimaggress folded before Flop (didn't bet)


*********** # 386 **************
PokerStars Hand #176680704020: Tournament #2054568934, $20+$2 USD Hold'em No Limit - Level XL (45000/90000) - 2017/10/09 6:46:07 MSK [2017/10/08 23:46:07 ET]
Table '2054568934 598' 9-max Seat #5 is the button
Seat 1: dogBq (830584 in chips)
Seat 2: blackaces93 (2437709 in chips)
Seat 3: 4time2warp0 (3131874 in chips)
Seat 4: khsgrizende (3014070 in chips)
Seat 5: lupninox (1444957 in chips)
Seat 6: Maikil361 (3220931 in chips)
Seat 7: hichnick777 (1920841 in chips)
Seat 8: dimaggress (1276853 in chips)
dogBq: posts the ante 9000
blackaces93: posts the ante 9000
4time2warp0: posts the ante 9000
khsgrizende: posts the ante 9000
lupninox: posts the ante 9000
Maikil361: posts the ante 9000
hichnick777: posts the ante 9000
dimaggress: posts the ante 9000
Maikil361: posts small blind 45000
hichnick777: posts big blind 90000
*** HOLE CARDS ***
Dealt to hichnick777 [5c 4c]
dimaggress: folds
dogBq: folds
blackaces93: folds
4time2warp0: raises 90000 to 180000
khsgrizende: folds
lupninox: folds
Maikil361: folds
hichnick777: calls 90000
*** FLOP *** [2h 6d 6s]
hichnick777: checks
4time2warp0: bets 270000
hichnick777: folds
Uncalled bet (270000) returned to 4time2warp0
4time2warp0 collected 477000 from pot
4time2warp0: doesn't show hand
*** SUMMARY ***
Total pot 477000 | Rake 0
Board [2h 6d 6s]
Seat 1: dogBq folded before Flop (didn't bet)
Seat 2: blackaces93 folded before Flop (didn't bet)
Seat 3: 4time2warp0 collected (477000)
Seat 4: khsgrizende folded before Flop (didn't bet)
Seat 5: lupninox (button) folded before Flop (didn't bet)
Seat 6: Maikil361 (small blind) folded before Flop
Seat 7: hichnick777 (big blind) folded on the Flop
Seat 8: dimaggress folded before Flop (didn't bet)


*********** # 387 **************
PokerStars Hand #176680719089: Tournament #2054568934, $20+$2 USD Hold'em No Limit - Level XL (45000/90000) - 2017/10/09 6:47:06 MSK [2017/10/08 23:47:06 ET]
Table '2054568934 598' 9-max Seat #6 is the button
Seat 1: dogBq (821584 in chips)
Seat 2: blackaces93 (2428709 in chips)
Seat 3: 4time2warp0 (3419874 in chips)
Seat 4: khsgrizende (3005070 in chips)
Seat 5: lupninox (1435957 in chips)
Seat 6: Maikil361 (3166931 in chips)
Seat 7: hichnick777 (1731841 in chips)
Seat 8: dimaggress (1267853 in chips)
dogBq: posts the ante 9000
blackaces93: posts the ante 9000
4time2warp0: posts the ante 9000
khsgrizende: posts the ante 9000
lupninox: posts the ante 9000
Maikil361: posts the ante 9000
hichnick777: posts the ante 9000
dimaggress: posts the ante 9000
hichnick777: posts small blind 45000
dimaggress: posts big blind 90000
*** HOLE CARDS ***
Dealt to hichnick777 [9s 4c]
dogBq: raises 722584 to 812584 and is all-in
blackaces93: folds
4time2warp0: folds
khsgrizende: folds
lupninox: folds
Maikil361: folds
hichnick777: folds
dimaggress: folds
Uncalled bet (722584) returned to dogBq
dogBq collected 297000 from pot
dogBq: doesn't show hand
*** SUMMARY ***
Total pot 297000 | Rake 0
Seat 1: dogBq collected (297000)
Seat 2: blackaces93 folded before Flop (didn't bet)
Seat 3: 4time2warp0 folded before Flop (didn't bet)
Seat 4: khsgrizende folded before Flop (didn't bet)
Seat 5: lupninox folded before Flop (didn't bet)
Seat 6: Maikil361 (button) folded before Flop (didn't bet)
Seat 7: hichnick777 (small blind) folded before Flop
Seat 8: dimaggress (big blind) folded before Flop


*********** # 388 **************
PokerStars Hand #176680728992: Tournament #2054568934, $20+$2 USD Hold'em No Limit - Level XL (45000/90000) - 2017/10/09 6:47:44 MSK [2017/10/08 23:47:44 ET]
Table '2054568934 598' 9-max Seat #7 is the button
Seat 1: dogBq (1019584 in chips)
Seat 2: blackaces93 (2419709 in chips)
Seat 3: 4time2warp0 (3410874 in chips)
Seat 4: khsgrizende (2996070 in chips)
Seat 5: lupninox (1426957 in chips)
Seat 6: Maikil361 (3157931 in chips)
Seat 7: hichnick777 (1677841 in chips)
Seat 8: dimaggress (1168853 in chips)
dogBq: posts the ante 9000
blackaces93: posts the ante 9000
4time2warp0: posts the ante 9000
khsgrizende: posts the ante 9000
lupninox: posts the ante 9000
Maikil361: posts the ante 9000
hichnick777: posts the ante 9000
dimaggress: posts the ante 9000
dimaggress: posts small blind 45000
dogBq: posts big blind 90000
*** HOLE CARDS ***
Dealt to hichnick777 [5h 3c]
blackaces93: folds
4time2warp0: folds
khsgrizende: folds
lupninox: folds
Maikil361: raises 122400 to 212400
hichnick777: folds
dimaggress: folds
dogBq: folds
Uncalled bet (122400) returned to Maikil361
Maikil361 collected 297000 from pot
*** SUMMARY ***
Total pot 297000 | Rake 0
Seat 1: dogBq (big blind) folded before Flop
Seat 2: blackaces93 folded before Flop (didn't bet)
Seat 3: 4time2warp0 folded before Flop (didn't bet)
Seat 4: khsgrizende folded before Flop (didn't bet)
Seat 5: lupninox folded before Flop (didn't bet)
Seat 6: Maikil361 collected (297000)
Seat 7: hichnick777 (button) folded before Flop (didn't bet)
Seat 8: dimaggress (small blind) folded before Flop


*********** # 389 **************
PokerStars Hand #176680739852: Tournament #2054568934, $20+$2 USD Hold'em No Limit - Level XL (45000/90000) - 2017/10/09 6:48:28 MSK [2017/10/08 23:48:28 ET]
Table '2054568934 598' 9-max Seat #8 is the button
Seat 1: dogBq (920584 in chips)
Seat 2: blackaces93 (2410709 in chips)
Seat 3: 4time2warp0 (3401874 in chips)
Seat 4: khsgrizende (2987070 in chips)
Seat 5: lupninox (1417957 in chips)
Seat 6: Maikil361 (3355931 in chips)
Seat 7: hichnick777 (1668841 in chips)
Seat 8: dimaggress (1114853 in chips)
dogBq: posts the ante 9000
blackaces93: posts the ante 9000
4time2warp0: posts the ante 9000
khsgrizende: posts the ante 9000
lupninox: posts the ante 9000
Maikil361: posts the ante 9000
hichnick777: posts the ante 9000
dimaggress: posts the ante 9000
dogBq: posts small blind 45000
blackaces93: posts big blind 90000
*** HOLE CARDS ***
Dealt to hichnick777 [9s 5h]
4time2warp0: folds
khsgrizende: folds
lupninox: folds
Maikil361: raises 112400 to 202400
hichnick777: folds
dimaggress: folds
dogBq: folds
blackaces93: folds
Uncalled bet (112400) returned to Maikil361
Maikil361 collected 297000 from pot
*** SUMMARY ***
Total pot 297000 | Rake 0
Seat 1: dogBq (small blind) folded before Flop
Seat 2: blackaces93 (big blind) folded before Flop
Seat 3: 4time2warp0 folded before Flop (didn't bet)
Seat 4: khsgrizende folded before Flop (didn't bet)
Seat 5: lupninox folded before Flop (didn't bet)
Seat 6: Maikil361 collected (297000)
Seat 7: hichnick777 folded before Flop (didn't bet)
Seat 8: dimaggress (button) folded before Flop (didn't bet)


*********** # 390 **************
PokerStars Hand #176680749654: Tournament #2054568934, $20+$2 USD Hold'em No Limit - Level XL (45000/90000) - 2017/10/09 6:49:07 MSK [2017/10/08 23:49:07 ET]
Table '2054568934 598' 9-max Seat #1 is the button
Seat 1: dogBq (866584 in chips)
Seat 2: blackaces93 (2311709 in chips)
Seat 3: 4time2warp0 (3392874 in chips)
Seat 4: khsgrizende (2978070 in chips)
Seat 5: lupninox (1408957 in chips)
Seat 6: Maikil361 (3553931 in chips)
Seat 7: hichnick777 (1659841 in chips)
Seat 8: dimaggress (1105853 in chips)
dogBq: posts the ante 9000
blackaces93: posts the ante 9000
4time2warp0: posts the ante 9000
khsgrizende: posts the ante 9000
lupninox: posts the ante 9000
Maikil361: posts the ante 9000
hichnick777: posts the ante 9000
dimaggress: posts the ante 9000
blackaces93: posts small blind 45000
4time2warp0: posts big blind 90000
*** HOLE CARDS ***
Dealt to hichnick777 [8s 6h]
khsgrizende: folds
lupninox: folds
Maikil361: raises 95400 to 185400
hichnick777: folds
dimaggress: folds
dogBq: folds
blackaces93: raises 2117309 to 2302709 and is all-in
4time2warp0: folds
Maikil361: folds [Qc As]
Uncalled bet (2117309) returned to blackaces93
blackaces93 collected 532800 from pot
blackaces93: doesn't show hand
*** SUMMARY ***
Total pot 532800 | Rake 0
Seat 1: dogBq (button) folded before Flop (didn't bet)
Seat 2: blackaces93 (small blind) collected (532800)
Seat 3: 4time2warp0 (big blind) folded before Flop
Seat 4: khsgrizende folded before Flop (didn't bet)
Seat 5: lupninox folded before Flop (didn't bet)
Seat 6: Maikil361 folded before Flop
Seat 7: hichnick777 folded before Flop (didn't bet)
Seat 8: dimaggress folded before Flop (didn't bet)


*********** # 391 **************
PokerStars Hand #176680764736: Tournament #2054568934, $20+$2 USD Hold'em No Limit - Level XL (45000/90000) - 2017/10/09 6:50:06 MSK [2017/10/08 23:50:06 ET]
Table '2054568934 598' 9-max Seat #2 is the button
Seat 1: dogBq (857584 in chips)
Seat 2: blackaces93 (2650109 in chips)
Seat 3: 4time2warp0 (3293874 in chips)
Seat 4: khsgrizende (2969070 in chips)
Seat 5: lupninox (1399957 in chips)
Seat 6: Maikil361 (3359531 in chips)
Seat 7: hichnick777 (1650841 in chips)
Seat 8: dimaggress (1096853 in chips)
dogBq: posts the ante 9000
blackaces93: posts the ante 9000
4time2warp0: posts the ante 9000
khsgrizende: posts the ante 9000
lupninox: posts the ante 9000
Maikil361: posts the ante 9000
hichnick777: posts the ante 9000
dimaggress: posts the ante 9000
4time2warp0: posts small blind 45000
khsgrizende: posts big blind 90000
*** HOLE CARDS ***
Dealt to hichnick777 [7c 9s]
lupninox: raises 90000 to 180000
Maikil361: folds
hichnick777: folds
dimaggress: folds
dogBq: folds
blackaces93: folds
4time2warp0: folds
khsgrizende: calls 90000
*** FLOP *** [Kd Js 8c]
khsgrizende: checks
lupninox: checks
*** TURN *** [Kd Js 8c] [7h]
khsgrizende: checks
lupninox: bets 171720
khsgrizende: folds
Uncalled bet (171720) returned to lupninox
lupninox collected 477000 from pot
*** SUMMARY ***
Total pot 477000 | Rake 0
Board [Kd Js 8c 7h]
Seat 1: dogBq folded before Flop (didn't bet)
Seat 2: blackaces93 (button) folded before Flop (didn't bet)
Seat 3: 4time2warp0 (small blind) folded before Flop
Seat 4: khsgrizende (big blind) folded on the Turn
Seat 5: lupninox collected (477000)
Seat 6: Maikil361 folded before Flop (didn't bet)
Seat 7: hichnick777 folded before Flop (didn't bet)
Seat 8: dimaggress folded before Flop (didn't bet)


*********** # 392 **************
PokerStars Hand #176680788633: Tournament #2054568934, $20+$2 USD Hold'em No Limit - Level XL (45000/90000) - 2017/10/09 6:51:22 MSK [2017/10/08 23:51:22 ET]
Table '2054568934 598' 9-max Seat #3 is the button
Seat 1: dogBq (848584 in chips)
Seat 2: blackaces93 (2641109 in chips)
Seat 3: 4time2warp0 (3239874 in chips)
Seat 4: khsgrizende (2780070 in chips)
Seat 5: lupninox (1687957 in chips)
Seat 6: Maikil361 (3350531 in chips)
Seat 7: hichnick777 (1641841 in chips)
Seat 8: dimaggress (1087853 in chips)
dogBq: posts the ante 9000
blackaces93: posts the ante 9000
4time2warp0: posts the ante 9000
khsgrizende: posts the ante 9000
lupninox: posts the ante 9000
Maikil361: posts the ante 9000
hichnick777: posts the ante 9000
dimaggress: posts the ante 9000
khsgrizende: posts small blind 45000
lupninox: posts big blind 90000
*** HOLE CARDS ***
Dealt to hichnick777 [Jd Jh]
Maikil361: folds
hichnick777: raises 112500 to 202500
dimaggress: folds
dogBq: folds
blackaces93: folds
4time2warp0: folds
khsgrizende: folds
lupninox: folds
Uncalled bet (112500) returned to hichnick777
hichnick777 collected 297000 from pot
hichnick777: doesn't show hand
*** SUMMARY ***
Total pot 297000 | Rake 0
Seat 1: dogBq folded before Flop (didn't bet)
Seat 2: blackaces93 folded before Flop (didn't bet)
Seat 3: 4time2warp0 (button) folded before Flop (didn't bet)
Seat 4: khsgrizende (small blind) folded before Flop
Seat 5: lupninox (big blind) folded before Flop
Seat 6: Maikil361 folded before Flop (didn't bet)
Seat 7: hichnick777 collected (297000)
Seat 8: dimaggress folded before Flop (didn't bet)


*********** # 393 **************
PokerStars Hand #176680798544: Tournament #2054568934, $20+$2 USD Hold'em No Limit - Level XL (45000/90000) - 2017/10/09 6:52:01 MSK [2017/10/08 23:52:01 ET]
Table '2054568934 598' 9-max Seat #4 is the button
Seat 1: dogBq (839584 in chips)
Seat 2: blackaces93 (2632109 in chips)
Seat 3: 4time2warp0 (3230874 in chips)
Seat 4: khsgrizende (2726070 in chips)
Seat 5: lupninox (1588957 in chips)
Seat 6: Maikil361 (3341531 in chips)
Seat 7: hichnick777 (1839841 in chips)
Seat 8: dimaggress (1078853 in chips)
dogBq: posts the ante 9000
blackaces93: posts the ante 9000
4time2warp0: posts the ante 9000
khsgrizende: posts the ante 9000
lupninox: posts the ante 9000
Maikil361: posts the ante 9000
hichnick777: posts the ante 9000
dimaggress: posts the ante 9000
lupninox: posts small blind 45000
Maikil361: posts big blind 90000
*** HOLE CARDS ***
Dealt to hichnick777 [6d 8c]
hichnick777: folds
dimaggress: folds
dogBq: folds
blackaces93: folds
4time2warp0: folds
khsgrizende: raises 99000 to 189000
lupninox: calls 144000
Maikil361: raises 339000 to 528000
khsgrizende: calls 339000
lupninox: folds
*** FLOP *** [4s 7d Kd]
Maikil361: checks
khsgrizende: bets 408270
Maikil361: calls 408270
*** TURN *** [4s 7d Kd] [4d]
Maikil361: checks
khsgrizende: bets 1780800 and is all-in
Maikil361: folds
Uncalled bet (1780800) returned to khsgrizende
khsgrizende collected 2133540 from pot
khsgrizende: doesn't show hand
*** SUMMARY ***
Total pot 2133540 | Rake 0
Board [4s 7d Kd 4d]
Seat 1: dogBq folded before Flop (didn't bet)
Seat 2: blackaces93 folded before Flop (didn't bet)
Seat 3: 4time2warp0 folded before Flop (didn't bet)
Seat 4: khsgrizende (button) collected (2133540)
Seat 5: lupninox (small blind) folded before Flop
Seat 6: Maikil361 (big blind) folded on the Turn
Seat 7: hichnick777 folded before Flop (didn't bet)
Seat 8: dimaggress folded before Flop (didn't bet)


*********** # 394 **************
PokerStars Hand #176680836063: Tournament #2054568934, $20+$2 USD Hold'em No Limit - Level XL (45000/90000) - 2017/10/09 6:54:30 MSK [2017/10/08 23:54:30 ET]
Table '2054568934 598' 9-max Seat #5 is the button
Seat 1: dogBq (830584 in chips)
Seat 2: blackaces93 (2623109 in chips)
Seat 3: 4time2warp0 (3221874 in chips)
Seat 4: khsgrizende (3914340 in chips)
Seat 5: lupninox (1390957 in chips)
Seat 6: Maikil361 (2396261 in chips)
Seat 7: hichnick777 (1830841 in chips)
Seat 8: dimaggress (1069853 in chips)
dogBq: posts the ante 9000
blackaces93: posts the ante 9000
4time2warp0: posts the ante 9000
khsgrizende: posts the ante 9000
lupninox: posts the ante 9000
Maikil361: posts the ante 9000
hichnick777: posts the ante 9000
dimaggress: posts the ante 9000
Maikil361: posts small blind 45000
hichnick777: posts big blind 90000
*** HOLE CARDS ***
Dealt to hichnick777 [3c 4s]
dimaggress: folds
dogBq: folds
blackaces93: raises 97770 to 187770
4time2warp0: raises 257886 to 445656
khsgrizende: folds
lupninox: folds
Maikil361: folds
hichnick777: folds
blackaces93: calls 257886
*** FLOP *** [Kh 4d 4c]
blackaces93: checks
4time2warp0: checks
*** TURN *** [Kh 4d 4c] [5s]
blackaces93: checks
4time2warp0: bets 445654
blackaces93: folds
Uncalled bet (445654) returned to 4time2warp0
4time2warp0 collected 1098312 from pot
4time2warp0: doesn't show hand
*** SUMMARY ***
Total pot 1098312 | Rake 0
Board [Kh 4d 4c 5s]
Seat 1: dogBq folded before Flop (didn't bet)
Seat 2: blackaces93 folded on the Turn
Seat 3: 4time2warp0 collected (1098312)
Seat 4: khsgrizende folded before Flop (didn't bet)
Seat 5: lupninox (button) folded before Flop (didn't bet)
Seat 6: Maikil361 (small blind) folded before Flop
Seat 7: hichnick777 (big blind) folded before Flop
Seat 8: dimaggress folded before Flop (didn't bet)


*********** # 395 **************
PokerStars Hand #176680926602: Tournament #2054568934, $20+$2 USD Hold'em No Limit - Level XL (45000/90000) - 2017/10/09 7:01:14 MSK [2017/10/09 0:01:14 ET]
Table '2054568934 598' 9-max Seat #6 is the button
Seat 1: dogBq (821584 in chips)
Seat 2: blackaces93 (2168453 in chips)
Seat 3: 4time2warp0 (3865530 in chips)
Seat 4: khsgrizende (3905340 in chips)
Seat 5: lupninox (1381957 in chips)
Seat 6: Maikil361 (2342261 in chips)
Seat 7: hichnick777 (1731841 in chips)
Seat 8: dimaggress (1060853 in chips)
dogBq: posts the ante 9000
blackaces93: posts the ante 9000
4time2warp0: posts the ante 9000
khsgrizende: posts the ante 9000
lupninox: posts the ante 9000
Maikil361: posts the ante 9000
hichnick777: posts the ante 9000
dimaggress: posts the ante 9000
hichnick777: posts small blind 45000
dimaggress: posts big blind 90000
*** HOLE CARDS ***
Dealt to hichnick777 [4c 3c]
dogBq: raises 722584 to 812584 and is all-in
blackaces93: folds
4time2warp0: raises 722584 to 1535168
khsgrizende: folds
lupninox: folds
Maikil361: folds
hichnick777: folds
dimaggress: folds
Uncalled bet (722584) returned to 4time2warp0
*** FLOP *** [6c 2h 2d]
*** TURN *** [6c 2h 2d] [Jh]
*** RIVER *** [6c 2h 2d Jh] [4d]
*** SHOW DOWN ***
dogBq: shows [As Js] (two pair, Jacks and Deuces)
4time2warp0: shows [Tc Th] (two pair, Tens and Deuces)
dogBq collected 1832168 from pot
*** SUMMARY ***
Total pot 1832168 | Rake 0
Board [6c 2h 2d Jh 4d]
Seat 1: dogBq showed [As Js] and won (1832168) with two pair, Jacks and Deuces
Seat 2: blackaces93 folded before Flop (didn't bet)
Seat 3: 4time2warp0 showed [Tc Th] and lost with two pair, Tens and Deuces
Seat 4: khsgrizende folded before Flop (didn't bet)
Seat 5: lupninox folded before Flop (didn't bet)
Seat 6: Maikil361 (button) folded before Flop (didn't bet)
Seat 7: hichnick777 (small blind) folded before Flop
Seat 8: dimaggress (big blind) folded before Flop


*********** # 396 **************
PokerStars Hand #176680942941: Tournament #2054568934, $20+$2 USD Hold'em No Limit - Level XL (45000/90000) - 2017/10/09 7:02:21 MSK [2017/10/09 0:02:21 ET]
Table '2054568934 598' 9-max Seat #7 is the button
Seat 1: dogBq (1832168 in chips)
Seat 2: blackaces93 (2159453 in chips)
Seat 3: 4time2warp0 (3043946 in chips)
Seat 4: khsgrizende (3896340 in chips)
Seat 5: lupninox (1372957 in chips)
Seat 6: Maikil361 (2333261 in chips)
Seat 7: hichnick777 (1677841 in chips)
Seat 8: dimaggress (961853 in chips)
dogBq: posts the ante 9000
blackaces93: posts the ante 9000
4time2warp0: posts the ante 9000
khsgrizende: posts the ante 9000
lupninox: posts the ante 9000
Maikil361: posts the ante 9000
hichnick777: posts the ante 9000
dimaggress: posts the ante 9000
dimaggress: posts small blind 45000
dogBq: posts big blind 90000
*** HOLE CARDS ***
Dealt to hichnick777 [Th Ac]
blackaces93: folds
4time2warp0: folds
khsgrizende: folds
lupninox: folds
Maikil361: raises 122400 to 212400
hichnick777: calls 212400
dimaggress: folds
dogBq: folds
*** FLOP *** [4h Kh Js]
Maikil361: checks
hichnick777: bets 233333
Maikil361: calls 233333
*** TURN *** [4h Kh Js] [9h]
Maikil361: checks
hichnick777: bets 1223108 and is all-in
Maikil361 has timed out
Maikil361: folds
Uncalled bet (1223108) returned to hichnick777
Maikil361 is sitting out
hichnick777 collected 1098466 from pot
Maikil361 has returned
hichnick777: doesn't show hand
*** SUMMARY ***
Total pot 1098466 | Rake 0
Board [4h Kh Js 9h]
Seat 1: dogBq (big blind) folded before Flop
Seat 2: blackaces93 folded before Flop (didn't bet)
Seat 3: 4time2warp0 folded before Flop (didn't bet)
Seat 4: khsgrizende folded before Flop (didn't bet)
Seat 5: lupninox folded before Flop (didn't bet)
Seat 6: Maikil361 folded on the Turn
Seat 7: hichnick777 (button) collected (1098466)
Seat 8: dimaggress (small blind) folded before Flop


*********** # 397 **************
PokerStars Hand #176680978747: Tournament #2054568934, $20+$2 USD Hold'em No Limit - Level XLI (50000/100000) - 2017/10/09 7:04:51 MSK [2017/10/09 0:04:51 ET]
Table '2054568934 598' 9-max Seat #8 is the button
Seat 1: dogBq (1733168 in chips)
Seat 2: blackaces93 (2150453 in chips)
Seat 3: 4time2warp0 (3034946 in chips)
Seat 4: khsgrizende (3887340 in chips)
Seat 5: lupninox (1363957 in chips)
Seat 6: Maikil361 (1878528 in chips)
Seat 7: hichnick777 (2321574 in chips)
Seat 8: dimaggress (907853 in chips)
dogBq: posts the ante 10000
blackaces93: posts the ante 10000
4time2warp0: posts the ante 10000
khsgrizende: posts the ante 10000
lupninox: posts the ante 10000
Maikil361: posts the ante 10000
hichnick777: posts the ante 10000
dimaggress: posts the ante 10000
dogBq: posts small blind 50000
blackaces93: posts big blind 100000
*** HOLE CARDS ***
Dealt to hichnick777 [2d 2h]
4time2warp0: folds
khsgrizende: folds
lupninox: folds
Maikil361: folds
hichnick777: raises 108000 to 208000
dimaggress: folds
dogBq: folds
blackaces93: calls 108000
*** FLOP *** [Qs Kh Ac]
blackaces93: checks
hichnick777: bets 180180
blackaces93: folds
Uncalled bet (180180) returned to hichnick777
hichnick777 collected 546000 from pot
hichnick777: doesn't show hand
*** SUMMARY ***
Total pot 546000 | Rake 0
Board [Qs Kh Ac]
Seat 1: dogBq (small blind) folded before Flop
Seat 2: blackaces93 (big blind) folded on the Flop
Seat 3: 4time2warp0 folded before Flop (didn't bet)
Seat 4: khsgrizende folded before Flop (didn't bet)
Seat 5: lupninox folded before Flop (didn't bet)
Seat 6: Maikil361 folded before Flop (didn't bet)
Seat 7: hichnick777 collected (546000)
Seat 8: dimaggress (button) folded before Flop (didn't bet)


*********** # 398 **************
PokerStars Hand #176680989371: Tournament #2054568934, $20+$2 USD Hold'em No Limit - Level XLI (50000/100000) - 2017/10/09 7:05:34 MSK [2017/10/09 0:05:34 ET]
Table '2054568934 598' 9-max Seat #1 is the button
Seat 1: dogBq (1673168 in chips)
Seat 2: blackaces93 (1932453 in chips)
Seat 3: 4time2warp0 (3024946 in chips)
Seat 4: khsgrizende (3877340 in chips)
Seat 5: lupninox (1353957 in chips)
Seat 6: Maikil361 (1868528 in chips)
Seat 7: hichnick777 (2649574 in chips)
Seat 8: dimaggress (897853 in chips)
dogBq: posts the ante 10000
blackaces93: posts the ante 10000
4time2warp0: posts the ante 10000
khsgrizende: posts the ante 10000
lupninox: posts the ante 10000
Maikil361: posts the ante 10000
hichnick777: posts the ante 10000
dimaggress: posts the ante 10000
blackaces93: posts small blind 50000
4time2warp0: posts big blind 100000
*** HOLE CARDS ***
Dealt to hichnick777 [4d 8s]
khsgrizende: folds
lupninox: folds
Maikil361: folds
hichnick777: folds
dimaggress: folds
dogBq: folds
blackaces93: calls 50000
4time2warp0: checks
*** FLOP *** [Jc 3c Kh]
blackaces93: bets 100000
4time2warp0: folds
Uncalled bet (100000) returned to blackaces93
blackaces93 collected 280000 from pot
blackaces93: doesn't show hand
*** SUMMARY ***
Total pot 280000 | Rake 0
Board [Jc 3c Kh]
Seat 1: dogBq (button) folded before Flop (didn't bet)
Seat 2: blackaces93 (small blind) collected (280000)
Seat 3: 4time2warp0 (big blind) folded on the Flop
Seat 4: khsgrizende folded before Flop (didn't bet)
Seat 5: lupninox folded before Flop (didn't bet)
Seat 6: Maikil361 folded before Flop (didn't bet)
Seat 7: hichnick777 folded before Flop (didn't bet)
Seat 8: dimaggress folded before Flop (didn't bet)


*********** # 399 **************
PokerStars Hand #176681003296: Tournament #2054568934, $20+$2 USD Hold'em No Limit - Level XLI (50000/100000) - 2017/10/09 7:06:31 MSK [2017/10/09 0:06:31 ET]
Table '2054568934 598' 9-max Seat #2 is the button
Seat 1: dogBq (1663168 in chips)
Seat 2: blackaces93 (2102453 in chips)
Seat 3: 4time2warp0 (2914946 in chips)
Seat 4: khsgrizende (3867340 in chips)
Seat 5: lupninox (1343957 in chips)
Seat 6: Maikil361 (1858528 in chips)
Seat 7: hichnick777 (2639574 in chips)
Seat 8: dimaggress (887853 in chips)
dogBq: posts the ante 10000
blackaces93: posts the ante 10000
4time2warp0: posts the ante 10000
khsgrizende: posts the ante 10000
lupninox: posts the ante 10000
Maikil361: posts the ante 10000
hichnick777: posts the ante 10000
dimaggress: posts the ante 10000
4time2warp0: posts small blind 50000
khsgrizende: posts big blind 100000
*** HOLE CARDS ***
Dealt to hichnick777 [5d 9h]
lupninox: folds
Maikil361: raises 106000 to 206000
hichnick777: folds
dimaggress: raises 671853 to 877853 and is all-in
dogBq: folds
blackaces93: folds
4time2warp0: folds
khsgrizende: folds
Maikil361: calls 671853
*** FLOP *** [9s 2s Qs]
*** TURN *** [9s 2s Qs] [6c]
*** RIVER *** [9s 2s Qs 6c] [7s]
*** SHOW DOWN ***
Maikil361: shows [Qh Ac] (a pair of Queens)
dimaggress: shows [6s 6d] (a flush, Queen high)
dimaggress collected 1985706 from pot
*** SUMMARY ***
Total pot 1985706 | Rake 0
Board [9s 2s Qs 6c 7s]
Seat 1: dogBq folded before Flop (didn't bet)
Seat 2: blackaces93 (button) folded before Flop (didn't bet)
Seat 3: 4time2warp0 (small blind) folded before Flop
Seat 4: khsgrizende (big blind) folded before Flop
Seat 5: lupninox folded before Flop (didn't bet)
Seat 6: Maikil361 showed [Qh Ac] and lost with a pair of Queens
Seat 7: hichnick777 folded before Flop (didn't bet)
Seat 8: dimaggress showed [6s 6d] and won (1985706) with a flush, Queen high


*********** # 400 **************
PokerStars Hand #176681013772: Tournament #2054568934, $20+$2 USD Hold'em No Limit - Level XLI (50000/100000) - 2017/10/09 7:07:15 MSK [2017/10/09 0:07:15 ET]
Table '2054568934 598' 9-max Seat #3 is the button
Seat 1: dogBq (1653168 in chips)
Seat 2: blackaces93 (2092453 in chips)
Seat 3: 4time2warp0 (2854946 in chips)
Seat 4: khsgrizende (3757340 in chips)
Seat 5: lupninox (1333957 in chips)
Seat 6: Maikil361 (970675 in chips)
Seat 7: hichnick777 (2629574 in chips)
Seat 8: dimaggress (1985706 in chips)
dogBq: posts the ante 10000
blackaces93: posts the ante 10000
4time2warp0: posts the ante 10000
khsgrizende: posts the ante 10000
lupninox: posts the ante 10000
Maikil361: posts the ante 10000
hichnick777: posts the ante 10000
dimaggress: posts the ante 10000
khsgrizende: posts small blind 50000
lupninox: posts big blind 100000
*** HOLE CARDS ***
Dealt to hichnick777 [3h 4d]
Maikil361: folds
hichnick777: folds
dimaggress: folds
dogBq: folds
blackaces93: raises 102222 to 202222
4time2warp0: folds
khsgrizende: folds
lupninox: calls 102222
*** FLOP *** [Qc 9s 8h]
lupninox: checks
blackaces93: bets 167744
lupninox: folds
Uncalled bet (167744) returned to blackaces93
blackaces93 collected 534444 from pot
*** SUMMARY ***
Total pot 534444 | Rake 0
Board [Qc 9s 8h]
Seat 1: dogBq folded before Flop (didn't bet)
Seat 2: blackaces93 collected (534444)
Seat 3: 4time2warp0 (button) folded before Flop (didn't bet)
Seat 4: khsgrizende (small blind) folded before Flop
Seat 5: lupninox (big blind) folded on the Flop
Seat 6: Maikil361 folded before Flop (didn't bet)
Seat 7: hichnick777 folded before Flop (didn't bet)
Seat 8: dimaggress folded before Flop (didn't bet)


*********** # 401 **************
PokerStars Hand #176681032619: Tournament #2054568934, $20+$2 USD Hold'em No Limit - Level XLI (50000/100000) - 2017/10/09 7:08:33 MSK [2017/10/09 0:08:33 ET]
Table '2054568934 598' 9-max Seat #4 is the button
Seat 1: dogBq (1643168 in chips)
Seat 2: blackaces93 (2414675 in chips)
Seat 3: 4time2warp0 (2844946 in chips)
Seat 4: khsgrizende (3697340 in chips)
Seat 5: lupninox (1121735 in chips)
Seat 6: Maikil361 (960675 in chips)
Seat 7: hichnick777 (2619574 in chips)
Seat 8: dimaggress (1975706 in chips)
dogBq: posts the ante 10000
blackaces93: posts the ante 10000
4time2warp0: posts the ante 10000
khsgrizende: posts the ante 10000
lupninox: posts the ante 10000
Maikil361: posts the ante 10000
hichnick777: posts the ante 10000
dimaggress: posts the ante 10000
lupninox: posts small blind 50000
Maikil361: posts big blind 100000
*** HOLE CARDS ***
Dealt to hichnick777 [5c 2c]
hichnick777: folds
dimaggress: folds
dogBq: folds
blackaces93: folds
4time2warp0: raises 100000 to 200000
khsgrizende: folds
lupninox: folds
Maikil361: folds
Uncalled bet (100000) returned to 4time2warp0
4time2warp0 collected 330000 from pot
4time2warp0: doesn't show hand
*** SUMMARY ***
Total pot 330000 | Rake 0
Seat 1: dogBq folded before Flop (didn't bet)
Seat 2: blackaces93 folded before Flop (didn't bet)
Seat 3: 4time2warp0 collected (330000)
Seat 4: khsgrizende (button) folded before Flop (didn't bet)
Seat 5: lupninox (small blind) folded before Flop
Seat 6: Maikil361 (big blind) folded before Flop
Seat 7: hichnick777 folded before Flop (didn't bet)
Seat 8: dimaggress folded before Flop (didn't bet)


*********** # 402 **************
PokerStars Hand #176681040558: Tournament #2054568934, $20+$2 USD Hold'em No Limit - Level XLI (50000/100000) - 2017/10/09 7:09:06 MSK [2017/10/09 0:09:06 ET]
Table '2054568934 598' 9-max Seat #5 is the button
Seat 1: dogBq (1633168 in chips)
Seat 2: blackaces93 (2404675 in chips)
Seat 3: 4time2warp0 (3064946 in chips)
Seat 4: khsgrizende (3687340 in chips)
Seat 5: lupninox (1061735 in chips)
Seat 6: Maikil361 (850675 in chips)
Seat 7: hichnick777 (2609574 in chips)
Seat 8: dimaggress (1965706 in chips)
dogBq: posts the ante 10000
blackaces93: posts the ante 10000
4time2warp0: posts the ante 10000
khsgrizende: posts the ante 10000
lupninox: posts the ante 10000
Maikil361: posts the ante 10000
hichnick777: posts the ante 10000
dimaggress: posts the ante 10000
Maikil361: posts small blind 50000
hichnick777: posts big blind 100000
*** HOLE CARDS ***
Dealt to hichnick777 [4d 6h]
dimaggress: folds
dogBq: folds
blackaces93: folds
4time2warp0: folds
khsgrizende: folds
lupninox: folds
Maikil361: raises 740675 to 840675 and is all-in
hichnick777: folds
Uncalled bet (740675) returned to Maikil361
Maikil361 collected 280000 from pot
*** SUMMARY ***
Total pot 280000 | Rake 0
Seat 1: dogBq folded before Flop (didn't bet)
Seat 2: blackaces93 folded before Flop (didn't bet)
Seat 3: 4time2warp0 folded before Flop (didn't bet)
Seat 4: khsgrizende folded before Flop (didn't bet)
Seat 5: lupninox (button) folded before Flop (didn't bet)
Seat 6: Maikil361 (small blind) collected (280000)
Seat 7: hichnick777 (big blind) folded before Flop
Seat 8: dimaggress folded before Flop (didn't bet)


*********** # 403 **************
PokerStars Hand #176681048603: Tournament #2054568934, $20+$2 USD Hold'em No Limit - Level XLI (50000/100000) - 2017/10/09 7:09:40 MSK [2017/10/09 0:09:40 ET]
Table '2054568934 598' 9-max Seat #6 is the button
Seat 1: dogBq (1623168 in chips)
Seat 2: blackaces93 (2394675 in chips)
Seat 3: 4time2warp0 (3054946 in chips)
Seat 4: khsgrizende (3677340 in chips)
Seat 5: lupninox (1051735 in chips)
Seat 6: Maikil361 (1020675 in chips)
Seat 7: hichnick777 (2499574 in chips)
Seat 8: dimaggress (1955706 in chips)
dogBq: posts the ante 10000
blackaces93: posts the ante 10000
4time2warp0: posts the ante 10000
khsgrizende: posts the ante 10000
lupninox: posts the ante 10000
Maikil361: posts the ante 10000
hichnick777: posts the ante 10000
dimaggress: posts the ante 10000
hichnick777: posts small blind 50000
dimaggress: posts big blind 100000
*** HOLE CARDS ***
Dealt to hichnick777 [5h 2h]
dogBq: folds
blackaces93: folds
4time2warp0: folds
khsgrizende: raises 110000 to 210000
lupninox: folds
Maikil361: folds
hichnick777: folds
dimaggress: folds
Uncalled bet (110000) returned to khsgrizende
khsgrizende collected 330000 from pot
khsgrizende: doesn't show hand
*** SUMMARY ***
Total pot 330000 | Rake 0
Seat 1: dogBq folded before Flop (didn't bet)
Seat 2: blackaces93 folded before Flop (didn't bet)
Seat 3: 4time2warp0 folded before Flop (didn't bet)
Seat 4: khsgrizende collected (330000)
Seat 5: lupninox folded before Flop (didn't bet)
Seat 6: Maikil361 (button) folded before Flop (didn't bet)
Seat 7: hichnick777 (small blind) folded before Flop
Seat 8: dimaggress (big blind) folded before Flop


*********** # 404 **************
PokerStars Hand #176681059762: Tournament #2054568934, $20+$2 USD Hold'em No Limit - Level XLI (50000/100000) - 2017/10/09 7:10:27 MSK [2017/10/09 0:10:27 ET]
Table '2054568934 598' 9-max Seat #7 is the button
Seat 1: dogBq (1613168 in chips)
Seat 2: blackaces93 (2384675 in chips)
Seat 3: 4time2warp0 (3044946 in chips)
Seat 4: khsgrizende (3897340 in chips)
Seat 5: lupninox (1041735 in chips)
Seat 6: Maikil361 (1010675 in chips)
Seat 7: hichnick777 (2439574 in chips)
Seat 8: dimaggress (1845706 in chips)
dogBq: posts the ante 10000
blackaces93: posts the ante 10000
4time2warp0: posts the ante 10000
khsgrizende: posts the ante 10000
lupninox: posts the ante 10000
Maikil361: posts the ante 10000
hichnick777: posts the ante 10000
dimaggress: posts the ante 10000
dimaggress: posts small blind 50000
dogBq: posts big blind 100000
*** HOLE CARDS ***
Dealt to hichnick777 [2c 8s]
blackaces93: raises 102222 to 202222
4time2warp0: folds
khsgrizende: folds
lupninox: folds
Maikil361: folds
hichnick777: folds
dimaggress: folds
dogBq: folds
Uncalled bet (102222) returned to blackaces93
blackaces93 collected 330000 from pot
*** SUMMARY ***
Total pot 330000 | Rake 0
Seat 1: dogBq (big blind) folded before Flop
Seat 2: blackaces93 collected (330000)
Seat 3: 4time2warp0 folded before Flop (didn't bet)
Seat 4: khsgrizende folded before Flop (didn't bet)
Seat 5: lupninox folded before Flop (didn't bet)
Seat 6: Maikil361 folded before Flop (didn't bet)
Seat 7: hichnick777 (button) folded before Flop (didn't bet)
Seat 8: dimaggress (small blind) folded before Flop


*********** # 405 **************
PokerStars Hand #176681073229: Tournament #2054568934, $20+$2 USD Hold'em No Limit - Level XLI (50000/100000) - 2017/10/09 7:11:23 MSK [2017/10/09 0:11:23 ET]
Table '2054568934 598' 9-max Seat #8 is the button
Seat 1: dogBq (1503168 in chips)
Seat 2: blackaces93 (2604675 in chips)
Seat 3: 4time2warp0 (3034946 in chips)
Seat 4: khsgrizende (3887340 in chips)
Seat 5: lupninox (1031735 in chips)
Seat 6: Maikil361 (1000675 in chips)
Seat 7: hichnick777 (2429574 in chips)
Seat 8: dimaggress (1785706 in chips)
dogBq: posts the ante 10000
blackaces93: posts the ante 10000
4time2warp0: posts the ante 10000
khsgrizende: posts the ante 10000
lupninox: posts the ante 10000
Maikil361: posts the ante 10000
hichnick777: posts the ante 10000
dimaggress: posts the ante 10000
dogBq: posts small blind 50000
blackaces93: posts big blind 100000
*** HOLE CARDS ***
Dealt to hichnick777 [Kc 3h]
4time2warp0: raises 100000 to 200000
khsgrizende: folds
lupninox: folds
Maikil361: folds
hichnick777: folds
dimaggress: folds
dogBq: folds
blackaces93: calls 100000
*** FLOP *** [4d Kh 7s]
blackaces93: checks
4time2warp0: bets 300000
blackaces93: folds
Uncalled bet (300000) returned to 4time2warp0
4time2warp0 collected 530000 from pot
4time2warp0: doesn't show hand
*** SUMMARY ***
Total pot 530000 | Rake 0
Board [4d Kh 7s]
Seat 1: dogBq (small blind) folded before Flop
Seat 2: blackaces93 (big blind) folded on the Flop
Seat 3: 4time2warp0 collected (530000)
Seat 4: khsgrizende folded before Flop (didn't bet)
Seat 5: lupninox folded before Flop (didn't bet)
Seat 6: Maikil361 folded before Flop (didn't bet)
Seat 7: hichnick777 folded before Flop (didn't bet)
Seat 8: dimaggress (button) folded before Flop (didn't bet)


*********** # 406 **************
PokerStars Hand #176681085809: Tournament #2054568934, $20+$2 USD Hold'em No Limit - Level XLI (50000/100000) - 2017/10/09 7:12:16 MSK [2017/10/09 0:12:16 ET]
Table '2054568934 598' 9-max Seat #1 is the button
Seat 1: dogBq (1443168 in chips)
Seat 2: blackaces93 (2394675 in chips)
Seat 3: 4time2warp0 (3354946 in chips)
Seat 4: khsgrizende (3877340 in chips)
Seat 5: lupninox (1021735 in chips)
Seat 6: Maikil361 (990675 in chips)
Seat 7: hichnick777 (2419574 in chips)
Seat 8: dimaggress (1775706 in chips)
dogBq: posts the ante 10000
blackaces93: posts the ante 10000
4time2warp0: posts the ante 10000
khsgrizende: posts the ante 10000
lupninox: posts the ante 10000
Maikil361: posts the ante 10000
hichnick777: posts the ante 10000
dimaggress: posts the ante 10000
blackaces93: posts small blind 50000
4time2warp0: posts big blind 100000
*** HOLE CARDS ***
Dealt to hichnick777 [Ah Jc]
khsgrizende: folds
lupninox: folds
Maikil361: folds
hichnick777: raises 125000 to 225000
dimaggress: folds
dogBq: folds
blackaces93: folds
4time2warp0: folds
Uncalled bet (125000) returned to hichnick777
hichnick777 collected 330000 from pot
hichnick777: doesn't show hand
*** SUMMARY ***
Total pot 330000 | Rake 0
Seat 1: dogBq (button) folded before Flop (didn't bet)
Seat 2: blackaces93 (small blind) folded before Flop
Seat 3: 4time2warp0 (big blind) folded before Flop
Seat 4: khsgrizende folded before Flop (didn't bet)
Seat 5: lupninox folded before Flop (didn't bet)
Seat 6: Maikil361 folded before Flop (didn't bet)
Seat 7: hichnick777 collected (330000)
Seat 8: dimaggress folded before Flop (didn't bet)


*********** # 407 **************
PokerStars Hand #176681094864: Tournament #2054568934, $20+$2 USD Hold'em No Limit - Level XLI (50000/100000) - 2017/10/09 7:12:54 MSK [2017/10/09 0:12:54 ET]
Table '2054568934 598' 9-max Seat #2 is the button
Seat 1: dogBq (1433168 in chips)
Seat 2: blackaces93 (2334675 in chips)
Seat 3: 4time2warp0 (3244946 in chips)
Seat 4: khsgrizende (3867340 in chips)
Seat 5: lupninox (1011735 in chips)
Seat 6: Maikil361 (980675 in chips)
Seat 7: hichnick777 (2639574 in chips)
Seat 8: dimaggress (1765706 in chips)
dogBq: posts the ante 10000
blackaces93: posts the ante 10000
4time2warp0: posts the ante 10000
khsgrizende: posts the ante 10000
lupninox: posts the ante 10000
Maikil361: posts the ante 10000
hichnick777: posts the ante 10000
dimaggress: posts the ante 10000
4time2warp0: posts small blind 50000
khsgrizende: posts big blind 100000
*** HOLE CARDS ***
Dealt to hichnick777 [Kd 2d]
lupninox: folds
Maikil361: folds
hichnick777: folds
dimaggress: folds
dogBq: folds
blackaces93: folds
4time2warp0: raises 100000 to 200000
khsgrizende: raises 300000 to 500000
4time2warp0: folds
Uncalled bet (300000) returned to khsgrizende
khsgrizende collected 480000 from pot
khsgrizende: doesn't show hand
*** SUMMARY ***
Total pot 480000 | Rake 0
Seat 1: dogBq folded before Flop (didn't bet)
Seat 2: blackaces93 (button) folded before Flop (didn't bet)
Seat 3: 4time2warp0 (small blind) folded before Flop
Seat 4: khsgrizende (big blind) collected (480000)
Seat 5: lupninox folded before Flop (didn't bet)
Seat 6: Maikil361 folded before Flop (didn't bet)
Seat 7: hichnick777 folded before Flop (didn't bet)
Seat 8: dimaggress folded before Flop (didn't bet)


*********** # 408 **************
PokerStars Hand #176681108126: Tournament #2054568934, $20+$2 USD Hold'em No Limit - Level XLI (50000/100000) - 2017/10/09 7:13:50 MSK [2017/10/09 0:13:50 ET]
Table '2054568934 598' 9-max Seat #3 is the button
Seat 1: dogBq (1423168 in chips)
Seat 2: blackaces93 (2324675 in chips)
Seat 3: 4time2warp0 (3034946 in chips)
Seat 4: khsgrizende (4137340 in chips)
Seat 5: lupninox (1001735 in chips)
Seat 7: hichnick777 (2629574 in chips)
Seat 8: dimaggress (1755706 in chips)
dogBq: posts the ante 10000
blackaces93: posts the ante 10000
4time2warp0: posts the ante 10000
khsgrizende: posts the ante 10000
lupninox: posts the ante 10000
hichnick777: posts the ante 10000
dimaggress: posts the ante 10000
khsgrizende: posts small blind 50000
lupninox: posts big blind 100000
*** HOLE CARDS ***
Dealt to hichnick777 [8c Jc]
hichnick777: folds
dimaggress: folds
dogBq: folds
blackaces93: folds
4time2warp0: folds
khsgrizende: raises 4027340 to 4127340 and is all-in
lupninox: folds
Uncalled bet (4027340) returned to khsgrizende
khsgrizende collected 270000 from pot
khsgrizende: doesn't show hand
*** SUMMARY ***
Total pot 270000 | Rake 0
Seat 1: dogBq folded before Flop (didn't bet)
Seat 2: blackaces93 folded before Flop (didn't bet)
Seat 3: 4time2warp0 (button) folded before Flop (didn't bet)
Seat 4: khsgrizende (small blind) collected (270000)
Seat 5: lupninox (big blind) folded before Flop
Seat 7: hichnick777 folded before Flop (didn't bet)
Seat 8: dimaggress folded before Flop (didn't bet)


*********** # 409 **************
PokerStars Hand #176681114623: Tournament #2054568934, $20+$2 USD Hold'em No Limit - Level XLI (50000/100000) - 2017/10/09 7:14:18 MSK [2017/10/09 0:14:18 ET]
Table '2054568934 598' 9-max Seat #4 is the button
Seat 1: dogBq (1413168 in chips)
Seat 2: blackaces93 (2314675 in chips)
Seat 3: 4time2warp0 (3024946 in chips)
Seat 4: khsgrizende (4297340 in chips)
Seat 5: lupninox (891735 in chips)
Seat 6: kasper744 (4366276 in chips)
Seat 7: hichnick777 (2619574 in chips)
Seat 8: dimaggress (1745706 in chips)
Seat 9: Ben_Apart (1642902 in chips)
dogBq: posts the ante 10000
blackaces93: posts the ante 10000
4time2warp0: posts the ante 10000
khsgrizende: posts the ante 10000
lupninox: posts the ante 10000
kasper744: posts the ante 10000
hichnick777: posts the ante 10000
dimaggress: posts the ante 10000
Ben_Apart: posts the ante 10000
lupninox: posts small blind 50000
kasper744: posts big blind 100000
*** HOLE CARDS ***
Dealt to hichnick777 [3d 5s]
hichnick777: folds
dimaggress: folds
Ben_Apart: folds
dogBq: folds
blackaces93: folds
4time2warp0: folds
khsgrizende: folds
lupninox: folds
Uncalled bet (50000) returned to kasper744
kasper744 collected 190000 from pot
kasper744: doesn't show hand
*** SUMMARY ***
Total pot 190000 | Rake 0
Seat 1: dogBq folded before Flop (didn't bet)
Seat 2: blackaces93 folded before Flop (didn't bet)
Seat 3: 4time2warp0 folded before Flop (didn't bet)
Seat 4: khsgrizende (button) folded before Flop (didn't bet)
Seat 5: lupninox (small blind) folded before Flop
Seat 6: kasper744 (big blind) collected (190000)
Seat 7: hichnick777 folded before Flop (didn't bet)
Seat 8: dimaggress folded before Flop (didn't bet)
Seat 9: Ben_Apart folded before Flop (didn't bet)


*********** # 410 **************
PokerStars Hand #176681120239: Tournament #2054568934, $20+$2 USD Hold'em No Limit - Level XLI (50000/100000) - 2017/10/09 7:14:42 MSK [2017/10/09 0:14:42 ET]
Table '2054568934 598' 9-max Seat #5 is the button
Seat 1: dogBq (1403168 in chips)
Seat 2: blackaces93 (2304675 in chips)
Seat 3: 4time2warp0 (3014946 in chips)
Seat 4: khsgrizende (4287340 in chips)
Seat 5: lupninox (831735 in chips)
Seat 6: kasper744 (4496276 in chips)
Seat 7: hichnick777 (2609574 in chips)
Seat 8: dimaggress (1735706 in chips)
Seat 9: Ben_Apart (1632902 in chips)
dogBq: posts the ante 10000
blackaces93: posts the ante 10000
4time2warp0: posts the ante 10000
khsgrizende: posts the ante 10000
lupninox: posts the ante 10000
kasper744: posts the ante 10000
hichnick777: posts the ante 10000
dimaggress: posts the ante 10000
Ben_Apart: posts the ante 10000
kasper744: posts small blind 50000
hichnick777: posts big blind 100000
*** HOLE CARDS ***
Dealt to hichnick777 [5h 7c]
dimaggress: folds
Ben_Apart: folds
dogBq: folds
blackaces93: folds
4time2warp0: folds
khsgrizende: folds
lupninox: folds
kasper744: calls 50000
hichnick777: checks
*** FLOP *** [5s Td As]
kasper744: checks
hichnick777: checks
*** TURN *** [5s Td As] [9c]
kasper744: bets 130500
hichnick777: calls 130500
*** RIVER *** [5s Td As 9c] [Kd]
kasper744: checks
hichnick777: checks
*** SHOW DOWN ***
kasper744: shows [8s Qh] (high card Ace)
hichnick777: shows [5h 7c] (a pair of Fives)
hichnick777 collected 551000 from pot
*** SUMMARY ***
Total pot 551000 | Rake 0
Board [5s Td As 9c Kd]
Seat 1: dogBq folded before Flop (didn't bet)
Seat 2: blackaces93 folded before Flop (didn't bet)
Seat 3: 4time2warp0 folded before Flop (didn't bet)
Seat 4: khsgrizende folded before Flop (didn't bet)
Seat 5: lupninox (button) folded before Flop (didn't bet)
Seat 6: kasper744 (small blind) showed [8s Qh] and lost with high card Ace
Seat 7: hichnick777 (big blind) showed [5h 7c] and won (551000) with a pair of Fives
Seat 8: dimaggress folded before Flop (didn't bet)
Seat 9: Ben_Apart folded before Flop (didn't bet)


*********** # 411 **************
PokerStars Hand #176681139526: Tournament #2054568934, $20+$2 USD Hold'em No Limit - Level XLII (60000/120000) - 2017/10/09 7:16:03 MSK [2017/10/09 0:16:03 ET]
Table '2054568934 598' 9-max Seat #6 is the button
Seat 1: dogBq (1393168 in chips)
Seat 2: blackaces93 (2294675 in chips)
Seat 3: 4time2warp0 (3004946 in chips)
Seat 4: khsgrizende (4277340 in chips)
Seat 5: lupninox (821735 in chips)
Seat 6: kasper744 (4255776 in chips)
Seat 7: hichnick777 (2920074 in chips)
Seat 8: dimaggress (1725706 in chips)
Seat 9: Ben_Apart (1622902 in chips)
dogBq: posts the ante 12000
blackaces93: posts the ante 12000
4time2warp0: posts the ante 12000
khsgrizende: posts the ante 12000
lupninox: posts the ante 12000
kasper744: posts the ante 12000
hichnick777: posts the ante 12000
dimaggress: posts the ante 12000
Ben_Apart: posts the ante 12000
hichnick777: posts small blind 60000
dimaggress: posts big blind 120000
*** HOLE CARDS ***
Dealt to hichnick777 [Kh 2s]
Ben_Apart: raises 1490902 to 1610902 and is all-in
dogBq: folds
blackaces93: folds
4time2warp0: folds
khsgrizende: folds
lupninox: folds
kasper744: folds
hichnick777: folds
dimaggress: folds
Uncalled bet (1490902) returned to Ben_Apart
Ben_Apart collected 408000 from pot
*** SUMMARY ***
Total pot 408000 | Rake 0
Seat 1: dogBq folded before Flop (didn't bet)
Seat 2: blackaces93 folded before Flop (didn't bet)
Seat 3: 4time2warp0 folded before Flop (didn't bet)
Seat 4: khsgrizende folded before Flop (didn't bet)
Seat 5: lupninox folded before Flop (didn't bet)
Seat 6: kasper744 (button) folded before Flop (didn't bet)
Seat 7: hichnick777 (small blind) folded before Flop
Seat 8: dimaggress (big blind) folded before Flop
Seat 9: Ben_Apart collected (408000)


*********** # 412 **************
PokerStars Hand #176681148152: Tournament #2054568934, $20+$2 USD Hold'em No Limit - Level XLII (60000/120000) - 2017/10/09 7:16:39 MSK [2017/10/09 0:16:39 ET]
Table '2054568934 598' 9-max Seat #7 is the button
Seat 1: dogBq (1381168 in chips)
Seat 2: blackaces93 (2282675 in chips)
Seat 3: 4time2warp0 (2992946 in chips)
Seat 4: khsgrizende (4265340 in chips)
Seat 5: lupninox (809735 in chips)
Seat 6: kasper744 (4243776 in chips)
Seat 7: hichnick777 (2848074 in chips)
Seat 8: dimaggress (1593706 in chips)
Seat 9: Ben_Apart (1898902 in chips)
dogBq: posts the ante 12000
blackaces93: posts the ante 12000
4time2warp0: posts the ante 12000
khsgrizende: posts the ante 12000
lupninox: posts the ante 12000
kasper744: posts the ante 12000
hichnick777: posts the ante 12000
dimaggress: posts the ante 12000
Ben_Apart: posts the ante 12000
dimaggress: posts small blind 60000
Ben_Apart: posts big blind 120000
*** HOLE CARDS ***
Dealt to hichnick777 [Js Tc]
dogBq: folds
blackaces93: folds
4time2warp0: raises 120000 to 240000
khsgrizende: folds
lupninox: folds
kasper744: folds
hichnick777: folds
dimaggress: folds
Ben_Apart: folds
Uncalled bet (120000) returned to 4time2warp0
4time2warp0 collected 408000 from pot
4time2warp0: doesn't show hand
*** SUMMARY ***
Total pot 408000 | Rake 0
Seat 1: dogBq folded before Flop (didn't bet)
Seat 2: blackaces93 folded before Flop (didn't bet)
Seat 3: 4time2warp0 collected (408000)
Seat 4: khsgrizende folded before Flop (didn't bet)
Seat 5: lupninox folded before Flop (didn't bet)
Seat 6: kasper744 folded before Flop (didn't bet)
Seat 7: hichnick777 (button) folded before Flop (didn't bet)
Seat 8: dimaggress (small blind) folded before Flop
Seat 9: Ben_Apart (big blind) folded before Flop


*********** # 413 **************
PokerStars Hand #176681158846: Tournament #2054568934, $20+$2 USD Hold'em No Limit - Level XLII (60000/120000) - 2017/10/09 7:17:25 MSK [2017/10/09 0:17:25 ET]
Table '2054568934 598' 9-max Seat #8 is the button
Seat 1: dogBq (1369168 in chips)
Seat 2: blackaces93 (2270675 in chips)
Seat 3: 4time2warp0 (3268946 in chips)
Seat 4: khsgrizende (4253340 in chips)
Seat 5: lupninox (797735 in chips)
Seat 6: kasper744 (4231776 in chips)
Seat 7: hichnick777 (2836074 in chips)
Seat 8: dimaggress (1521706 in chips)
Seat 9: Ben_Apart (1766902 in chips)
dogBq: posts the ante 12000
blackaces93: posts the ante 12000
4time2warp0: posts the ante 12000
khsgrizende: posts the ante 12000
lupninox: posts the ante 12000
kasper744: posts the ante 12000
hichnick777: posts the ante 12000
dimaggress: posts the ante 12000
Ben_Apart: posts the ante 12000
Ben_Apart: posts small blind 60000
dogBq: posts big blind 120000
*** HOLE CARDS ***
Dealt to hichnick777 [9s 7s]
blackaces93: folds
4time2warp0: folds
khsgrizende: folds
lupninox: folds
kasper744: folds
hichnick777: raises 129600 to 249600
dimaggress: folds
Ben_Apart: folds
dogBq: folds
Uncalled bet (129600) returned to hichnick777
hichnick777 collected 408000 from pot
hichnick777: doesn't show hand
*** SUMMARY ***
Total pot 408000 | Rake 0
Seat 1: dogBq (big blind) folded before Flop
Seat 2: blackaces93 folded before Flop (didn't bet)
Seat 3: 4time2warp0 folded before Flop (didn't bet)
Seat 4: khsgrizende folded before Flop (didn't bet)
Seat 5: lupninox folded before Flop (didn't bet)
Seat 6: kasper744 folded before Flop (didn't bet)
Seat 7: hichnick777 collected (408000)
Seat 8: dimaggress (button) folded before Flop (didn't bet)
Seat 9: Ben_Apart (small blind) folded before Flop


*********** # 414 **************
PokerStars Hand #176681170576: Tournament #2054568934, $20+$2 USD Hold'em No Limit - Level XLII (60000/120000) - 2017/10/09 7:18:15 MSK [2017/10/09 0:18:15 ET]
Table '2054568934 598' 9-max Seat #9 is the button
Seat 1: dogBq (1237168 in chips)
Seat 2: blackaces93 (2258675 in chips)
Seat 4: khsgrizende (4241340 in chips)
Seat 5: lupninox (785735 in chips)
Seat 6: kasper744 (4219776 in chips)
Seat 7: hichnick777 (3112074 in chips)
Seat 8: dimaggress (1509706 in chips)
Seat 9: Ben_Apart (1694902 in chips)
dogBq: posts the ante 12000
blackaces93: posts the ante 12000
khsgrizende: posts the ante 12000
lupninox: posts the ante 12000
kasper744: posts the ante 12000
hichnick777: posts the ante 12000
dimaggress: posts the ante 12000
Ben_Apart: posts the ante 12000
dogBq: posts small blind 60000
blackaces93: posts big blind 120000
*** HOLE CARDS ***
Dealt to hichnick777 [8s 7s]
khsgrizende: folds
lupninox: folds
kasper744: folds
hichnick777: raises 129600 to 249600
dimaggress: folds
Ben_Apart: folds
dogBq: folds
blackaces93: folds
Uncalled bet (129600) returned to hichnick777
hichnick777 collected 396000 from pot
hichnick777: doesn't show hand
*** SUMMARY ***
Total pot 396000 | Rake 0
Seat 1: dogBq (small blind) folded before Flop
Seat 2: blackaces93 (big blind) folded before Flop
Seat 4: khsgrizende folded before Flop (didn't bet)
Seat 5: lupninox folded before Flop (didn't bet)
Seat 6: kasper744 folded before Flop (didn't bet)
Seat 7: hichnick777 collected (396000)
Seat 8: dimaggress folded before Flop (didn't bet)
Seat 9: Ben_Apart (button) folded before Flop (didn't bet)


*********** # 415 **************
PokerStars Hand #176681179573: Tournament #2054568934, $20+$2 USD Hold'em No Limit - Level XLII (60000/120000) - 2017/10/09 7:18:53 MSK [2017/10/09 0:18:53 ET]
Table '2054568934 598' 9-max Seat #1 is the button
Seat 1: dogBq (1165168 in chips)
Seat 2: blackaces93 (2126675 in chips)
Seat 4: khsgrizende (4229340 in chips)
Seat 5: lupninox (773735 in chips)
Seat 6: kasper744 (4207776 in chips)
Seat 7: hichnick777 (3376074 in chips)
Seat 8: dimaggress (1497706 in chips)
Seat 9: Ben_Apart (1682902 in chips)
dogBq: posts the ante 12000
blackaces93: posts the ante 12000
khsgrizende: posts the ante 12000
lupninox: posts the ante 12000
kasper744: posts the ante 12000
hichnick777: posts the ante 12000
dimaggress: posts the ante 12000
Ben_Apart: posts the ante 12000
blackaces93: posts small blind 60000
khsgrizende: posts big blind 120000
*** HOLE CARDS ***
Dealt to hichnick777 [4d As]
lupninox: raises 641735 to 761735 and is all-in
kasper744: folds
hichnick777: folds
dimaggress: folds
Ben_Apart: folds
dogBq: folds
blackaces93: folds
khsgrizende: calls 641735
*** FLOP *** [Js 9h 3h]
*** TURN *** [Js 9h 3h] [8c]
*** RIVER *** [Js 9h 3h 8c] [Ks]
*** SHOW DOWN ***
khsgrizende: shows [Ad 7c] (high card Ace)
lupninox: shows [9d Ts] (a pair of Nines)
lupninox collected 1679470 from pot
*** SUMMARY ***
Total pot 1679470 | Rake 0
Board [Js 9h 3h 8c Ks]
Seat 1: dogBq (button) folded before Flop (didn't bet)
Seat 2: blackaces93 (small blind) folded before Flop
Seat 4: khsgrizende (big blind) showed [Ad 7c] and lost with high card Ace
Seat 5: lupninox showed [9d Ts] and won (1679470) with a pair of Nines
Seat 6: kasper744 folded before Flop (didn't bet)
Seat 7: hichnick777 folded before Flop (didn't bet)
Seat 8: dimaggress folded before Flop (didn't bet)
Seat 9: Ben_Apart folded before Flop (didn't bet)


*********** # 416 **************
PokerStars Hand #176681201338: Tournament #2054568934, $20+$2 USD Hold'em No Limit - Level XLII (60000/120000) - 2017/10/09 7:19:59 MSK [2017/10/09 0:19:59 ET]
Table '2054568934 598' 9-max Seat #2 is the button
Seat 1: dogBq (1153168 in chips)
Seat 2: blackaces93 (2054675 in chips)
Seat 4: khsgrizende (3455605 in chips)
Seat 5: lupninox (1679470 in chips)
Seat 6: kasper744 (4195776 in chips)
Seat 7: hichnick777 (3364074 in chips)
Seat 8: dimaggress (1485706 in chips)
Seat 9: Ben_Apart (1670902 in chips)
dogBq: posts the ante 12000
blackaces93: posts the ante 12000
khsgrizende: posts the ante 12000
lupninox: posts the ante 12000
kasper744: posts the ante 12000
hichnick777: posts the ante 12000
dimaggress: posts the ante 12000
Ben_Apart: posts the ante 12000
khsgrizende: posts small blind 60000
lupninox: posts big blind 120000
*** HOLE CARDS ***
Dealt to hichnick777 [5c 6c]
kasper744: folds
hichnick777: folds
dimaggress: folds
Ben_Apart: folds
dogBq: folds
blackaces93: calls 120000
khsgrizende: raises 240000 to 360000
lupninox: folds
blackaces93: calls 240000
*** FLOP *** [Ah 4s Ad]
khsgrizende: bets 290160
blackaces93: folds
Uncalled bet (290160) returned to khsgrizende
khsgrizende collected 936000 from pot
khsgrizende: doesn't show hand
*** SUMMARY ***
Total pot 936000 | Rake 0
Board [Ah 4s Ad]
Seat 1: dogBq folded before Flop (didn't bet)
Seat 2: blackaces93 (button) folded on the Flop
Seat 4: khsgrizende (small blind) collected (936000)
Seat 5: lupninox (big blind) folded before Flop
Seat 6: kasper744 folded before Flop (didn't bet)
Seat 7: hichnick777 folded before Flop (didn't bet)
Seat 8: dimaggress folded before Flop (didn't bet)
Seat 9: Ben_Apart folded before Flop (didn't bet)


*********** # 417 **************
PokerStars Hand #176681216708: Tournament #2054568934, $20+$2 USD Hold'em No Limit - Level XLII (60000/120000) - 2017/10/09 7:21:06 MSK [2017/10/09 0:21:06 ET]
Table '2054568934 598' 9-max Seat #4 is the button
Seat 1: dogBq (1141168 in chips)
Seat 2: blackaces93 (1682675 in chips)
Seat 4: khsgrizende (4019605 in chips)
Seat 5: lupninox (1547470 in chips)
Seat 6: kasper744 (4183776 in chips)
Seat 7: hichnick777 (3352074 in chips)
Seat 8: dimaggress (1473706 in chips)
Seat 9: Ben_Apart (1658902 in chips)
dogBq: posts the ante 12000
blackaces93: posts the ante 12000
khsgrizende: posts the ante 12000
lupninox: posts the ante 12000
kasper744: posts the ante 12000
hichnick777: posts the ante 12000
dimaggress: posts the ante 12000
Ben_Apart: posts the ante 12000
lupninox: posts small blind 60000
kasper744: posts big blind 120000
*** HOLE CARDS ***
Dealt to hichnick777 [6s Jh]
hichnick777: folds
dimaggress: folds
Ben_Apart: folds
dogBq: folds
blackaces93: folds
khsgrizende: folds
lupninox: raises 1415470 to 1535470 and is all-in
kasper744: folds
Uncalled bet (1415470) returned to lupninox
lupninox collected 336000 from pot
*** SUMMARY ***
Total pot 336000 | Rake 0
Seat 1: dogBq folded before Flop (didn't bet)
Seat 2: blackaces93 folded before Flop (didn't bet)
Seat 4: khsgrizende (button) folded before Flop (didn't bet)
Seat 5: lupninox (small blind) collected (336000)
Seat 6: kasper744 (big blind) folded before Flop
Seat 7: hichnick777 folded before Flop (didn't bet)
Seat 8: dimaggress folded before Flop (didn't bet)
Seat 9: Ben_Apart folded before Flop (didn't bet)


*********** # 418 **************
PokerStars Hand #176681224650: Tournament #2054568934, $20+$2 USD Hold'em No Limit - Level XLII (60000/120000) - 2017/10/09 7:21:40 MSK [2017/10/09 0:21:40 ET]
Table '2054568934 598' 9-max Seat #5 is the button
Seat 1: dogBq (1129168 in chips)
Seat 2: blackaces93 (1670675 in chips)
Seat 4: khsgrizende (4007605 in chips)
Seat 5: lupninox (1751470 in chips)
Seat 6: kasper744 (4051776 in chips)
Seat 7: hichnick777 (3340074 in chips)
Seat 8: dimaggress (1461706 in chips)
Seat 9: Ben_Apart (1646902 in chips)
dogBq: posts the ante 12000
blackaces93: posts the ante 12000
khsgrizende: posts the ante 12000
lupninox: posts the ante 12000
kasper744: posts the ante 12000
hichnick777: posts the ante 12000
dimaggress: posts the ante 12000
Ben_Apart: posts the ante 12000
kasper744: posts small blind 60000
hichnick777: posts big blind 120000
*** HOLE CARDS ***
Dealt to hichnick777 [Qd Kd]
dimaggress: folds
Ben_Apart: folds
dogBq: raises 997168 to 1117168 and is all-in
blackaces93: folds
khsgrizende: folds
lupninox: folds
kasper744: folds
hichnick777: calls 997168
*** FLOP *** [7h Ac 5c]
*** TURN *** [7h Ac 5c] [7s]
*** RIVER *** [7h Ac 5c 7s] [Kh]
*** SHOW DOWN ***
hichnick777: shows [Qd Kd] (two pair, Kings and Sevens)
dogBq: shows [Qc Qs] (two pair, Queens and Sevens)
hichnick777 collected 2390336 from pot
dogBq finished the tournament in 22nd place and received $369.81.
*** SUMMARY ***
Total pot 2390336 | Rake 0
Board [7h Ac 5c 7s Kh]
Seat 1: dogBq showed [Qc Qs] and lost with two pair, Queens and Sevens
Seat 2: blackaces93 folded before Flop (didn't bet)
Seat 4: khsgrizende folded before Flop (didn't bet)
Seat 5: lupninox (button) folded before Flop (didn't bet)
Seat 6: kasper744 (small blind) folded before Flop
Seat 7: hichnick777 (big blind) showed [Qd Kd] and won (2390336) with two pair, Kings and Sevens
Seat 8: dimaggress folded before Flop (didn't bet)
Seat 9: Ben_Apart folded before Flop (didn't bet)


*********** # 419 **************
PokerStars Hand #176681232696: Tournament #2054568934, $20+$2 USD Hold'em No Limit - Level XLII (60000/120000) - 2017/10/09 7:22:15 MSK [2017/10/09 0:22:15 ET]
Table '2054568934 598' 9-max Seat #6 is the button
Seat 2: blackaces93 (1658675 in chips)
Seat 4: khsgrizende (3995605 in chips)
Seat 5: lupninox (1739470 in chips)
Seat 6: kasper744 (3979776 in chips)
Seat 7: hichnick777 (4601242 in chips)
Seat 8: dimaggress (1449706 in chips)
Seat 9: Ben_Apart (1634902 in chips)
blackaces93: posts the ante 12000
khsgrizende: posts the ante 12000
lupninox: posts the ante 12000
kasper744: posts the ante 12000
hichnick777: posts the ante 12000
dimaggress: posts the ante 12000
Ben_Apart: posts the ante 12000
hichnick777: posts small blind 60000
dimaggress: posts big blind 120000
*** HOLE CARDS ***
Dealt to hichnick777 [Qc 6c]
Ben_Apart: folds
blackaces93: folds
khsgrizende: raises 132000 to 252000
lupninox: calls 252000
kasper744: folds
hichnick777: folds
dimaggress: raises 1185706 to 1437706 and is all-in
khsgrizende: folds
lupninox: calls 1185706
*** FLOP *** [6d Qs As]
*** TURN *** [6d Qs As] [4h]
*** RIVER *** [6d Qs As 4h] [7c]
*** SHOW DOWN ***
dimaggress: shows [Jd Ad] (a pair of Aces)
lupninox: shows [Ac Ah] (three of a kind, Aces)
lupninox collected 3271412 from pot
dimaggress finished the tournament in 21st place and received $369.81.
*** SUMMARY ***
Total pot 3271412 | Rake 0
Board [6d Qs As 4h 7c]
Seat 2: blackaces93 folded before Flop (didn't bet)
Seat 4: khsgrizende folded before Flop
Seat 5: lupninox showed [Ac Ah] and won (3271412) with three of a kind, Aces
Seat 6: kasper744 (button) folded before Flop (didn't bet)
Seat 7: hichnick777 (small blind) folded before Flop
Seat 8: dimaggress (big blind) showed [Jd Ad] and lost with a pair of Aces
Seat 9: Ben_Apart folded before Flop (didn't bet)


*********** # 420 **************
PokerStars Hand #176681245103: Tournament #2054568934, $20+$2 USD Hold'em No Limit - Level XLII (60000/120000) - 2017/10/09 7:23:09 MSK [2017/10/09 0:23:09 ET]
Table '2054568934 598' 9-max Seat #7 is the button
Seat 2: blackaces93 (1646675 in chips)
Seat 4: khsgrizende (3731605 in chips)
Seat 5: lupninox (3561176 in chips)
Seat 6: kasper744 (3967776 in chips)
Seat 7: hichnick777 (4529242 in chips)
Seat 9: Ben_Apart (1622902 in chips)
blackaces93: posts the ante 12000
khsgrizende: posts the ante 12000
lupninox: posts the ante 12000
kasper744: posts the ante 12000
hichnick777: posts the ante 12000
Ben_Apart: posts the ante 12000
Ben_Apart: posts small blind 60000
blackaces93: posts big blind 120000
*** HOLE CARDS ***
Dealt to hichnick777 [2s 2h]
khsgrizende: folds
lupninox: folds
kasper744: folds
hichnick777: raises 4397242 to 4517242 and is all-in
Ben_Apart: folds
blackaces93: calls 1514675 and is all-in
Uncalled bet (2882567) returned to hichnick777
*** FLOP *** [5h 6d Ac]
*** TURN *** [5h 6d Ac] [Th]
*** RIVER *** [5h 6d Ac Th] [7h]
*** SHOW DOWN ***
blackaces93: shows [Jd Ah] (a pair of Aces)
hichnick777: shows [2s 2h] (a pair of Deuces)
blackaces93 collected 3401350 from pot
*** SUMMARY ***
Total pot 3401350 | Rake 0
Board [5h 6d Ac Th 7h]
Seat 2: blackaces93 (big blind) showed [Jd Ah] and won (3401350) with a pair of Aces
Seat 4: khsgrizende folded before Flop (didn't bet)
Seat 5: lupninox folded before Flop (didn't bet)
Seat 6: kasper744 folded before Flop (didn't bet)
Seat 7: hichnick777 (button) showed [2s 2h] and lost with a pair of Deuces
Seat 9: Ben_Apart (small blind) folded before Flop


*********** # 421 **************
PokerStars Hand #176681261365: Tournament #2054568934, $20+$2 USD Hold'em No Limit - Level XLII (60000/120000) - 2017/10/09 7:24:21 MSK [2017/10/09 0:24:21 ET]
Table '2054568934 598' 9-max Seat #9 is the button
Seat 2: blackaces93 (3401350 in chips)
Seat 4: khsgrizende (3719605 in chips)
Seat 5: lupninox (3549176 in chips)
Seat 6: kasper744 (3955776 in chips)
Seat 7: hichnick777 (2882567 in chips)
Seat 9: Ben_Apart (1550902 in chips)
blackaces93: posts the ante 12000
khsgrizende: posts the ante 12000
lupninox: posts the ante 12000
kasper744: posts the ante 12000
hichnick777: posts the ante 12000
Ben_Apart: posts the ante 12000
blackaces93: posts small blind 60000
khsgrizende: posts big blind 120000
*** HOLE CARDS ***
Dealt to hichnick777 [As Td]
lupninox: folds
kasper744: folds
hichnick777: raises 129600 to 249600
Ben_Apart: folds
blackaces93: folds
khsgrizende: folds
Uncalled bet (129600) returned to hichnick777
hichnick777 collected 372000 from pot
hichnick777: doesn't show hand
*** SUMMARY ***
Total pot 372000 | Rake 0
Seat 2: blackaces93 (small blind) folded before Flop
Seat 4: khsgrizende (big blind) folded before Flop
Seat 5: lupninox folded before Flop (didn't bet)
Seat 6: kasper744 folded before Flop (didn't bet)
Seat 7: hichnick777 collected (372000)
Seat 9: Ben_Apart (button) folded before Flop (didn't bet)


*********** # 422 **************
PokerStars Hand #176681268020: Tournament #2054568934, $20+$2 USD Hold'em No Limit - Level XLII (60000/120000) - 2017/10/09 7:24:49 MSK [2017/10/09 0:24:49 ET]
Table '2054568934 598' 9-max Seat #2 is the button
Seat 2: blackaces93 (3329350 in chips)
Seat 4: khsgrizende (3587605 in chips)
Seat 5: lupninox (3537176 in chips)
Seat 6: kasper744 (3943776 in chips)
Seat 7: hichnick777 (3122567 in chips)
Seat 9: Ben_Apart (1538902 in chips)
blackaces93: posts the ante 12000
khsgrizende: posts the ante 12000
lupninox: posts the ante 12000
kasper744: posts the ante 12000
hichnick777: posts the ante 12000
Ben_Apart: posts the ante 12000
khsgrizende: posts small blind 60000
lupninox: posts big blind 120000
*** HOLE CARDS ***
Dealt to hichnick777 [Qc 7h]
kasper744: folds
hichnick777: folds
Ben_Apart: folds
blackaces93: raises 132222 to 252222
khsgrizende: folds
lupninox: calls 132222
*** FLOP *** [2d 8d Ts]
lupninox: checks
blackaces93: checks
*** TURN *** [2d 8d Ts] [Td]
lupninox: bets 209120
blackaces93: calls 209120
*** RIVER *** [2d 8d Ts Td] [Ks]
lupninox: checks
blackaces93: checks
*** SHOW DOWN ***
lupninox: shows [2s 2h] (a full house, Deuces full of Tens)
blackaces93: mucks hand
lupninox collected 1054684 from pot
*** SUMMARY ***
Total pot 1054684 | Rake 0
Board [2d 8d Ts Td Ks]
Seat 2: blackaces93 (button) mucked [6h 6s]
Seat 4: khsgrizende (small blind) folded before Flop
Seat 5: lupninox (big blind) showed [2s 2h] and won (1054684) with a full house, Deuces full of Tens
Seat 6: kasper744 folded before Flop (didn't bet)
Seat 7: hichnick777 folded before Flop (didn't bet)
Seat 9: Ben_Apart folded before Flop (didn't bet)


*********** # 423 **************
PokerStars Hand #176681293553: Tournament #2054568934, $20+$2 USD Hold'em No Limit - Level XLII (60000/120000) - 2017/10/09 7:26:40 MSK [2017/10/09 0:26:40 ET]
Table '2054568934 598' 9-max Seat #4 is the button
Seat 2: blackaces93 (2856008 in chips)
Seat 4: khsgrizende (3515605 in chips)
Seat 5: lupninox (4118518 in chips)
Seat 6: kasper744 (3931776 in chips)
Seat 7: hichnick777 (3110567 in chips)
Seat 9: Ben_Apart (1526902 in chips)
blackaces93: posts the ante 12000
khsgrizende: posts the ante 12000
lupninox: posts the ante 12000
kasper744: posts the ante 12000
hichnick777: posts the ante 12000
Ben_Apart: posts the ante 12000
lupninox: posts small blind 60000
kasper744: posts big blind 120000
*** HOLE CARDS ***
Dealt to hichnick777 [8s 3h]
hichnick777: folds
Ben_Apart: folds
blackaces93: raises 132220 to 252220
khsgrizende: calls 252220
lupninox: folds
kasper744: folds
*** FLOP *** [Kh 3s 8h]
blackaces93: bets 257780
khsgrizende: raises 394320 to 652100
blackaces93: folds
Uncalled bet (394320) returned to khsgrizende
khsgrizende collected 1272000 from pot
khsgrizende: doesn't show hand
*** SUMMARY ***
Total pot 1272000 | Rake 0
Board [Kh 3s 8h]
Seat 2: blackaces93 folded on the Flop
Seat 4: khsgrizende (button) collected (1272000)
Seat 5: lupninox (small blind) folded before Flop
Seat 6: kasper744 (big blind) folded before Flop
Seat 7: hichnick777 folded before Flop (didn't bet)
Seat 9: Ben_Apart folded before Flop (didn't bet)


*********** # 424 **************
PokerStars Hand #176681308225: Tournament #2054568934, $20+$2 USD Hold'em No Limit - Level XLIII (80000/160000) - 2017/10/09 7:27:44 MSK [2017/10/09 0:27:44 ET]
Table '2054568934 598' 9-max Seat #5 is the button
Seat 2: blackaces93 (2334008 in chips)
Seat 4: khsgrizende (4265605 in chips)
Seat 5: lupninox (4046518 in chips)
Seat 6: kasper744 (3799776 in chips)
Seat 7: hichnick777 (3098567 in chips)
Seat 9: Ben_Apart (1514902 in chips)
blackaces93: posts the ante 16000
khsgrizende: posts the ante 16000
lupninox: posts the ante 16000
kasper744: posts the ante 16000
hichnick777: posts the ante 16000
Ben_Apart: posts the ante 16000
kasper744: posts small blind 80000
hichnick777: posts big blind 160000
*** HOLE CARDS ***
Dealt to hichnick777 [2h 7c]
Ben_Apart: folds
blackaces93: raises 160000 to 320000
khsgrizende: raises 3929605 to 4249605 and is all-in
lupninox: folds
kasper744: folds
hichnick777: folds
blackaces93: folds
Uncalled bet (3929605) returned to khsgrizende
khsgrizende collected 976000 from pot
khsgrizende: doesn't show hand
*** SUMMARY ***
Total pot 976000 | Rake 0
Seat 2: blackaces93 folded before Flop
Seat 4: khsgrizende collected (976000)
Seat 5: lupninox (button) folded before Flop (didn't bet)
Seat 6: kasper744 (small blind) folded before Flop
Seat 7: hichnick777 (big blind) folded before Flop
Seat 9: Ben_Apart folded before Flop (didn't bet)


*********** # 425 **************
PokerStars Hand #176681322201: Tournament #2054568934, $20+$2 USD Hold'em No Limit - Level XLIII (80000/160000) - 2017/10/09 7:28:45 MSK [2017/10/09 0:28:45 ET]
Table '2054568934 598' 9-max Seat #6 is the button
Seat 2: blackaces93 (1998008 in chips)
Seat 4: khsgrizende (4905605 in chips)
Seat 5: lupninox (4030518 in chips)
Seat 6: kasper744 (3703776 in chips)
Seat 7: hichnick777 (2922567 in chips)
Seat 9: Ben_Apart (1498902 in chips)
blackaces93: posts the ante 16000
khsgrizende: posts the ante 16000
lupninox: posts the ante 16000
kasper744: posts the ante 16000
hichnick777: posts the ante 16000
Ben_Apart: posts the ante 16000
hichnick777: posts small blind 80000
Ben_Apart: posts big blind 160000
*** HOLE CARDS ***
Dealt to hichnick777 [Qh 7h]
blackaces93: raises 1822008 to 1982008 and is all-in
khsgrizende: folds
lupninox: folds
kasper744: folds
hichnick777: folds
Ben_Apart: folds
Uncalled bet (1822008) returned to blackaces93
blackaces93 collected 496000 from pot
*** SUMMARY ***
Total pot 496000 | Rake 0
Seat 2: blackaces93 collected (496000)
Seat 4: khsgrizende folded before Flop (didn't bet)
Seat 5: lupninox folded before Flop (didn't bet)
Seat 6: kasper744 (button) folded before Flop (didn't bet)
Seat 7: hichnick777 (small blind) folded before Flop
Seat 9: Ben_Apart (big blind) folded before Flop


*********** # 426 **************
PokerStars Hand #176681328059: Tournament #2054568934, $20+$2 USD Hold'em No Limit - Level XLIII (80000/160000) - 2017/10/09 7:29:11 MSK [2017/10/09 0:29:11 ET]
Table '2054568934 598' 9-max Seat #7 is the button
Seat 2: blackaces93 (2318008 in chips)
Seat 4: khsgrizende (4889605 in chips)
Seat 5: lupninox (4014518 in chips)
Seat 6: kasper744 (3687776 in chips)
Seat 7: hichnick777 (2826567 in chips)
Seat 9: Ben_Apart (1322902 in chips)
blackaces93: posts the ante 16000
khsgrizende: posts the ante 16000
lupninox: posts the ante 16000
kasper744: posts the ante 16000
hichnick777: posts the ante 16000
Ben_Apart: posts the ante 16000
Ben_Apart: posts small blind 80000
blackaces93: posts big blind 160000
*** HOLE CARDS ***
Dealt to hichnick777 [7c As]
khsgrizende: folds
lupninox: folds
kasper744: folds
sidlovskiy89 is sitting out
sidlovskiy89 has returned
hichnick777: raises 2650567 to 2810567 and is all-in
Ben_Apart: calls 1226902 and is all-in
blackaces93: folds
Uncalled bet (1503665) returned to hichnick777
*** FLOP *** [6s Ks 9d]
*** TURN *** [6s Ks 9d] [2d]
*** RIVER *** [6s Ks 9d 2d] [7s]
*** SHOW DOWN ***
Ben_Apart: shows [Qh Kh] (a pair of Kings)
hichnick777: shows [7c As] (a pair of Sevens)
Ben_Apart collected 2869804 from pot
*** SUMMARY ***
Total pot 2869804 | Rake 0
Board [6s Ks 9d 2d 7s]
Seat 2: blackaces93 (big blind) folded before Flop
Seat 4: khsgrizende folded before Flop (didn't bet)
Seat 5: lupninox folded before Flop (didn't bet)
Seat 6: kasper744 folded before Flop (didn't bet)
Seat 7: hichnick777 (button) showed [7c As] and lost with a pair of Sevens
Seat 9: Ben_Apart (small blind) showed [Qh Kh] and won (2869804) with a pair of Kings


*********** # 427 **************
PokerStars Hand #176681339135: Tournament #2054568934, $20+$2 USD Hold'em No Limit - Level XLIII (80000/160000) - 2017/10/09 7:30:00 MSK [2017/10/09 0:30:00 ET]
Table '2054568934 598' 9-max Seat #9 is the button
Seat 1: TeddyKGB027 (8178660 in chips) out of hand (moved from another table into small blind)
Seat 2: blackaces93 (2142008 in chips)
Seat 3: sidlovskiy89 (4107938 in chips)
Seat 4: khsgrizende (4873605 in chips)
Seat 5: lupninox (3998518 in chips)
Seat 6: kasper744 (3671776 in chips)
Seat 7: hichnick777 (1503665 in chips)
Seat 8: casey1186 (7714668 in chips)
Seat 9: Ben_Apart (2869804 in chips)
blackaces93: posts the ante 16000
sidlovskiy89: posts the ante 16000
khsgrizende: posts the ante 16000
lupninox: posts the ante 16000
kasper744: posts the ante 16000
hichnick777: posts the ante 16000
casey1186: posts the ante 16000
Ben_Apart: posts the ante 16000
blackaces93: posts small blind 80000
sidlovskiy89: posts big blind 160000
*** HOLE CARDS ***
Dealt to hichnick777 [Kd 6d]
khsgrizende: folds
lupninox: folds
kasper744: raises 174400 to 334400
hichnick777: folds
casey1186: folds
Ben_Apart: calls 334400
blackaces93: folds
sidlovskiy89: calls 174400
*** FLOP *** [Jd Ts 9s]
sidlovskiy89: checks
kasper744: checks
Ben_Apart: bets 480000
sidlovskiy89: calls 480000
kasper744: raises 2841376 to 3321376 and is all-in
Ben_Apart: calls 2039404 and is all-in
sidlovskiy89: folds
Uncalled bet (801972) returned to kasper744
*** TURN *** [Jd Ts 9s] [7s]
*** RIVER *** [Jd Ts 9s 7s] [Qh]
*** SHOW DOWN ***
kasper744: shows [Ks Jh] (a straight, Nine to King)
Ben_Apart: shows [As Ad] (a pair of Aces)
kasper744 collected 6730008 from pot
Ben_Apart finished the tournament in 18th place and received $369.81.
*** SUMMARY ***
Total pot 6730008 | Rake 0
Board [Jd Ts 9s 7s Qh]
Seat 2: blackaces93 (small blind) folded before Flop
Seat 3: sidlovskiy89 (big blind) folded on the Flop
Seat 4: khsgrizende folded before Flop (didn't bet)
Seat 5: lupninox folded before Flop (didn't bet)
Seat 6: kasper744 showed [Ks Jh] and won (6730008) with a straight, Nine to King
Seat 7: hichnick777 folded before Flop (didn't bet)
Seat 8: casey1186 folded before Flop (didn't bet)
Seat 9: Ben_Apart (button) showed [As Ad] and lost with a pair of Aces


*********** # 428 **************
PokerStars Hand #176681361822: Tournament #2054568934, $20+$2 USD Hold'em No Limit - Level XLIII (80000/160000) - 2017/10/09 7:31:42 MSK [2017/10/09 0:31:42 ET]
Table '2054568934 598' 9-max Seat #2 is the button
Seat 1: TeddyKGB027 (8178660 in chips)
Seat 2: blackaces93 (2046008 in chips)
Seat 3: sidlovskiy89 (3277538 in chips)
Seat 4: khsgrizende (4857605 in chips)
Seat 5: lupninox (3982518 in chips)
Seat 6: kasper744 (7531980 in chips)
Seat 7: hichnick777 (1487665 in chips)
Seat 8: casey1186 (7698668 in chips)
TeddyKGB027: posts the ante 16000
blackaces93: posts the ante 16000
sidlovskiy89: posts the ante 16000
khsgrizende: posts the ante 16000
lupninox: posts the ante 16000
kasper744: posts the ante 16000
hichnick777: posts the ante 16000
casey1186: posts the ante 16000
sidlovskiy89: posts small blind 80000
khsgrizende: posts big blind 160000
*** HOLE CARDS ***
Dealt to hichnick777 [7s Ks]
lupninox: folds
kasper744: folds
hichnick777: folds
casey1186: folds
TeddyKGB027: folds
blackaces93: folds
sidlovskiy89: raises 193600 to 353600
khsgrizende: calls 193600
*** FLOP *** [3d 8h 9h]
sidlovskiy89: bets 350784
khsgrizende: raises 476398 to 827182
sidlovskiy89: folds
Uncalled bet (476398) returned to khsgrizende
khsgrizende collected 1536768 from pot
khsgrizende: doesn't show hand
*** SUMMARY ***
Total pot 1536768 | Rake 0
Board [3d 8h 9h]
Seat 1: TeddyKGB027 folded before Flop (didn't bet)
Seat 2: blackaces93 (button) folded before Flop (didn't bet)
Seat 3: sidlovskiy89 (small blind) folded on the Flop
Seat 4: khsgrizende (big blind) collected (1536768)
Seat 5: lupninox folded before Flop (didn't bet)
Seat 6: kasper744 folded before Flop (didn't bet)
Seat 7: hichnick777 folded before Flop (didn't bet)
Seat 8: casey1186 folded before Flop (didn't bet)


*********** # 429 **************
PokerStars Hand #176681373280: Tournament #2054568934, $20+$2 USD Hold'em No Limit - Level XLIII (80000/160000) - 2017/10/09 7:32:33 MSK [2017/10/09 0:32:33 ET]
Table '2054568934 598' 9-max Seat #3 is the button
Seat 1: TeddyKGB027 (8162660 in chips)
Seat 2: blackaces93 (2030008 in chips)
Seat 3: sidlovskiy89 (2557154 in chips)
Seat 4: khsgrizende (5673989 in chips)
Seat 5: lupninox (3966518 in chips)
Seat 6: kasper744 (7515980 in chips)
Seat 7: hichnick777 (1471665 in chips)
Seat 8: casey1186 (7682668 in chips)
TeddyKGB027: posts the ante 16000
blackaces93: posts the ante 16000
sidlovskiy89: posts the ante 16000
khsgrizende: posts the ante 16000
lupninox: posts the ante 16000
kasper744: posts the ante 16000
hichnick777: posts the ante 16000
casey1186: posts the ante 16000
khsgrizende: posts small blind 80000
lupninox: posts big blind 160000
*** HOLE CARDS ***
Dealt to hichnick777 [7d 4s]
kasper744: folds
hichnick777: folds
casey1186: folds
TeddyKGB027: folds
blackaces93: folds
sidlovskiy89: folds
khsgrizende: raises 5497989 to 5657989 and is all-in
lupninox: folds
Uncalled bet (5497989) returned to khsgrizende
khsgrizende collected 448000 from pot
khsgrizende: doesn't show hand
*** SUMMARY ***
Total pot 448000 | Rake 0
Seat 1: TeddyKGB027 folded before Flop (didn't bet)
Seat 2: blackaces93 folded before Flop (didn't bet)
Seat 3: sidlovskiy89 (button) folded before Flop (didn't bet)
Seat 4: khsgrizende (small blind) collected (448000)
Seat 5: lupninox (big blind) folded before Flop
Seat 6: kasper744 folded before Flop (didn't bet)
Seat 7: hichnick777 folded before Flop (didn't bet)
Seat 8: casey1186 folded before Flop (didn't bet)


*********** # 430 **************
PokerStars Hand #176681383314: Tournament #2054568934, $20+$2 USD Hold'em No Limit - Level XLIII (80000/160000) - 2017/10/09 7:33:18 MSK [2017/10/09 0:33:18 ET]
Table '2054568934 598' 9-max Seat #4 is the button
Seat 1: TeddyKGB027 (8146660 in chips)
Seat 2: blackaces93 (2014008 in chips)
Seat 3: sidlovskiy89 (2541154 in chips)
Seat 4: khsgrizende (5945989 in chips)
Seat 5: lupninox (3790518 in chips)
Seat 6: kasper744 (7499980 in chips)
Seat 7: hichnick777 (1455665 in chips)
Seat 8: casey1186 (7666668 in chips)
TeddyKGB027: posts the ante 16000
blackaces93: posts the ante 16000
sidlovskiy89: posts the ante 16000
khsgrizende: posts the ante 16000
lupninox: posts the ante 16000
kasper744: posts the ante 16000
hichnick777: posts the ante 16000
casey1186: posts the ante 16000
lupninox: posts small blind 80000
kasper744: posts big blind 160000
*** HOLE CARDS ***
Dealt to hichnick777 [Qh 9c]
hichnick777: folds
casey1186: folds
TeddyKGB027: folds
blackaces93: folds
sidlovskiy89: folds
khsgrizende: raises 176000 to 336000
lupninox: raises 516555 to 852555
kasper744: folds
khsgrizende: raises 5077434 to 5929989 and is all-in
lupninox: calls 2921963 and is all-in
Uncalled bet (2155471) returned to khsgrizende
*** FLOP *** [Ah Kd Ts]
*** TURN *** [Ah Kd Ts] [4d]
*** RIVER *** [Ah Kd Ts 4d] [4h]
*** SHOW DOWN ***
lupninox: shows [Th Tc] (a full house, Tens full of Fours)
khsgrizende: shows [Jd Ad] (two pair, Aces and Fours)
lupninox collected 7837036 from pot
*** SUMMARY ***
Total pot 7837036 | Rake 0
Board [Ah Kd Ts 4d 4h]
Seat 1: TeddyKGB027 folded before Flop (didn't bet)
Seat 2: blackaces93 folded before Flop (didn't bet)
Seat 3: sidlovskiy89 folded before Flop (didn't bet)
Seat 4: khsgrizende (button) showed [Jd Ad] and lost with two pair, Aces and Fours
Seat 5: lupninox (small blind) showed [Th Tc] and won (7837036) with a full house, Tens full of Fours
Seat 6: kasper744 (big blind) folded before Flop
Seat 7: hichnick777 folded before Flop (didn't bet)
Seat 8: casey1186 folded before Flop (didn't bet)


*********** # 431 **************
PokerStars Hand #176681397583: Tournament #2054568934, $20+$2 USD Hold'em No Limit - Level XLIII (80000/160000) - 2017/10/09 7:34:22 MSK [2017/10/09 0:34:22 ET]
Table '2054568934 598' 9-max Seat #5 is the button
Seat 1: TeddyKGB027 (8130660 in chips)
Seat 2: blackaces93 (1998008 in chips)
Seat 3: sidlovskiy89 (2525154 in chips)
Seat 4: khsgrizende (2155471 in chips)
Seat 5: lupninox (7837036 in chips)
Seat 6: kasper744 (7323980 in chips)
Seat 7: hichnick777 (1439665 in chips)
Seat 8: casey1186 (7650668 in chips)
TeddyKGB027: posts the ante 16000
blackaces93: posts the ante 16000
sidlovskiy89: posts the ante 16000
khsgrizende: posts the ante 16000
lupninox: posts the ante 16000
kasper744: posts the ante 16000
hichnick777: posts the ante 16000
casey1186: posts the ante 16000
kasper744: posts small blind 80000
hichnick777: posts big blind 160000
*** HOLE CARDS ***
Dealt to hichnick777 [5d 3h]
casey1186: raises 160000 to 320000
TeddyKGB027: folds
blackaces93: folds
casey1186 said, "nh"
sidlovskiy89: folds
khsgrizende: folds
lupninox: folds
kasper744: folds
hichnick777: folds
Uncalled bet (160000) returned to casey1186
casey1186 collected 528000 from pot
casey1186: doesn't show hand
*** SUMMARY ***
Total pot 528000 | Rake 0
Seat 1: TeddyKGB027 folded before Flop (didn't bet)
Seat 2: blackaces93 folded before Flop (didn't bet)
Seat 3: sidlovskiy89 folded before Flop (didn't bet)
Seat 4: khsgrizende folded before Flop (didn't bet)
Seat 5: lupninox (button) folded before Flop (didn't bet)
Seat 6: kasper744 (small blind) folded before Flop
Seat 7: hichnick777 (big blind) folded before Flop
Seat 8: casey1186 collected (528000)


*********** # 432 **************
PokerStars Hand #176681404669: Tournament #2054568934, $20+$2 USD Hold'em No Limit - Level XLIII (80000/160000) - 2017/10/09 7:34:54 MSK [2017/10/09 0:34:54 ET]
Table '2054568934 598' 9-max Seat #6 is the button
Seat 1: TeddyKGB027 (8114660 in chips)
Seat 2: blackaces93 (1982008 in chips)
Seat 3: sidlovskiy89 (2509154 in chips)
Seat 4: khsgrizende (2139471 in chips)
Seat 5: lupninox (7821036 in chips)
Seat 6: kasper744 (7227980 in chips)
Seat 7: hichnick777 (1263665 in chips)
Seat 8: casey1186 (8002668 in chips)
TeddyKGB027: posts the ante 16000
blackaces93: posts the ante 16000
sidlovskiy89: posts the ante 16000
khsgrizende: posts the ante 16000
lupninox: posts the ante 16000
kasper744: posts the ante 16000
hichnick777: posts the ante 16000
casey1186: posts the ante 16000
hichnick777: posts small blind 80000
casey1186: posts big blind 160000
*** HOLE CARDS ***
Dealt to hichnick777 [Js Ks]
TeddyKGB027: folds
blackaces93: folds
sidlovskiy89: folds
khsgrizende: folds
lupninox: folds
kasper744: folds
hichnick777: raises 1087665 to 1247665 and is all-in
casey1186: calls 1087665
*** FLOP *** [7d 4c 5s]
*** TURN *** [7d 4c 5s] [Jc]
*** RIVER *** [7d 4c 5s Jc] [Qs]
*** SHOW DOWN ***
hichnick777: shows [Js Ks] (a pair of Jacks)
casey1186: shows [3s 3h] (a pair of Threes)
hichnick777 collected 2623330 from pot
*** SUMMARY ***
Total pot 2623330 | Rake 0
Board [7d 4c 5s Jc Qs]
Seat 1: TeddyKGB027 folded before Flop (didn't bet)
Seat 2: blackaces93 folded before Flop (didn't bet)
Seat 3: sidlovskiy89 folded before Flop (didn't bet)
Seat 4: khsgrizende folded before Flop (didn't bet)
Seat 5: lupninox folded before Flop (didn't bet)
Seat 6: kasper744 (button) folded before Flop (didn't bet)
Seat 7: hichnick777 (small blind) showed [Js Ks] and won (2623330) with a pair of Jacks
Seat 8: casey1186 (big blind) showed [3s 3h] and lost with a pair of Threes


*********** # 433 **************
PokerStars Hand #176681414121: Tournament #2054568934, $20+$2 USD Hold'em No Limit - Level XLIII (80000/160000) - 2017/10/09 7:35:37 MSK [2017/10/09 0:35:37 ET]
Table '2054568934 598' 9-max Seat #7 is the button
Seat 1: TeddyKGB027 (8098660 in chips)
Seat 2: blackaces93 (1966008 in chips)
Seat 3: sidlovskiy89 (2493154 in chips)
Seat 4: khsgrizende (2123471 in chips)
Seat 5: lupninox (7805036 in chips)
Seat 6: kasper744 (7211980 in chips)
Seat 7: hichnick777 (2623330 in chips)
Seat 8: casey1186 (6739003 in chips)
TeddyKGB027: posts the ante 16000
blackaces93: posts the ante 16000
sidlovskiy89: posts the ante 16000
khsgrizende: posts the ante 16000
lupninox: posts the ante 16000
kasper744: posts the ante 16000
hichnick777: posts the ante 16000
casey1186: posts the ante 16000
casey1186: posts small blind 80000
TeddyKGB027: posts big blind 160000
*** HOLE CARDS ***
Dealt to hichnick777 [Jc Ts]
blackaces93: folds
sidlovskiy89: folds
khsgrizende: raises 176000 to 336000
lupninox: raises 563995 to 899995
kasper744: folds
hichnick777: folds
casey1186: folds
TeddyKGB027: folds
khsgrizende: folds
Uncalled bet (563995) returned to lupninox
lupninox collected 1040000 from pot
*** SUMMARY ***
Total pot 1040000 | Rake 0
Seat 1: TeddyKGB027 (big blind) folded before Flop
Seat 2: blackaces93 folded before Flop (didn't bet)
Seat 3: sidlovskiy89 folded before Flop (didn't bet)
Seat 4: khsgrizende folded before Flop
Seat 5: lupninox collected (1040000)
Seat 6: kasper744 folded before Flop (didn't bet)
Seat 7: hichnick777 (button) folded before Flop (didn't bet)
Seat 8: casey1186 (small blind) folded before Flop


*********** # 434 **************
PokerStars Hand #176681424823: Tournament #2054568934, $20+$2 USD Hold'em No Limit - Level XLIII (80000/160000) - 2017/10/09 7:36:25 MSK [2017/10/09 0:36:25 ET]
Table '2054568934 598' 9-max Seat #8 is the button
Seat 1: TeddyKGB027 (7922660 in chips)
Seat 2: blackaces93 (1950008 in chips)
Seat 3: sidlovskiy89 (2477154 in chips)
Seat 4: khsgrizende (1771471 in chips)
Seat 5: lupninox (8493036 in chips)
Seat 6: kasper744 (7195980 in chips)
Seat 7: hichnick777 (2607330 in chips)
Seat 8: casey1186 (6643003 in chips)
TeddyKGB027: posts the ante 16000
blackaces93: posts the ante 16000
sidlovskiy89: posts the ante 16000
khsgrizende: posts the ante 16000
lupninox: posts the ante 16000
kasper744: posts the ante 16000
hichnick777: posts the ante 16000
casey1186: posts the ante 16000
TeddyKGB027: posts small blind 80000
blackaces93: posts big blind 160000
*** HOLE CARDS ***
Dealt to hichnick777 [Jd 7d]
sidlovskiy89: folds
khsgrizende: folds
lupninox: raises 192000 to 352000
kasper744: folds
hichnick777: folds
casey1186: folds
TeddyKGB027: folds
VitoldikS [observer] said, "no final table for morons"
blackaces93: calls 192000
*** FLOP *** [Js 3d 8c]
blackaces93: checks
lupninox: checks
*** TURN *** [Js 3d 8c] [As]
blackaces93: checks
lupninox: bets 350000
blackaces93: folds
Uncalled bet (350000) returned to lupninox
lupninox collected 912000 from pot
*** SUMMARY ***
Total pot 912000 | Rake 0
Board [Js 3d 8c As]
Seat 1: TeddyKGB027 (small blind) folded before Flop
Seat 2: blackaces93 (big blind) folded on the Turn
Seat 3: sidlovskiy89 folded before Flop (didn't bet)
Seat 4: khsgrizende folded before Flop (didn't bet)
Seat 5: lupninox collected (912000)
Seat 6: kasper744 folded before Flop (didn't bet)
Seat 7: hichnick777 folded before Flop (didn't bet)
Seat 8: casey1186 (button) folded before Flop (didn't bet)


*********** # 435 **************
PokerStars Hand #176681439210: Tournament #2054568934, $20+$2 USD Hold'em No Limit - Level XLIII (80000/160000) - 2017/10/09 7:37:31 MSK [2017/10/09 0:37:31 ET]
Table '2054568934 598' 9-max Seat #1 is the button
Seat 1: TeddyKGB027 (7826660 in chips)
Seat 2: blackaces93 (1582008 in chips)
Seat 3: sidlovskiy89 (2461154 in chips)
Seat 4: khsgrizende (1755471 in chips)
Seat 5: lupninox (9037036 in chips)
Seat 6: kasper744 (7179980 in chips)
Seat 7: hichnick777 (2591330 in chips)
Seat 8: casey1186 (6627003 in chips)
TeddyKGB027: posts the ante 16000
blackaces93: posts the ante 16000
sidlovskiy89: posts the ante 16000
khsgrizende: posts the ante 16000
lupninox: posts the ante 16000
kasper744: posts the ante 16000
hichnick777: posts the ante 16000
casey1186: posts the ante 16000
blackaces93: posts small blind 80000
sidlovskiy89: posts big blind 160000
*** HOLE CARDS ***
Dealt to hichnick777 [Qh 6c]
khsgrizende: folds
lupninox: raises 160000 to 320000
kasper744: folds
hichnick777: folds
casey1186: calls 320000
TeddyKGB027: folds
blackaces93: folds
sidlovskiy89: folds
*** FLOP *** [Ts 8s Qc]
lupninox: checks
casey1186: bets 320000
lupninox: calls 320000
*** TURN *** [Ts 8s Qc] [4d]
lupninox: checks
casey1186: bets 800000
lupninox: calls 800000
*** RIVER *** [Ts 8s Qc 4d] [2d]
lupninox: checks
casey1186: bets 160000
lupninox: raises 2590000 to 2750000
casey1186: folds
Uncalled bet (2590000) returned to lupninox
lupninox collected 3568000 from pot
*** SUMMARY ***
Total pot 3568000 | Rake 0
Board [Ts 8s Qc 4d 2d]
Seat 1: TeddyKGB027 (button) folded before Flop (didn't bet)
Seat 2: blackaces93 (small blind) folded before Flop
Seat 3: sidlovskiy89 (big blind) folded before Flop
Seat 4: khsgrizende folded before Flop (didn't bet)
Seat 5: lupninox collected (3568000)
Seat 6: kasper744 folded before Flop (didn't bet)
Seat 7: hichnick777 folded before Flop (didn't bet)
Seat 8: casey1186 folded on the River


*********** # 436 **************
PokerStars Hand #176681453353: Tournament #2054568934, $20+$2 USD Hold'em No Limit - Level XLIII (80000/160000) - 2017/10/09 7:38:34 MSK [2017/10/09 0:38:34 ET]
Table '2054568934 598' 9-max Seat #2 is the button
Seat 1: TeddyKGB027 (7810660 in chips)
Seat 2: blackaces93 (1486008 in chips)
Seat 3: sidlovskiy89 (2285154 in chips)
Seat 4: khsgrizende (1739471 in chips)
Seat 5: lupninox (10989036 in chips)
Seat 6: kasper744 (7163980 in chips)
Seat 7: hichnick777 (2575330 in chips)
Seat 8: casey1186 (5011003 in chips)
TeddyKGB027: posts the ante 16000
blackaces93: posts the ante 16000
sidlovskiy89: posts the ante 16000
khsgrizende: posts the ante 16000
lupninox: posts the ante 16000
kasper744: posts the ante 16000
hichnick777: posts the ante 16000
casey1186: posts the ante 16000
sidlovskiy89: posts small blind 80000
khsgrizende: posts big blind 160000
*** HOLE CARDS ***
Dealt to hichnick777 [8c 4d]
lupninox: raises 160000 to 320000
kasper744: folds
hichnick777: folds
casey1186: folds
TeddyKGB027: folds
blackaces93: folds
sidlovskiy89: folds
khsgrizende: folds
Uncalled bet (160000) returned to lupninox
lupninox collected 528000 from pot
*** SUMMARY ***
Total pot 528000 | Rake 0
Seat 1: TeddyKGB027 folded before Flop (didn't bet)
Seat 2: blackaces93 (button) folded before Flop (didn't bet)
Seat 3: sidlovskiy89 (small blind) folded before Flop
Seat 4: khsgrizende (big blind) folded before Flop
Seat 5: lupninox collected (528000)
Seat 6: kasper744 folded before Flop (didn't bet)
Seat 7: hichnick777 folded before Flop (didn't bet)
Seat 8: casey1186 folded before Flop (didn't bet)


*********** # 437 **************
PokerStars Hand #176681459451: Tournament #2054568934, $20+$2 USD Hold'em No Limit - Level XLIII (80000/160000) - 2017/10/09 7:39:02 MSK [2017/10/09 0:39:02 ET]
Table '2054568934 598' 9-max Seat #3 is the button
Seat 1: TeddyKGB027 (7794660 in chips)
Seat 2: blackaces93 (1470008 in chips)
Seat 3: sidlovskiy89 (2189154 in chips)
Seat 4: khsgrizende (1563471 in chips)
Seat 5: lupninox (11341036 in chips)
Seat 6: kasper744 (7147980 in chips)
Seat 7: hichnick777 (2559330 in chips)
Seat 8: casey1186 (4995003 in chips)
TeddyKGB027: posts the ante 16000
blackaces93: posts the ante 16000
sidlovskiy89: posts the ante 16000
khsgrizende: posts the ante 16000
lupninox: posts the ante 16000
kasper744: posts the ante 16000
hichnick777: posts the ante 16000
casey1186: posts the ante 16000
khsgrizende: posts small blind 80000
lupninox: posts big blind 160000
*** HOLE CARDS ***
Dealt to hichnick777 [6c 2s]
kasper744: folds
hichnick777: folds
casey1186: folds
TeddyKGB027: folds
blackaces93: folds
sidlovskiy89: raises 2013154 to 2173154 and is all-in
khsgrizende: folds
lupninox: folds
Uncalled bet (2013154) returned to sidlovskiy89
sidlovskiy89 collected 528000 from pot
*** SUMMARY ***
Total pot 528000 | Rake 0
Seat 1: TeddyKGB027 folded before Flop (didn't bet)
Seat 2: blackaces93 folded before Flop (didn't bet)
Seat 3: sidlovskiy89 (button) collected (528000)
Seat 4: khsgrizende (small blind) folded before Flop
Seat 5: lupninox (big blind) folded before Flop
Seat 6: kasper744 folded before Flop (didn't bet)
Seat 7: hichnick777 folded before Flop (didn't bet)
Seat 8: casey1186 folded before Flop (didn't bet)


*********** # 438 **************
PokerStars Hand #176681467645: Tournament #2054568934, $20+$2 USD Hold'em No Limit - Level XLIV (100000/200000) - 2017/10/09 7:39:39 MSK [2017/10/09 0:39:39 ET]
Table '2054568934 598' 9-max Seat #4 is the button
Seat 1: TeddyKGB027 (7778660 in chips)
Seat 2: blackaces93 (1454008 in chips)
Seat 3: sidlovskiy89 (2541154 in chips)
Seat 4: khsgrizende (1467471 in chips)
Seat 5: lupninox (11165036 in chips)
Seat 6: kasper744 (7131980 in chips)
Seat 7: hichnick777 (2543330 in chips)
Seat 8: casey1186 (4979003 in chips)
TeddyKGB027: posts the ante 20000
blackaces93: posts the ante 20000
sidlovskiy89: posts the ante 20000
khsgrizende: posts the ante 20000
lupninox: posts the ante 20000
kasper744: posts the ante 20000
hichnick777: posts the ante 20000
casey1186: posts the ante 20000
lupninox: posts small blind 100000
kasper744: posts big blind 200000
*** HOLE CARDS ***
Dealt to hichnick777 [9c 4d]
hichnick777: folds
casey1186: folds
TeddyKGB027: folds
blackaces93: raises 1234008 to 1434008 and is all-in
sidlovskiy89: folds
khsgrizende: raises 13463 to 1447471 and is all-in
lupninox: folds
kasper744: folds
Uncalled bet (13463) returned to khsgrizende
*** FLOP *** [7c 7s Jd]
*** TURN *** [7c 7s Jd] [5d]
*** RIVER *** [7c 7s Jd 5d] [3s]
*** SHOW DOWN ***
blackaces93: shows [As Js] (two pair, Jacks and Sevens)
khsgrizende: shows [Ah 8h] (a pair of Sevens)
blackaces93 collected 3328016 from pot
*** SUMMARY ***
Total pot 3328016 | Rake 0
Board [7c 7s Jd 5d 3s]
Seat 1: TeddyKGB027 folded before Flop (didn't bet)
Seat 2: blackaces93 showed [As Js] and won (3328016) with two pair, Jacks and Sevens
Seat 3: sidlovskiy89 folded before Flop (didn't bet)
Seat 4: khsgrizende (button) showed [Ah 8h] and lost with a pair of Sevens
Seat 5: lupninox (small blind) folded before Flop
Seat 6: kasper744 (big blind) folded before Flop
Seat 7: hichnick777 folded before Flop (didn't bet)
Seat 8: casey1186 folded before Flop (didn't bet)


*********** # 439 **************
PokerStars Hand #176681474613: Tournament #2054568934, $20+$2 USD Hold'em No Limit - Level XLIV (100000/200000) - 2017/10/09 7:40:10 MSK [2017/10/09 0:40:10 ET]
Table '2054568934 598' 9-max Seat #5 is the button
Seat 1: TeddyKGB027 (7758660 in chips)
Seat 2: blackaces93 (3328016 in chips)
Seat 3: sidlovskiy89 (2521154 in chips)
Seat 4: khsgrizende (13463 in chips)
Seat 5: lupninox (11045036 in chips)
Seat 6: kasper744 (6911980 in chips)
Seat 7: hichnick777 (2523330 in chips)
Seat 8: casey1186 (4959003 in chips)
TeddyKGB027: posts the ante 20000
blackaces93: posts the ante 20000
sidlovskiy89: posts the ante 20000
khsgrizende: posts the ante 13463 and is all-in
lupninox: posts the ante 20000
kasper744: posts the ante 20000
hichnick777: posts the ante 20000
casey1186: posts the ante 20000
kasper744: posts small blind 100000
hichnick777: posts big blind 200000
*** HOLE CARDS ***
Dealt to hichnick777 [9h Th]
casey1186: raises 400000 to 600000
TeddyKGB027: folds
blackaces93: folds
sidlovskiy89: folds
lupninox: folds
kasper744: folds
hichnick777: calls 400000
*** FLOP *** [Ad As Ks]
hichnick777: checks
casey1186: bets 600000
hichnick777: folds
Uncalled bet (600000) returned to casey1186
*** TURN *** [Ad As Ks] [9c]
*** RIVER *** [Ad As Ks 9c] [6s]
*** SHOW DOWN ***
casey1186: shows [Ac Jh] (three of a kind, Aces)
casey1186 collected 1345759 from side pot
khsgrizende: shows [6h 9d] (two pair, Aces and Nines)
casey1186 collected 107704 from main pot
khsgrizende finished the tournament in 16th place and received $537.79.
*** SUMMARY ***
Total pot 1453463 Main pot 107704. Side pot 1345759. | Rake 0
Board [Ad As Ks 9c 6s]
Seat 1: TeddyKGB027 folded before Flop (didn't bet)
Seat 2: blackaces93 folded before Flop (didn't bet)
Seat 3: sidlovskiy89 folded before Flop (didn't bet)
Seat 4: khsgrizende showed [6h 9d] and lost with two pair, Aces and Nines
Seat 5: lupninox (button) folded before Flop (didn't bet)
Seat 6: kasper744 (small blind) folded before Flop
Seat 7: hichnick777 (big blind) folded on the Flop
Seat 8: casey1186 showed [Ac Jh] and won (1453463) with three of a kind, Aces


*********** # 440 **************
PokerStars Hand #176681485730: Tournament #2054568934, $20+$2 USD Hold'em No Limit - Level XLIV (100000/200000) - 2017/10/09 7:41:00 MSK [2017/10/09 0:41:00 ET]
Table '2054568934 598' 9-max Seat #6 is the button
Seat 1: TeddyKGB027 (7738660 in chips)
Seat 2: blackaces93 (3308016 in chips)
Seat 3: sidlovskiy89 (2501154 in chips)
Seat 5: lupninox (11025036 in chips)
Seat 6: kasper744 (6791980 in chips)
Seat 7: hichnick777 (1903330 in chips)
Seat 8: casey1186 (5792466 in chips)
TeddyKGB027: posts the ante 20000
blackaces93: posts the ante 20000
sidlovskiy89: posts the ante 20000
lupninox: posts the ante 20000
kasper744: posts the ante 20000
hichnick777: posts the ante 20000
casey1186: posts the ante 20000
hichnick777: posts small blind 100000
casey1186: posts big blind 200000
*** HOLE CARDS ***
Dealt to hichnick777 [Qh 7h]
TeddyKGB027: folds
blackaces93: folds
sidlovskiy89: raises 242000 to 442000
lupninox: folds
kasper744: folds
hichnick777: folds
casey1186: calls 242000
*** FLOP *** [2c 8s Ac]
casey1186: checks
sidlovskiy89: bets 348440
casey1186: folds
Uncalled bet (348440) returned to sidlovskiy89
sidlovskiy89 collected 1124000 from pot
*** SUMMARY ***
Total pot 1124000 | Rake 0
Board [2c 8s Ac]
Seat 1: TeddyKGB027 folded before Flop (didn't bet)
Seat 2: blackaces93 folded before Flop (didn't bet)
Seat 3: sidlovskiy89 collected (1124000)
Seat 5: lupninox folded before Flop (didn't bet)
Seat 6: kasper744 (button) folded before Flop (didn't bet)
Seat 7: hichnick777 (small blind) folded before Flop
Seat 8: casey1186 (big blind) folded on the Flop


*********** # 441 **************
PokerStars Hand #176681493192: Tournament #2054568934, $20+$2 USD Hold'em No Limit - Level XLIV (100000/200000) - 2017/10/09 7:41:34 MSK [2017/10/09 0:41:34 ET]
Table '2054568934 598' 9-max Seat #7 is the button
Seat 1: TeddyKGB027 (7718660 in chips)
Seat 2: blackaces93 (3288016 in chips)
Seat 3: sidlovskiy89 (3163154 in chips)
Seat 5: lupninox (11005036 in chips)
Seat 6: kasper744 (6771980 in chips)
Seat 7: hichnick777 (1783330 in chips)
Seat 8: casey1186 (5330466 in chips)
TeddyKGB027: posts the ante 20000
blackaces93: posts the ante 20000
sidlovskiy89: posts the ante 20000
lupninox: posts the ante 20000
kasper744: posts the ante 20000
hichnick777: posts the ante 20000
casey1186: posts the ante 20000
casey1186: posts small blind 100000
TeddyKGB027: posts big blind 200000
*** HOLE CARDS ***
Dealt to hichnick777 [5h 7s]
blackaces93: folds
sidlovskiy89: folds
lupninox: raises 240000 to 440000
kasper744: folds
hichnick777: folds
casey1186: raises 4870466 to 5310466 and is all-in
TeddyKGB027: folds
lupninox: calls 4870466
*** FLOP *** [6s Tc 6h]
*** TURN *** [6s Tc 6h] [6c]
*** RIVER *** [6s Tc 6h 6c] [Qd]
*** SHOW DOWN ***
casey1186: shows [Qs Ac] (a full house, Sixes full of Queens)
lupninox: shows [9d 9s] (a full house, Sixes full of Nines)
casey1186 collected 10960932 from pot
*** SUMMARY ***
Total pot 10960932 | Rake 0
Board [6s Tc 6h 6c Qd]
Seat 1: TeddyKGB027 (big blind) folded before Flop
Seat 2: blackaces93 folded before Flop (didn't bet)
Seat 3: sidlovskiy89 folded before Flop (didn't bet)
Seat 5: lupninox showed [9d 9s] and lost with a full house, Sixes full of Nines
Seat 6: kasper744 folded before Flop (didn't bet)
Seat 7: hichnick777 (button) folded before Flop (didn't bet)
Seat 8: casey1186 (small blind) showed [Qs Ac] and won (10960932) with a full house, Sixes full of Queens


*********** # 442 **************
PokerStars Hand #176681504400: Tournament #2054568934, $20+$2 USD Hold'em No Limit - Level XLIV (100000/200000) - 2017/10/09 7:42:25 MSK [2017/10/09 0:42:25 ET]
Table '2054568934 598' 9-max Seat #8 is the button
Seat 1: TeddyKGB027 (7498660 in chips)
Seat 2: blackaces93 (3268016 in chips)
Seat 3: sidlovskiy89 (3143154 in chips)
Seat 5: lupninox (5674570 in chips)
Seat 6: kasper744 (6751980 in chips)
Seat 7: hichnick777 (1763330 in chips)
Seat 8: casey1186 (10960932 in chips)
TeddyKGB027: posts the ante 20000
blackaces93: posts the ante 20000
sidlovskiy89: posts the ante 20000
lupninox: posts the ante 20000
kasper744: posts the ante 20000
hichnick777: posts the ante 20000
casey1186: posts the ante 20000
TeddyKGB027: posts small blind 100000
blackaces93: posts big blind 200000
*** HOLE CARDS ***
Dealt to hichnick777 [9c 5d]
sidlovskiy89: folds
lupninox: folds
kasper744: folds
hichnick777: folds
casey1186: raises 200000 to 400000
TeddyKGB027: folds
blackaces93: calls 200000
*** FLOP *** [7h 2h 4d]
blackaces93: checks
casey1186: bets 400000
blackaces93: raises 2448016 to 2848016 and is all-in
casey1186: calls 2448016
*** TURN *** [7h 2h 4d] [Js]
*** RIVER *** [7h 2h 4d Js] [3c]
*** SHOW DOWN ***
blackaces93: shows [8h Jh] (a pair of Jacks)
casey1186: shows [4h Qh] (a pair of Fours)
blackaces93 collected 6736032 from pot
*** SUMMARY ***
Total pot 6736032 | Rake 0
Board [7h 2h 4d Js 3c]
Seat 1: TeddyKGB027 (small blind) folded before Flop
Seat 2: blackaces93 (big blind) showed [8h Jh] and won (6736032) with a pair of Jacks
Seat 3: sidlovskiy89 folded before Flop (didn't bet)
Seat 5: lupninox folded before Flop (didn't bet)
Seat 6: kasper744 folded before Flop (didn't bet)
Seat 7: hichnick777 folded before Flop (didn't bet)
Seat 8: casey1186 (button) showed [4h Qh] and lost with a pair of Fours


*********** # 443 **************
PokerStars Hand #176681515413: Tournament #2054568934, $20+$2 USD Hold'em No Limit - Level XLIV (100000/200000) - 2017/10/09 7:43:14 MSK [2017/10/09 0:43:14 ET]
Table '2054568934 598' 9-max Seat #1 is the button
Seat 1: TeddyKGB027 (7378660 in chips)
Seat 2: blackaces93 (6736032 in chips)
Seat 3: sidlovskiy89 (3123154 in chips)
Seat 5: lupninox (5654570 in chips)
Seat 6: kasper744 (6731980 in chips)
Seat 7: hichnick777 (1743330 in chips)
Seat 8: casey1186 (7692916 in chips)
TeddyKGB027: posts the ante 20000
blackaces93: posts the ante 20000
sidlovskiy89: posts the ante 20000
lupninox: posts the ante 20000
kasper744: posts the ante 20000
hichnick777: posts the ante 20000
casey1186: posts the ante 20000
blackaces93: posts small blind 100000
sidlovskiy89: posts big blind 200000
*** HOLE CARDS ***
Dealt to hichnick777 [9s 6s]
lupninox: raises 240000 to 440000
kasper744: calls 440000
hichnick777: folds
casey1186: folds
TeddyKGB027: folds
blackaces93: folds
sidlovskiy89: raises 2663154 to 3103154 and is all-in
lupninox: folds
kasper744: folds
Uncalled bet (2663154) returned to sidlovskiy89
sidlovskiy89 collected 1560000 from pot
*** SUMMARY ***
Total pot 1560000 | Rake 0
Seat 1: TeddyKGB027 (button) folded before Flop (didn't bet)
Seat 2: blackaces93 (small blind) folded before Flop
Seat 3: sidlovskiy89 (big blind) collected (1560000)
Seat 5: lupninox folded before Flop
Seat 6: kasper744 folded before Flop
Seat 7: hichnick777 folded before Flop (didn't bet)
Seat 8: casey1186 folded before Flop (didn't bet)


*********** # 444 **************
PokerStars Hand #176681521815: Tournament #2054568934, $20+$2 USD Hold'em No Limit - Level XLIV (100000/200000) - 2017/10/09 7:43:43 MSK [2017/10/09 0:43:43 ET]
Table '2054568934 598' 9-max Seat #2 is the button
Seat 1: TeddyKGB027 (7358660 in chips)
Seat 2: blackaces93 (6616032 in chips)
Seat 3: sidlovskiy89 (4223154 in chips)
Seat 5: lupninox (5194570 in chips)
Seat 6: kasper744 (6271980 in chips)
Seat 7: hichnick777 (1723330 in chips)
Seat 8: casey1186 (7672916 in chips)
TeddyKGB027: posts the ante 20000
blackaces93: posts the ante 20000
sidlovskiy89: posts the ante 20000
lupninox: posts the ante 20000
kasper744: posts the ante 20000
hichnick777: posts the ante 20000
casey1186: posts the ante 20000
sidlovskiy89: posts small blind 100000
lupninox: posts big blind 200000
*** HOLE CARDS ***
Dealt to hichnick777 [5h 5c]
kasper744: folds
hichnick777: raises 1503330 to 1703330 and is all-in
casey1186: folds
TeddyKGB027: folds
blackaces93: folds
sidlovskiy89: raises 2499824 to 4203154 and is all-in
lupninox: folds
Uncalled bet (2499824) returned to sidlovskiy89
*** FLOP *** [6d 8h 5s]
*** TURN *** [6d 8h 5s] [6c]
*** RIVER *** [6d 8h 5s 6c] [4s]
*** SHOW DOWN ***
sidlovskiy89: shows [9h 9d] (two pair, Nines and Sixes)
hichnick777: shows [5h 5c] (a full house, Fives full of Sixes)
hichnick777 collected 3746660 from pot
*** SUMMARY ***
Total pot 3746660 | Rake 0
Board [6d 8h 5s 6c 4s]
Seat 1: TeddyKGB027 folded before Flop (didn't bet)
Seat 2: blackaces93 (button) folded before Flop (didn't bet)
Seat 3: sidlovskiy89 (small blind) showed [9h 9d] and lost with two pair, Nines and Sixes
Seat 5: lupninox (big blind) folded before Flop
Seat 6: kasper744 folded before Flop (didn't bet)
Seat 7: hichnick777 showed [5h 5c] and won (3746660) with a full house, Fives full of Sixes
Seat 8: casey1186 folded before Flop (didn't bet)


*********** # 445 **************
PokerStars Hand #176681530786: Tournament #2054568934, $20+$2 USD Hold'em No Limit - Level XLIV (100000/200000) - 2017/10/09 7:44:24 MSK [2017/10/09 0:44:24 ET]
Table '2054568934 598' 9-max Seat #3 is the button
Seat 1: TeddyKGB027 (7338660 in chips)
Seat 2: blackaces93 (6596032 in chips)
Seat 3: sidlovskiy89 (2499824 in chips)
Seat 5: lupninox (4974570 in chips)
Seat 6: kasper744 (6251980 in chips)
Seat 7: hichnick777 (3746660 in chips)
Seat 8: casey1186 (7652916 in chips)
TeddyKGB027: posts the ante 20000
blackaces93: posts the ante 20000
sidlovskiy89: posts the ante 20000
lupninox: posts the ante 20000
kasper744: posts the ante 20000
hichnick777: posts the ante 20000
casey1186: posts the ante 20000
lupninox: posts small blind 100000
kasper744: posts big blind 200000
*** HOLE CARDS ***
Dealt to hichnick777 [8h Td]
hichnick777: folds
casey1186: folds
TeddyKGB027: folds
blackaces93: folds
sidlovskiy89: folds
lupninox: calls 100000
kasper744: checks
*** FLOP *** [2h Ac 3h]
lupninox: bets 250000
kasper744: calls 250000
*** TURN *** [2h Ac 3h] [5d]
lupninox: checks
kasper744: checks
*** RIVER *** [2h Ac 3h 5d] [Ts]
lupninox: bets 470250
kasper744: calls 470250
*** SHOW DOWN ***
lupninox: shows [Jc 9c] (high card Ace)
kasper744: shows [Ah 7c] (a pair of Aces)
kasper744 collected 1980500 from pot
*** SUMMARY ***
Total pot 1980500 | Rake 0
Board [2h Ac 3h 5d Ts]
Seat 1: TeddyKGB027 folded before Flop (didn't bet)
Seat 2: blackaces93 folded before Flop (didn't bet)
Seat 3: sidlovskiy89 (button) folded before Flop (didn't bet)
Seat 5: lupninox (small blind) showed [Jc 9c] and lost with high card Ace
Seat 6: kasper744 (big blind) showed [Ah 7c] and won (1980500) with a pair of Aces
Seat 7: hichnick777 folded before Flop (didn't bet)
Seat 8: casey1186 folded before Flop (didn't bet)


*********** # 446 **************
PokerStars Hand #176681549201: Tournament #2054568934, $20+$2 USD Hold'em No Limit - Level XLIV (100000/200000) - 2017/10/09 7:45:48 MSK [2017/10/09 0:45:48 ET]
Table '2054568934 598' 9-max Seat #5 is the button
Seat 1: TeddyKGB027 (7318660 in chips)
Seat 2: blackaces93 (6576032 in chips)
Seat 3: sidlovskiy89 (2479824 in chips)
Seat 5: lupninox (4034320 in chips)
Seat 6: kasper744 (7292230 in chips)
Seat 7: hichnick777 (3726660 in chips)
Seat 8: casey1186 (7632916 in chips)
TeddyKGB027: posts the ante 20000
blackaces93: posts the ante 20000
sidlovskiy89: posts the ante 20000
lupninox: posts the ante 20000
kasper744: posts the ante 20000
hichnick777: posts the ante 20000
casey1186: posts the ante 20000
kasper744: posts small blind 100000
hichnick777: posts big blind 200000
*** HOLE CARDS ***
Dealt to hichnick777 [Ts Ks]
casey1186: folds
TeddyKGB027: folds
blackaces93: raises 205770 to 405770
sidlovskiy89: folds
lupninox: folds
kasper744: folds
hichnick777: calls 205770
*** FLOP *** [2h 6c 8c]
hichnick777: checks
blackaces93: bets 289070
hichnick777: folds
Uncalled bet (289070) returned to blackaces93
blackaces93 collected 1051540 from pot
*** SUMMARY ***
Total pot 1051540 | Rake 0
Board [2h 6c 8c]
Seat 1: TeddyKGB027 folded before Flop (didn't bet)
Seat 2: blackaces93 collected (1051540)
Seat 3: sidlovskiy89 folded before Flop (didn't bet)
Seat 5: lupninox (button) folded before Flop (didn't bet)
Seat 6: kasper744 (small blind) folded before Flop
Seat 7: hichnick777 (big blind) folded on the Flop
Seat 8: casey1186 folded before Flop (didn't bet)


*********** # 447 **************
PokerStars Hand #176681567698: Tournament #2054568934, $20+$2 USD Hold'em No Limit - Level XLIV (100000/200000) - 2017/10/09 7:47:13 MSK [2017/10/09 0:47:13 ET]
Table '2054568934 598' 9-max Seat #6 is the button
Seat 1: TeddyKGB027 (7298660 in chips)
Seat 2: blackaces93 (7201802 in chips)
Seat 3: sidlovskiy89 (2459824 in chips)
Seat 5: lupninox (4014320 in chips)
Seat 6: kasper744 (7172230 in chips)
Seat 7: hichnick777 (3300890 in chips)
Seat 8: casey1186 (7612916 in chips)
TeddyKGB027: posts the ante 20000
blackaces93: posts the ante 20000
sidlovskiy89: posts the ante 20000
lupninox: posts the ante 20000
kasper744: posts the ante 20000
hichnick777: posts the ante 20000
casey1186: posts the ante 20000
hichnick777: posts small blind 100000
casey1186: posts big blind 200000
*** HOLE CARDS ***
Dealt to hichnick777 [Js 8d]
TeddyKGB027: folds
blackaces93: raises 205770 to 405770
sidlovskiy89: folds
lupninox: folds
kasper744: calls 405770
hichnick777: folds
casey1186: calls 205770
*** FLOP *** [2d Tc Jh]
casey1186: checks
blackaces93: checks
kasper744: checks
*** TURN *** [2d Tc Jh] [4c]
casey1186: bets 1457310
blackaces93: folds
kasper744: raises 5289150 to 6746460 and is all-in
casey1186: folds
Uncalled bet (5289150) returned to kasper744
kasper744 collected 4371930 from pot
kasper744: doesn't show hand
*** SUMMARY ***
Total pot 4371930 | Rake 0
Board [2d Tc Jh 4c]
Seat 1: TeddyKGB027 folded before Flop (didn't bet)
Seat 2: blackaces93 folded on the Turn
Seat 3: sidlovskiy89 folded before Flop (didn't bet)
Seat 5: lupninox folded before Flop (didn't bet)
Seat 6: kasper744 (button) collected (4371930)
Seat 7: hichnick777 (small blind) folded before Flop
Seat 8: casey1186 (big blind) folded on the Turn


*********** # 448 **************
PokerStars Hand #176681580961: Tournament #2054568934, $20+$2 USD Hold'em No Limit - Level XLIV (100000/200000) - 2017/10/09 7:48:13 MSK [2017/10/09 0:48:13 ET]
Table '2054568934 598' 9-max Seat #7 is the button
Seat 1: TeddyKGB027 (7278660 in chips)
Seat 2: blackaces93 (6776032 in chips)
Seat 3: sidlovskiy89 (2439824 in chips)
Seat 5: lupninox (3994320 in chips)
Seat 6: kasper744 (9661080 in chips)
Seat 7: hichnick777 (3180890 in chips)
Seat 8: casey1186 (5729836 in chips)
TeddyKGB027: posts the ante 20000
blackaces93: posts the ante 20000
sidlovskiy89: posts the ante 20000
lupninox: posts the ante 20000
kasper744: posts the ante 20000
hichnick777: posts the ante 20000
casey1186: posts the ante 20000
casey1186: posts small blind 100000
TeddyKGB027: posts big blind 200000
*** HOLE CARDS ***
Dealt to hichnick777 [7d 7h]
blackaces93: folds
sidlovskiy89: folds
lupninox: folds
kasper744: folds
hichnick777: raises 216000 to 416000
casey1186: folds
TeddyKGB027: folds
Uncalled bet (216000) returned to hichnick777
hichnick777 collected 640000 from pot
hichnick777: doesn't show hand
*** SUMMARY ***
Total pot 640000 | Rake 0
Seat 1: TeddyKGB027 (big blind) folded before Flop
Seat 2: blackaces93 folded before Flop (didn't bet)
Seat 3: sidlovskiy89 folded before Flop (didn't bet)
Seat 5: lupninox folded before Flop (didn't bet)
Seat 6: kasper744 folded before Flop (didn't bet)
Seat 7: hichnick777 (button) collected (640000)
Seat 8: casey1186 (small blind) folded before Flop


*********** # 449 **************
PokerStars Hand #176681592525: Tournament #2054568934, $20+$2 USD Hold'em No Limit - Level XLIV (100000/200000) - 2017/10/09 7:49:06 MSK [2017/10/09 0:49:06 ET]
Table '2054568934 598' 9-max Seat #8 is the button
Seat 1: TeddyKGB027 (7058660 in chips)
Seat 2: blackaces93 (6756032 in chips)
Seat 3: sidlovskiy89 (2419824 in chips)
Seat 5: lupninox (3974320 in chips)
Seat 6: kasper744 (9641080 in chips)
Seat 7: hichnick777 (3600890 in chips)
Seat 8: casey1186 (5609836 in chips)
TeddyKGB027: posts the ante 20000
blackaces93: posts the ante 20000
sidlovskiy89: posts the ante 20000
lupninox: posts the ante 20000
kasper744: posts the ante 20000
hichnick777: posts the ante 20000
casey1186: posts the ante 20000
TeddyKGB027: posts small blind 100000
blackaces93: posts big blind 200000
*** HOLE CARDS ***
Dealt to hichnick777 [5s 6d]
sidlovskiy89: folds
lupninox: folds
kasper744: folds
hichnick777: folds
casey1186: folds
TeddyKGB027: raises 330000 to 530000
blackaces93: calls 330000
*** FLOP *** [8d 7h 2c]
TeddyKGB027: bets 420000
blackaces93: calls 420000
*** TURN *** [8d 7h 2c] [Qc]
TeddyKGB027: checks
blackaces93: checks
*** RIVER *** [8d 7h 2c Qc] [9d]
TeddyKGB027: checks
blackaces93: checks
*** SHOW DOWN ***
TeddyKGB027: shows [As 2s] (a pair of Deuces)
blackaces93: shows [4c 8c] (a pair of Eights)
blackaces93 collected 2040000 from pot
*** SUMMARY ***
Total pot 2040000 | Rake 0
Board [8d 7h 2c Qc 9d]
Seat 1: TeddyKGB027 (small blind) showed [As 2s] and lost with a pair of Deuces
Seat 2: blackaces93 (big blind) showed [4c 8c] and won (2040000) with a pair of Eights
Seat 3: sidlovskiy89 folded before Flop (didn't bet)
Seat 5: lupninox folded before Flop (didn't bet)
Seat 6: kasper744 folded before Flop (didn't bet)
Seat 7: hichnick777 folded before Flop (didn't bet)
Seat 8: casey1186 (button) folded before Flop (didn't bet)


*********** # 450 **************
PokerStars Hand #176681617121: Tournament #2054568934, $20+$2 USD Hold'em No Limit - Level XLIV (100000/200000) - 2017/10/09 7:50:59 MSK [2017/10/09 0:50:59 ET]
Table '2054568934 598' 9-max Seat #1 is the button
Seat 1: TeddyKGB027 (6088660 in chips)
Seat 2: blackaces93 (7826032 in chips)
Seat 3: sidlovskiy89 (2399824 in chips)
Seat 5: lupninox (3954320 in chips)
Seat 6: kasper744 (9621080 in chips)
Seat 7: hichnick777 (3580890 in chips)
Seat 8: casey1186 (5589836 in chips)
TeddyKGB027: posts the ante 20000
blackaces93: posts the ante 20000
sidlovskiy89: posts the ante 20000
lupninox: posts the ante 20000
kasper744: posts the ante 20000
hichnick777: posts the ante 20000
casey1186: posts the ante 20000
blackaces93: posts small blind 100000
sidlovskiy89: posts big blind 200000
*** HOLE CARDS ***
Dealt to hichnick777 [7s Tc]
lupninox: raises 240000 to 440000
kasper744: folds
hichnick777: folds
casey1186: calls 440000
TeddyKGB027: folds
blackaces93: folds
sidlovskiy89: folds
*** FLOP *** [4h Js 7d]
lupninox: checks
casey1186: checks
*** TURN *** [4h Js 7d] [6h]
lupninox: checks
casey1186: bets 800000
lupninox: calls 800000
*** RIVER *** [4h Js 7d 6h] [9s]
lupninox: checks
casey1186: bets 4329836 and is all-in
lupninox: calls 2694320 and is all-in
Uncalled bet (1635516) returned to casey1186
*** SHOW DOWN ***
casey1186: shows [6c 6d] (three of a kind, Sixes)
lupninox: shows [Ks Jd] (a pair of Jacks)
casey1186 collected 8308640 from pot
lupninox finished the tournament in 13th place and received $782.09.
*** SUMMARY ***
Total pot 8308640 | Rake 0
Board [4h Js 7d 6h 9s]
Seat 1: TeddyKGB027 (button) folded before Flop (didn't bet)
Seat 2: blackaces93 (small blind) folded before Flop
Seat 3: sidlovskiy89 (big blind) folded before Flop
Seat 5: lupninox showed [Ks Jd] and lost with a pair of Jacks
Seat 6: kasper744 folded before Flop (didn't bet)
Seat 7: hichnick777 folded before Flop (didn't bet)
Seat 8: casey1186 showed [6c 6d] and won (8308640) with three of a kind, Sixes


*********** # 451 **************
PokerStars Hand #176681630539: Tournament #2054568934, $20+$2 USD Hold'em No Limit - Level XLV (125000/250000) - 2017/10/09 7:52:00 MSK [2017/10/09 0:52:00 ET]
Table '2054568934 598' 9-max Seat #2 is the button
Seat 1: TeddyKGB027 (6068660 in chips)
Seat 2: blackaces93 (7706032 in chips)
Seat 3: sidlovskiy89 (2179824 in chips)
Seat 6: kasper744 (9601080 in chips)
Seat 7: hichnick777 (3560890 in chips)
Seat 8: casey1186 (9944156 in chips)
TeddyKGB027: posts the ante 25000
blackaces93: posts the ante 25000
sidlovskiy89: posts the ante 25000
kasper744: posts the ante 25000
hichnick777: posts the ante 25000
casey1186: posts the ante 25000
sidlovskiy89: posts small blind 125000
kasper744: posts big blind 250000
*** HOLE CARDS ***
Dealt to hichnick777 [8h 6s]
hichnick777: folds
casey1186: folds
TeddyKGB027: folds
blackaces93: folds
sidlovskiy89: raises 1904824 to 2154824 and is all-in
kasper744: folds
Uncalled bet (1904824) returned to sidlovskiy89
sidlovskiy89 collected 650000 from pot
*** SUMMARY ***
Total pot 650000 | Rake 0
Seat 1: TeddyKGB027 folded before Flop (didn't bet)
Seat 2: blackaces93 (button) folded before Flop (didn't bet)
Seat 3: sidlovskiy89 (small blind) collected (650000)
Seat 6: kasper744 (big blind) folded before Flop
Seat 7: hichnick777 folded before Flop (didn't bet)
Seat 8: casey1186 folded before Flop (didn't bet)


*********** # 452 **************
PokerStars Hand #176681640086: Tournament #2054568934, $20+$2 USD Hold'em No Limit - Level XLV (125000/250000) - 2017/10/09 7:52:44 MSK [2017/10/09 0:52:44 ET]
Table '2054568934 598' 9-max Seat #3 is the button
Seat 1: TeddyKGB027 (6043660 in chips)
Seat 2: blackaces93 (7681032 in chips)
Seat 3: sidlovskiy89 (2554824 in chips)
Seat 6: kasper744 (9326080 in chips)
Seat 7: hichnick777 (3535890 in chips)
Seat 8: casey1186 (9919156 in chips)
TeddyKGB027: posts the ante 25000
blackaces93: posts the ante 25000
sidlovskiy89: posts the ante 25000
kasper744: posts the ante 25000
hichnick777: posts the ante 25000
casey1186: posts the ante 25000
kasper744: posts small blind 125000
hichnick777: posts big blind 250000
*** HOLE CARDS ***
Dealt to hichnick777 [7d Qd]
casey1186: folds
TeddyKGB027: folds
blackaces93: folds
sidlovskiy89: folds
kasper744: raises 9051080 to 9301080 and is all-in
hichnick777: folds
Uncalled bet (9051080) returned to kasper744
kasper744 collected 650000 from pot
kasper744: doesn't show hand
*** SUMMARY ***
Total pot 650000 | Rake 0
Seat 1: TeddyKGB027 folded before Flop (didn't bet)
Seat 2: blackaces93 folded before Flop (didn't bet)
Seat 3: sidlovskiy89 (button) folded before Flop (didn't bet)
Seat 6: kasper744 (small blind) collected (650000)
Seat 7: hichnick777 (big blind) folded before Flop
Seat 8: casey1186 folded before Flop (didn't bet)


*********** # 453 **************
PokerStars Hand #176681644043: Tournament #2054568934, $20+$2 USD Hold'em No Limit - Level XLV (125000/250000) - 2017/10/09 7:53:02 MSK [2017/10/09 0:53:02 ET]
Table '2054568934 598' 9-max Seat #6 is the button
Seat 1: TeddyKGB027 (6018660 in chips)
Seat 2: blackaces93 (7656032 in chips)
Seat 3: sidlovskiy89 (2529824 in chips)
Seat 6: kasper744 (9701080 in chips)
Seat 7: hichnick777 (3260890 in chips)
Seat 8: casey1186 (9894156 in chips)
TeddyKGB027: posts the ante 25000
blackaces93: posts the ante 25000
sidlovskiy89: posts the ante 25000
kasper744: posts the ante 25000
hichnick777: posts the ante 25000
casey1186: posts the ante 25000
hichnick777: posts small blind 125000
casey1186: posts big blind 250000
*** HOLE CARDS ***
Dealt to hichnick777 [5h 3h]
TeddyKGB027: folds
blackaces93: raises 258770 to 508770
sidlovskiy89: folds
kasper744: folds
hichnick777: folds
casey1186: folds
Uncalled bet (258770) returned to blackaces93
blackaces93 collected 775000 from pot
*** SUMMARY ***
Total pot 775000 | Rake 0
Seat 1: TeddyKGB027 folded before Flop (didn't bet)
Seat 2: blackaces93 collected (775000)
Seat 3: sidlovskiy89 folded before Flop (didn't bet)
Seat 6: kasper744 (button) folded before Flop (didn't bet)
Seat 7: hichnick777 (small blind) folded before Flop
Seat 8: casey1186 (big blind) folded before Flop


*********** # 454 **************
PokerStars Hand #176681650932: Tournament #2054568934, $20+$2 USD Hold'em No Limit - Level XLV (125000/250000) - 2017/10/09 7:53:34 MSK [2017/10/09 0:53:34 ET]
Table '2054568934 598' 9-max Seat #7 is the button
Seat 1: TeddyKGB027 (5993660 in chips)
Seat 2: blackaces93 (8156032 in chips)
Seat 3: sidlovskiy89 (2504824 in chips)
Seat 6: kasper744 (9676080 in chips)
Seat 7: hichnick777 (3110890 in chips)
Seat 8: casey1186 (9619156 in chips)
TeddyKGB027: posts the ante 25000
blackaces93: posts the ante 25000
sidlovskiy89: posts the ante 25000
kasper744: posts the ante 25000
hichnick777: posts the ante 25000
casey1186: posts the ante 25000
casey1186: posts small blind 125000
TeddyKGB027: posts big blind 250000
*** HOLE CARDS ***
Dealt to hichnick777 [9s Kh]
blackaces93: folds
sidlovskiy89: raises 2229824 to 2479824 and is all-in
kasper744: folds
hichnick777: folds
casey1186: folds
TeddyKGB027: folds
Uncalled bet (2229824) returned to sidlovskiy89
sidlovskiy89 collected 775000 from pot
*** SUMMARY ***
Total pot 775000 | Rake 0
Seat 1: TeddyKGB027 (big blind) folded before Flop
Seat 2: blackaces93 folded before Flop (didn't bet)
Seat 3: sidlovskiy89 collected (775000)
Seat 6: kasper744 folded before Flop (didn't bet)
Seat 7: hichnick777 (button) folded before Flop (didn't bet)
Seat 8: casey1186 (small blind) folded before Flop


*********** # 455 **************
PokerStars Hand #176681656893: Tournament #2054568934, $20+$2 USD Hold'em No Limit - Level XLV (125000/250000) - 2017/10/09 7:54:02 MSK [2017/10/09 0:54:02 ET]
Table '2054568934 598' 9-max Seat #8 is the button
Seat 1: TeddyKGB027 (5718660 in chips)
Seat 2: blackaces93 (8131032 in chips)
Seat 3: sidlovskiy89 (3004824 in chips)
Seat 6: kasper744 (9651080 in chips)
Seat 7: hichnick777 (3085890 in chips)
Seat 8: casey1186 (9469156 in chips)
TeddyKGB027: posts the ante 25000
blackaces93: posts the ante 25000
sidlovskiy89: posts the ante 25000
kasper744: posts the ante 25000
hichnick777: posts the ante 25000
casey1186: posts the ante 25000
TeddyKGB027: posts small blind 125000
blackaces93: posts big blind 250000
*** HOLE CARDS ***
Dealt to hichnick777 [5c 8h]
sidlovskiy89: folds
kasper744: folds
hichnick777: folds
casey1186: raises 400000 to 650000
TeddyKGB027: raises 5043660 to 5693660 and is all-in
blackaces93: folds
casey1186: folds
Uncalled bet (5043660) returned to TeddyKGB027
TeddyKGB027 collected 1700000 from pot
TeddyKGB027: doesn't show hand
*** SUMMARY ***
Total pot 1700000 | Rake 0
Seat 1: TeddyKGB027 (small blind) collected (1700000)
Seat 2: blackaces93 (big blind) folded before Flop
Seat 3: sidlovskiy89 folded before Flop (didn't bet)
Seat 6: kasper744 folded before Flop (didn't bet)
Seat 7: hichnick777 folded before Flop (didn't bet)
Seat 8: casey1186 (button) folded before Flop


*********** # 456 **************
PokerStars Hand #176681664557: Tournament #2054568934, $20+$2 USD Hold'em No Limit - Level XLV (125000/250000) - 2017/10/09 7:54:37 MSK [2017/10/09 0:54:37 ET]
Table '2054568934 598' 9-max Seat #1 is the button
Seat 1: TeddyKGB027 (6743660 in chips)
Seat 2: blackaces93 (7856032 in chips)
Seat 3: sidlovskiy89 (2979824 in chips)
Seat 6: kasper744 (9626080 in chips)
Seat 7: hichnick777 (3060890 in chips)
Seat 8: casey1186 (8794156 in chips)
TeddyKGB027: posts the ante 25000
blackaces93: posts the ante 25000
sidlovskiy89: posts the ante 25000
kasper744: posts the ante 25000
hichnick777: posts the ante 25000
casey1186: posts the ante 25000
blackaces93: posts small blind 125000
sidlovskiy89: posts big blind 250000
*** HOLE CARDS ***
Dealt to hichnick777 [2d Kc]
kasper744: folds
hichnick777: folds
casey1186: folds
TeddyKGB027: folds
blackaces93: calls 125000
sidlovskiy89: checks
*** FLOP *** [8h 9c 8s]
blackaces93: bets 250000
sidlovskiy89: calls 250000
*** TURN *** [8h 9c 8s] [5c]
blackaces93: checks
sidlovskiy89: checks
*** RIVER *** [8h 9c 8s 5c] [Jd]
blackaces93: bets 732500
sidlovskiy89: calls 732500
*** SHOW DOWN ***
blackaces93: shows [4s 6c] (a pair of Eights)
sidlovskiy89: shows [9h Tc] (two pair, Nines and Eights)
sidlovskiy89 collected 2615000 from pot
*** SUMMARY ***
Total pot 2615000 | Rake 0
Board [8h 9c 8s 5c Jd]
Seat 1: TeddyKGB027 (button) folded before Flop (didn't bet)
Seat 2: blackaces93 (small blind) showed [4s 6c] and lost with a pair of Eights
Seat 3: sidlovskiy89 (big blind) showed [9h Tc] and won (2615000) with two pair, Nines and Eights
Seat 6: kasper744 folded before Flop (didn't bet)
Seat 7: hichnick777 folded before Flop (didn't bet)
Seat 8: casey1186 folded before Flop (didn't bet)


*********** # 457 **************
PokerStars Hand #176681744801: Tournament #2054568934, $20+$2 USD Hold'em No Limit - Level XLV (125000/250000) - 2017/10/09 8:01:17 MSK [2017/10/09 1:01:17 ET]
Table '2054568934 598' 9-max Seat #2 is the button
Seat 1: TeddyKGB027 (6718660 in chips)
Seat 2: blackaces93 (6598532 in chips)
Seat 3: sidlovskiy89 (4337324 in chips)
Seat 6: kasper744 (9601080 in chips)
Seat 7: hichnick777 (3035890 in chips)
Seat 8: casey1186 (8769156 in chips)
TeddyKGB027: posts the ante 25000
blackaces93: posts the ante 25000
sidlovskiy89: posts the ante 25000
kasper744: posts the ante 25000
hichnick777: posts the ante 25000
casey1186: posts the ante 25000
sidlovskiy89: posts small blind 125000
kasper744: posts big blind 250000
*** HOLE CARDS ***
Dealt to hichnick777 [2c Ad]
hichnick777: folds
casey1186: raises 775000 to 1025000
TeddyKGB027: folds
blackaces93: folds
sidlovskiy89: folds
kasper744: folds
Uncalled bet (775000) returned to casey1186
casey1186 collected 775000 from pot
casey1186: doesn't show hand
*** SUMMARY ***
Total pot 775000 | Rake 0
Seat 1: TeddyKGB027 folded before Flop (didn't bet)
Seat 2: blackaces93 (button) folded before Flop (didn't bet)
Seat 3: sidlovskiy89 (small blind) folded before Flop
Seat 6: kasper744 (big blind) folded before Flop
Seat 7: hichnick777 folded before Flop (didn't bet)
Seat 8: casey1186 collected (775000)


*********** # 458 **************
PokerStars Hand #176681757755: Tournament #2054568934, $20+$2 USD Hold'em No Limit - Level XLV (125000/250000) - 2017/10/09 8:02:18 MSK [2017/10/09 1:02:18 ET]
Table '2054568934 598' 9-max Seat #3 is the button
Seat 1: TeddyKGB027 (6693660 in chips)
Seat 2: blackaces93 (6573532 in chips)
Seat 3: sidlovskiy89 (4187324 in chips)
Seat 6: kasper744 (9326080 in chips)
Seat 7: hichnick777 (3010890 in chips)
Seat 8: casey1186 (9269156 in chips)
TeddyKGB027: posts the ante 25000
blackaces93: posts the ante 25000
sidlovskiy89: posts the ante 25000
kasper744: posts the ante 25000
hichnick777: posts the ante 25000
casey1186: posts the ante 25000
kasper744: posts small blind 125000
hichnick777: posts big blind 250000
*** HOLE CARDS ***
Dealt to hichnick777 [7c 8c]
casey1186: folds
TeddyKGB027: folds
blackaces93: folds
sidlovskiy89: folds
kasper744: raises 9051080 to 9301080 and is all-in
hichnick777: folds
Uncalled bet (9051080) returned to kasper744
kasper744 collected 650000 from pot
kasper744: doesn't show hand
*** SUMMARY ***
Total pot 650000 | Rake 0
Seat 1: TeddyKGB027 folded before Flop (didn't bet)
Seat 2: blackaces93 folded before Flop (didn't bet)
Seat 3: sidlovskiy89 (button) folded before Flop (didn't bet)
Seat 6: kasper744 (small blind) collected (650000)
Seat 7: hichnick777 (big blind) folded before Flop
Seat 8: casey1186 folded before Flop (didn't bet)


*********** # 459 **************
PokerStars Hand #176681764838: Tournament #2054568934, $20+$2 USD Hold'em No Limit - Level XLV (125000/250000) - 2017/10/09 8:02:50 MSK [2017/10/09 1:02:50 ET]
Table '2054568934 598' 9-max Seat #6 is the button
Seat 1: TeddyKGB027 (6668660 in chips)
Seat 2: blackaces93 (6548532 in chips)
Seat 3: sidlovskiy89 (4162324 in chips)
Seat 6: kasper744 (9701080 in chips)
Seat 7: hichnick777 (2735890 in chips)
Seat 8: casey1186 (9244156 in chips)
TeddyKGB027: posts the ante 25000
blackaces93: posts the ante 25000
sidlovskiy89: posts the ante 25000
kasper744: posts the ante 25000
hichnick777: posts the ante 25000
casey1186: posts the ante 25000
hichnick777: posts small blind 125000
casey1186: posts big blind 250000
*** HOLE CARDS ***
Dealt to hichnick777 [Ks 6d]
TeddyKGB027: raises 250000 to 500000
blackaces93: folds
sidlovskiy89: folds
kasper744: folds
hichnick777: folds
casey1186: calls 250000
*** FLOP *** [Th 6h 6c]
casey1186: bets 1275000
TeddyKGB027: folds
Uncalled bet (1275000) returned to casey1186
casey1186 collected 1275000 from pot
casey1186: doesn't show hand
*** SUMMARY ***
Total pot 1275000 | Rake 0
Board [Th 6h 6c]
Seat 1: TeddyKGB027 folded on the Flop
Seat 2: blackaces93 folded before Flop (didn't bet)
Seat 3: sidlovskiy89 folded before Flop (didn't bet)
Seat 6: kasper744 (button) folded before Flop (didn't bet)
Seat 7: hichnick777 (small blind) folded before Flop
Seat 8: casey1186 (big blind) collected (1275000)


*********** # 460 **************
PokerStars Hand #176681773014: Tournament #2054568934, $20+$2 USD Hold'em No Limit - Level XLV (125000/250000) - 2017/10/09 8:03:29 MSK [2017/10/09 1:03:29 ET]
Table '2054568934 598' 9-max Seat #7 is the button
Seat 1: TeddyKGB027 (6143660 in chips)
Seat 2: blackaces93 (6523532 in chips)
Seat 3: sidlovskiy89 (4137324 in chips)
Seat 6: kasper744 (9676080 in chips)
Seat 7: hichnick777 (2585890 in chips)
Seat 8: casey1186 (9994156 in chips)
TeddyKGB027: posts the ante 25000
blackaces93: posts the ante 25000
sidlovskiy89: posts the ante 25000
kasper744: posts the ante 25000
hichnick777: posts the ante 25000
casey1186: posts the ante 25000
casey1186: posts small blind 125000
TeddyKGB027: posts big blind 250000
*** HOLE CARDS ***
Dealt to hichnick777 [7h Jh]
blackaces93: folds
sidlovskiy89: folds
kasper744: folds
hichnick777: raises 2310890 to 2560890 and is all-in
casey1186: folds
TeddyKGB027: folds
Uncalled bet (2310890) returned to hichnick777
hichnick777 collected 775000 from pot
hichnick777: doesn't show hand
*** SUMMARY ***
Total pot 775000 | Rake 0
Seat 1: TeddyKGB027 (big blind) folded before Flop
Seat 2: blackaces93 folded before Flop (didn't bet)
Seat 3: sidlovskiy89 folded before Flop (didn't bet)
Seat 6: kasper744 folded before Flop (didn't bet)
Seat 7: hichnick777 (button) collected (775000)
Seat 8: casey1186 (small blind) folded before Flop


*********** # 461 **************
PokerStars Hand #176681781862: Tournament #2054568934, $20+$2 USD Hold'em No Limit - Level XLV (125000/250000) - 2017/10/09 8:04:10 MSK [2017/10/09 1:04:10 ET]
Table '2054568934 598' 9-max Seat #8 is the button
Seat 1: TeddyKGB027 (5868660 in chips)
Seat 2: blackaces93 (6498532 in chips)
Seat 3: sidlovskiy89 (4112324 in chips)
Seat 6: kasper744 (9651080 in chips)
Seat 7: hichnick777 (3085890 in chips)
Seat 8: casey1186 (9844156 in chips)
TeddyKGB027: posts the ante 25000
blackaces93: posts the ante 25000
sidlovskiy89: posts the ante 25000
kasper744: posts the ante 25000
hichnick777: posts the ante 25000
casey1186: posts the ante 25000
TeddyKGB027: posts small blind 125000
blackaces93: posts big blind 250000
*** HOLE CARDS ***
Dealt to hichnick777 [Td Tc]
sidlovskiy89: folds
kasper744: raises 425000 to 675000
hichnick777: raises 2385890 to 3060890 and is all-in
casey1186: folds
TeddyKGB027: folds
blackaces93: folds
kasper744: calls 2385890
*** FLOP *** [2c 8c Ts]
*** TURN *** [2c 8c Ts] [Jc]
*** RIVER *** [2c 8c Ts Jc] [5d]
*** SHOW DOWN ***
kasper744: shows [4s 4d] (a pair of Fours)
hichnick777: shows [Td Tc] (three of a kind, Tens)
hichnick777 collected 6646780 from pot
*** SUMMARY ***
Total pot 6646780 | Rake 0
Board [2c 8c Ts Jc 5d]
Seat 1: TeddyKGB027 (small blind) folded before Flop
Seat 2: blackaces93 (big blind) folded before Flop
Seat 3: sidlovskiy89 folded before Flop (didn't bet)
Seat 6: kasper744 showed [4s 4d] and lost with a pair of Fours
Seat 7: hichnick777 showed [Td Tc] and won (6646780) with three of a kind, Tens
Seat 8: casey1186 (button) folded before Flop (didn't bet)


*********** # 462 **************
PokerStars Hand #176681790959: Tournament #2054568934, $20+$2 USD Hold'em No Limit - Level XLV (125000/250000) - 2017/10/09 8:04:53 MSK [2017/10/09 1:04:53 ET]
Table '2054568934 598' 9-max Seat #1 is the button
Seat 1: TeddyKGB027 (5718660 in chips)
Seat 2: blackaces93 (6223532 in chips)
Seat 3: sidlovskiy89 (4087324 in chips)
Seat 6: kasper744 (6565190 in chips)
Seat 7: hichnick777 (6646780 in chips)
Seat 8: casey1186 (9819156 in chips)
TeddyKGB027: posts the ante 25000
blackaces93: posts the ante 25000
sidlovskiy89: posts the ante 25000
kasper744: posts the ante 25000
hichnick777: posts the ante 25000
casey1186: posts the ante 25000
blackaces93: posts small blind 125000
sidlovskiy89: posts big blind 250000
*** HOLE CARDS ***
Dealt to hichnick777 [Ac 8s]
kasper744: folds
hichnick777: folds
casey1186: raises 500000 to 750000
TeddyKGB027: folds
blackaces93: folds
sidlovskiy89: raises 3312324 to 4062324 and is all-in
casey1186: calls 3312324
*** FLOP *** [Kc Td 6c]
*** TURN *** [Kc Td 6c] [2h]
*** RIVER *** [Kc Td 6c 2h] [3s]
*** SHOW DOWN ***
sidlovskiy89: shows [7s 7d] (a pair of Sevens)
casey1186: shows [Kh Kd] (three of a kind, Kings)
casey1186 collected 8399648 from pot
sidlovskiy89 finished the tournament in 11th place and received $782.09.
*** SUMMARY ***
Total pot 8399648 | Rake 0
Board [Kc Td 6c 2h 3s]
Seat 1: TeddyKGB027 (button) folded before Flop (didn't bet)
Seat 2: blackaces93 (small blind) folded before Flop
Seat 3: sidlovskiy89 (big blind) showed [7s 7d] and lost with a pair of Sevens
Seat 6: kasper744 folded before Flop (didn't bet)
Seat 7: hichnick777 folded before Flop (didn't bet)
Seat 8: casey1186 showed [Kh Kd] and won (8399648) with three of a kind, Kings


*********** # 463 **************
PokerStars Hand #176681797486: Tournament #2054568934, $20+$2 USD Hold'em No Limit - Level XLV (125000/250000) - 2017/10/09 8:05:22 MSK [2017/10/09 1:05:22 ET]
Table '2054568934 598' 9-max Seat #2 is the button
Seat 1: TeddyKGB027 (5693660 in chips)
Seat 2: blackaces93 (6073532 in chips)
Seat 6: kasper744 (6540190 in chips)
Seat 7: hichnick777 (6621780 in chips)
Seat 8: casey1186 (14131480 in chips)
TeddyKGB027: posts the ante 25000
blackaces93: posts the ante 25000
kasper744: posts the ante 25000
hichnick777: posts the ante 25000
casey1186: posts the ante 25000
kasper744: posts small blind 125000
hichnick777: posts big blind 250000
*** HOLE CARDS ***
Dealt to hichnick777 [2d 6h]
casey1186: folds
TeddyKGB027: folds
blackaces93: raises 257770 to 507770
kasper744: folds
hichnick777: folds
Uncalled bet (257770) returned to blackaces93
blackaces93 collected 750000 from pot
blackaces93: doesn't show hand
*** SUMMARY ***
Total pot 750000 | Rake 0
Seat 1: TeddyKGB027 folded before Flop (didn't bet)
Seat 2: blackaces93 (button) collected (750000)
Seat 6: kasper744 (small blind) folded before Flop
Seat 7: hichnick777 (big blind) folded before Flop
Seat 8: casey1186 folded before Flop (didn't bet)


*********** # 464 **************
PokerStars Hand #176681803214: Tournament #2054568934, $20+$2 USD Hold'em No Limit - Level XLV (125000/250000) - 2017/10/09 8:05:48 MSK [2017/10/09 1:05:48 ET]
Table '2054568934 598' 9-max Seat #6 is the button
Seat 1: TeddyKGB027 (5668660 in chips)
Seat 2: blackaces93 (6548532 in chips)
Seat 6: kasper744 (6390190 in chips)
Seat 7: hichnick777 (6346780 in chips)
Seat 8: casey1186 (14106480 in chips)
TeddyKGB027: posts the ante 25000
blackaces93: posts the ante 25000
kasper744: posts the ante 25000
hichnick777: posts the ante 25000
casey1186: posts the ante 25000
hichnick777: posts small blind 125000
casey1186: posts big blind 250000
*** HOLE CARDS ***
Dealt to hichnick777 [6h Th]
TeddyKGB027: raises 337500 to 587500
blackaces93: folds
kasper744: folds
hichnick777: folds
casey1186: folds
Uncalled bet (337500) returned to TeddyKGB027
TeddyKGB027 collected 750000 from pot
TeddyKGB027: doesn't show hand
*** SUMMARY ***
Total pot 750000 | Rake 0
Seat 1: TeddyKGB027 collected (750000)
Seat 2: blackaces93 folded before Flop (didn't bet)
Seat 6: kasper744 (button) folded before Flop (didn't bet)
Seat 7: hichnick777 (small blind) folded before Flop
Seat 8: casey1186 (big blind) folded before Flop


*********** # 465 **************
PokerStars Hand #176681810949: Tournament #2054568934, $20+$2 USD Hold'em No Limit - Level XLV (125000/250000) - 2017/10/09 8:06:23 MSK [2017/10/09 1:06:23 ET]
Table '2054568934 598' 9-max Seat #7 is the button
Seat 1: TeddyKGB027 (6143660 in chips)
Seat 2: blackaces93 (6523532 in chips)
Seat 6: kasper744 (6365190 in chips)
Seat 7: hichnick777 (6196780 in chips)
Seat 8: casey1186 (13831480 in chips)
TeddyKGB027: posts the ante 25000
blackaces93: posts the ante 25000
kasper744: posts the ante 25000
hichnick777: posts the ante 25000
casey1186: posts the ante 25000
casey1186: posts small blind 125000
TeddyKGB027: posts big blind 250000
*** HOLE CARDS ***
Dealt to hichnick777 [Qc 3h]
blackaces93: folds
kasper744: folds
hichnick777: folds
casey1186: raises 625000 to 875000
TeddyKGB027: folds
Uncalled bet (625000) returned to casey1186
casey1186 collected 625000 from pot
casey1186: doesn't show hand
*** SUMMARY ***
Total pot 625000 | Rake 0
Seat 1: TeddyKGB027 (big blind) folded before Flop
Seat 2: blackaces93 folded before Flop (didn't bet)
Seat 6: kasper744 folded before Flop (didn't bet)
Seat 7: hichnick777 (button) folded before Flop (didn't bet)
Seat 8: casey1186 (small blind) collected (625000)


*********** # 466 **************
PokerStars Hand #176681816037: Tournament #2054568934, $20+$2 USD Hold'em No Limit - Level XLV (125000/250000) - 2017/10/09 8:06:46 MSK [2017/10/09 1:06:46 ET]
Table '2054568934 598' 9-max Seat #8 is the button
Seat 1: TeddyKGB027 (5868660 in chips)
Seat 2: blackaces93 (6498532 in chips)
Seat 6: kasper744 (6340190 in chips)
Seat 7: hichnick777 (6171780 in chips)
Seat 8: casey1186 (14181480 in chips)
TeddyKGB027: posts the ante 25000
blackaces93: posts the ante 25000
kasper744: posts the ante 25000
hichnick777: posts the ante 25000
casey1186: posts the ante 25000
TeddyKGB027: posts small blind 125000
blackaces93: posts big blind 250000
*** HOLE CARDS ***
Dealt to hichnick777 [Td 4s]
kasper744: folds
hichnick777: folds
casey1186: raises 500000 to 750000
TeddyKGB027: folds
blackaces93: raises 5723532 to 6473532 and is all-in
casey1186: calls 5723532
*** FLOP *** [6d 3c 6h]
*** TURN *** [6d 3c 6h] [9c]
*** RIVER *** [6d 3c 6h 9c] [2h]
*** SHOW DOWN ***
blackaces93: shows [9s As] (two pair, Nines and Sixes)
casey1186: shows [Ks Kh] (two pair, Kings and Sixes)
casey1186 collected 13197064 from pot
blackaces93 finished the tournament in 10th place and received $782.09.
*** SUMMARY ***
Total pot 13197064 | Rake 0
Board [6d 3c 6h 9c 2h]
Seat 1: TeddyKGB027 (small blind) folded before Flop
Seat 2: blackaces93 (big blind) showed [9s As] and lost with two pair, Nines and Sixes
Seat 6: kasper744 folded before Flop (didn't bet)
Seat 7: hichnick777 folded before Flop (didn't bet)
Seat 8: casey1186 (button) showed [Ks Kh] and won (13197064) with two pair, Kings and Sixes


*********** # 467 **************
PokerStars Hand #176681821894: Tournament #2054568934, $20+$2 USD Hold'em No Limit - Level XLV (125000/250000) - 2017/10/09 8:07:13 MSK [2017/10/09 1:07:13 ET]
Table '2054568934 624' 9-max Seat #1 is the button
Seat 1: youdri15 (5979401 in chips)
Seat 2: 4time2warp0 (8432986 in chips)
Seat 3: AtilaMoreira (7527369 in chips)
Seat 4: hichnick777 (6146780 in chips)
Seat 5: kasper744 (6315190 in chips)
Seat 6: maxsi10 (14713280 in chips)
Seat 7: TeddyKGB027 (5718660 in chips)
Seat 8: casey1186 (20880012 in chips)
Seat 9: AYoshiK (15016322 in chips)
youdri15: posts the ante 25000
4time2warp0: posts the ante 25000
AtilaMoreira: posts the ante 25000
hichnick777: posts the ante 25000
kasper744: posts the ante 25000
maxsi10: posts the ante 25000
TeddyKGB027: posts the ante 25000
casey1186: posts the ante 25000
AYoshiK: posts the ante 25000
4time2warp0: posts small blind 125000
AtilaMoreira: posts big blind 250000
*** HOLE CARDS ***
Dealt to hichnick777 [4s 6h]
hichnick777: folds
kasper744: folds
maxsi10: folds
TeddyKGB027: folds
casey1186: folds
AYoshiK: folds
youdri15: raises 500000 to 750000
4time2warp0: folds
AtilaMoreira: folds
Uncalled bet (500000) returned to youdri15
youdri15 collected 850000 from pot
youdri15: doesn't show hand
kasper744 said, "glgl"
*** SUMMARY ***
Total pot 850000 | Rake 0
Seat 1: youdri15 (button) collected (850000)
Seat 2: 4time2warp0 (small blind) folded before Flop
Seat 3: AtilaMoreira (big blind) folded before Flop
Seat 4: hichnick777 folded before Flop (didn't bet)
Seat 5: kasper744 folded before Flop (didn't bet)
Seat 6: maxsi10 folded before Flop (didn't bet)
Seat 7: TeddyKGB027 folded before Flop (didn't bet)
Seat 8: casey1186 folded before Flop (didn't bet)
Seat 9: AYoshiK folded before Flop (didn't bet)


*********** # 468 **************
PokerStars Hand #176681828316: Tournament #2054568934, $20+$2 USD Hold'em No Limit - Level XLV (125000/250000) - 2017/10/09 8:07:42 MSK [2017/10/09 1:07:42 ET]
Table '2054568934 624' 9-max Seat #2 is the button
Seat 1: youdri15 (6554401 in chips)
Seat 2: 4time2warp0 (8282986 in chips)
Seat 3: AtilaMoreira (7252369 in chips)
Seat 4: hichnick777 (6121780 in chips)
Seat 5: kasper744 (6290190 in chips)
Seat 6: maxsi10 (14688280 in chips)
Seat 7: TeddyKGB027 (5693660 in chips)
Seat 8: casey1186 (20855012 in chips)
Seat 9: AYoshiK (14991322 in chips)
youdri15: posts the ante 25000
4time2warp0: posts the ante 25000
AtilaMoreira: posts the ante 25000
hichnick777: posts the ante 25000
kasper744: posts the ante 25000
maxsi10: posts the ante 25000
TeddyKGB027: posts the ante 25000
casey1186: posts the ante 25000
AYoshiK: posts the ante 25000
AtilaMoreira: posts small blind 125000
hichnick777: posts big blind 250000
*** HOLE CARDS ***
Dealt to hichnick777 [9s 2d]
kasper744: folds
maxsi10: folds
TeddyKGB027: folds
casey1186: folds
AYoshiK: folds
youdri15: folds
4time2warp0: folds
casey1186 said, "gl all"
AtilaMoreira: raises 500000 to 750000
AYoshiK said, "glgl"
hichnick777: folds
Uncalled bet (500000) returned to AtilaMoreira
AtilaMoreira collected 725000 from pot
*** SUMMARY ***
Total pot 725000 | Rake 0
Seat 1: youdri15 folded before Flop (didn't bet)
Seat 2: 4time2warp0 (button) folded before Flop (didn't bet)
Seat 3: AtilaMoreira (small blind) collected (725000)
Seat 4: hichnick777 (big blind) folded before Flop
Seat 5: kasper744 folded before Flop (didn't bet)
Seat 6: maxsi10 folded before Flop (didn't bet)
Seat 7: TeddyKGB027 folded before Flop (didn't bet)
Seat 8: casey1186 folded before Flop (didn't bet)
Seat 9: AYoshiK folded before Flop (didn't bet)


*********** # 469 **************
PokerStars Hand #176681834058: Tournament #2054568934, $20+$2 USD Hold'em No Limit - Level XLV (125000/250000) - 2017/10/09 8:08:08 MSK [2017/10/09 1:08:08 ET]
Table '2054568934 624' 9-max Seat #3 is the button
Seat 1: youdri15 (6529401 in chips)
Seat 2: 4time2warp0 (8257986 in chips)
Seat 3: AtilaMoreira (7702369 in chips)
Seat 4: hichnick777 (5846780 in chips)
Seat 5: kasper744 (6265190 in chips)
Seat 6: maxsi10 (14663280 in chips)
Seat 7: TeddyKGB027 (5668660 in chips)
Seat 8: casey1186 (20830012 in chips)
Seat 9: AYoshiK (14966322 in chips)
youdri15: posts the ante 25000
4time2warp0: posts the ante 25000
AtilaMoreira: posts the ante 25000
hichnick777: posts the ante 25000
kasper744: posts the ante 25000
maxsi10: posts the ante 25000
TeddyKGB027: posts the ante 25000
casey1186: posts the ante 25000
AYoshiK: posts the ante 25000
hichnick777: posts small blind 125000
kasper744: posts big blind 250000
*** HOLE CARDS ***
Dealt to hichnick777 [Jd 6d]
maxsi10: folds
TeddyKGB027: folds
casey1186: folds
AYoshiK: folds
youdri15: folds
4time2warp0: folds
AtilaMoreira: raises 250000 to 500000
hichnick777: folds
kasper744: calls 250000
*** FLOP *** [Qh Ts 7d]
kasper744: checks
AtilaMoreira: bets 445500
kasper744: calls 445500
*** TURN *** [Qh Ts 7d] [Kc]
kasper744: checks
AtilaMoreira: bets 1300000
kasper744: calls 1300000
*** RIVER *** [Qh Ts 7d Kc] [9d]
kasper744: checks
AtilaMoreira: checks
*** SHOW DOWN ***
kasper744: shows [Qd Tc] (two pair, Queens and Tens)
AtilaMoreira: mucks hand
kasper744 collected 4841000 from pot
*** SUMMARY ***
Total pot 4841000 | Rake 0
Board [Qh Ts 7d Kc 9d]
Seat 1: youdri15 folded before Flop (didn't bet)
Seat 2: 4time2warp0 folded before Flop (didn't bet)
Seat 3: AtilaMoreira (button) mucked [5d 5s]
Seat 4: hichnick777 (small blind) folded before Flop
Seat 5: kasper744 (big blind) showed [Qd Tc] and won (4841000) with two pair, Queens and Tens
Seat 6: maxsi10 folded before Flop (didn't bet)
Seat 7: TeddyKGB027 folded before Flop (didn't bet)
Seat 8: casey1186 folded before Flop (didn't bet)
Seat 9: AYoshiK folded before Flop (didn't bet)


*********** # 470 **************
PokerStars Hand #176681863974: Tournament #2054568934, $20+$2 USD Hold'em No Limit - Level XLVI (150000/300000) - 2017/10/09 8:10:24 MSK [2017/10/09 1:10:24 ET]
Table '2054568934 624' 9-max Seat #4 is the button
Seat 1: youdri15 (6504401 in chips)
Seat 2: 4time2warp0 (8232986 in chips)
Seat 3: AtilaMoreira (5431869 in chips)
Seat 4: hichnick777 (5696780 in chips)
Seat 5: kasper744 (8835690 in chips)
Seat 6: maxsi10 (14638280 in chips)
Seat 7: TeddyKGB027 (5643660 in chips)
Seat 8: casey1186 (20805012 in chips)
Seat 9: AYoshiK (14941322 in chips)
youdri15: posts the ante 30000
4time2warp0: posts the ante 30000
AtilaMoreira: posts the ante 30000
hichnick777: posts the ante 30000
kasper744: posts the ante 30000
maxsi10: posts the ante 30000
TeddyKGB027: posts the ante 30000
casey1186: posts the ante 30000
AYoshiK: posts the ante 30000
kasper744: posts small blind 150000
maxsi10: posts big blind 300000
*** HOLE CARDS ***
Dealt to hichnick777 [Kh 3s]
TeddyKGB027: folds
casey1186: folds
AYoshiK: folds
youdri15: folds
4time2warp0: folds
AtilaMoreira: raises 300000 to 600000
hichnick777: folds
kasper744: folds
maxsi10: folds
Uncalled bet (300000) returned to AtilaMoreira
AtilaMoreira collected 1020000 from pot
AtilaMoreira: doesn't show hand
*** SUMMARY ***
Total pot 1020000 | Rake 0
Seat 1: youdri15 folded before Flop (didn't bet)
Seat 2: 4time2warp0 folded before Flop (didn't bet)
Seat 3: AtilaMoreira collected (1020000)
Seat 4: hichnick777 (button) folded before Flop (didn't bet)
Seat 5: kasper744 (small blind) folded before Flop
Seat 6: maxsi10 (big blind) folded before Flop
Seat 7: TeddyKGB027 folded before Flop (didn't bet)
Seat 8: casey1186 folded before Flop (didn't bet)
Seat 9: AYoshiK folded before Flop (didn't bet)


*********** # 471 **************
PokerStars Hand #176681875334: Tournament #2054568934, $20+$2 USD Hold'em No Limit - Level XLVI (150000/300000) - 2017/10/09 8:10:51 MSK [2017/10/09 1:10:51 ET]
Table '2054568934 624' 9-max Seat #5 is the button
Seat 1: youdri15 (6474401 in chips)
Seat 2: 4time2warp0 (8202986 in chips)
Seat 3: AtilaMoreira (6121869 in chips)
Seat 4: hichnick777 (5666780 in chips)
Seat 5: kasper744 (8655690 in chips)
Seat 6: maxsi10 (14308280 in chips)
Seat 7: TeddyKGB027 (5613660 in chips)
Seat 8: casey1186 (20775012 in chips)
Seat 9: AYoshiK (14911322 in chips)
youdri15: posts the ante 30000
4time2warp0: posts the ante 30000
AtilaMoreira: posts the ante 30000
hichnick777: posts the ante 30000
kasper744: posts the ante 30000
maxsi10: posts the ante 30000
TeddyKGB027: posts the ante 30000
casey1186: posts the ante 30000
AYoshiK: posts the ante 30000
maxsi10: posts small blind 150000
TeddyKGB027: posts big blind 300000
*** HOLE CARDS ***
Dealt to hichnick777 [5h Jh]
casey1186: folds
AYoshiK: folds
youdri15: raises 450000 to 750000
4time2warp0: folds
AtilaMoreira: folds
hichnick777: folds
kasper744: folds
maxsi10: folds
TeddyKGB027: folds
Uncalled bet (450000) returned to youdri15
youdri15 collected 1020000 from pot
youdri15: doesn't show hand
*** SUMMARY ***
Total pot 1020000 | Rake 0
Seat 1: youdri15 collected (1020000)
Seat 2: 4time2warp0 folded before Flop (didn't bet)
Seat 3: AtilaMoreira folded before Flop (didn't bet)
Seat 4: hichnick777 folded before Flop (didn't bet)
Seat 5: kasper744 (button) folded before Flop (didn't bet)
Seat 6: maxsi10 (small blind) folded before Flop
Seat 7: TeddyKGB027 (big blind) folded before Flop
Seat 8: casey1186 folded before Flop (didn't bet)
Seat 9: AYoshiK folded before Flop (didn't bet)


*********** # 472 **************
PokerStars Hand #176681881831: Tournament #2054568934, $20+$2 USD Hold'em No Limit - Level XLVI (150000/300000) - 2017/10/09 8:11:21 MSK [2017/10/09 1:11:21 ET]
Table '2054568934 624' 9-max Seat #6 is the button
Seat 1: youdri15 (7164401 in chips)
Seat 2: 4time2warp0 (8172986 in chips)
Seat 3: AtilaMoreira (6091869 in chips)
Seat 4: hichnick777 (5636780 in chips)
Seat 5: kasper744 (8625690 in chips)
Seat 6: maxsi10 (14128280 in chips)
Seat 7: TeddyKGB027 (5283660 in chips)
Seat 8: casey1186 (20745012 in chips)
Seat 9: AYoshiK (14881322 in chips)
youdri15: posts the ante 30000
4time2warp0: posts the ante 30000
AtilaMoreira: posts the ante 30000
hichnick777: posts the ante 30000
kasper744: posts the ante 30000
maxsi10: posts the ante 30000
TeddyKGB027: posts the ante 30000
casey1186: posts the ante 30000
AYoshiK: posts the ante 30000
TeddyKGB027: posts small blind 150000
casey1186: posts big blind 300000
*** HOLE CARDS ***
Dealt to hichnick777 [6d Ad]
AYoshiK: folds
youdri15: folds
4time2warp0: folds
AtilaMoreira: folds
hichnick777: raises 324000 to 624000
kasper744: calls 624000
maxsi10: folds
TeddyKGB027: raises 4629660 to 5253660 and is all-in
casey1186: calls 4953660
hichnick777: folds
kasper744: raises 3342030 to 8595690 and is all-in
casey1186: calls 3342030
*** FLOP *** [Kd Jd Qh]
*** TURN *** [Kd Jd Qh] [3h]
*** RIVER *** [Kd Jd Qh 3h] [Ts]
*** SHOW DOWN ***
casey1186: shows [Qd Ac] (a straight, Ten to Ace)
kasper744: shows [Ah As] (a straight, Ten to Ace)
casey1186 collected 3342030 from side pot
kasper744 collected 3342030 from side pot
TeddyKGB027: shows [8s 8h] (a pair of Eights)
casey1186 collected 8327490 from main pot
kasper744 collected 8327490 from main pot
TeddyKGB027 finished the tournament in 9th place and received $1137.35.
*** SUMMARY ***
Total pot 23339040 Main pot 16654980. Side pot 6684060. | Rake 0
Board [Kd Jd Qh 3h Ts]
Seat 1: youdri15 folded before Flop (didn't bet)
Seat 2: 4time2warp0 folded before Flop (didn't bet)
Seat 3: AtilaMoreira folded before Flop (didn't bet)
Seat 4: hichnick777 folded before Flop
Seat 5: kasper744 showed [Ah As] and won (11669520) with a straight, Ten to Ace
Seat 6: maxsi10 (button) folded before Flop (didn't bet)
Seat 7: TeddyKGB027 (small blind) showed [8s 8h] and lost with a pair of Eights
Seat 8: casey1186 (big blind) showed [Qd Ac] and won (11669520) with a straight, Ten to Ace
Seat 9: AYoshiK folded before Flop (didn't bet)


*********** # 473 **************
PokerStars Hand #176681906104: Tournament #2054568934, $20+$2 USD Hold'em No Limit - Level XLVI (150000/300000) - 2017/10/09 8:13:11 MSK [2017/10/09 1:13:11 ET]
Table '2054568934 624' 9-max Seat #8 is the button
Seat 1: youdri15 (7134401 in chips)
Seat 2: 4time2warp0 (8142986 in chips)
Seat 3: AtilaMoreira (6061869 in chips)
Seat 4: hichnick777 (4982780 in chips)
Seat 5: kasper744 (11669520 in chips)
Seat 6: maxsi10 (14098280 in chips)
Seat 8: casey1186 (23788842 in chips)
Seat 9: AYoshiK (14851322 in chips)
youdri15: posts the ante 30000
4time2warp0: posts the ante 30000
AtilaMoreira: posts the ante 30000
hichnick777: posts the ante 30000
kasper744: posts the ante 30000
maxsi10: posts the ante 30000
casey1186: posts the ante 30000
AYoshiK: posts the ante 30000
AYoshiK: posts small blind 150000
youdri15: posts big blind 300000
*** HOLE CARDS ***
Dealt to hichnick777 [Ks Ad]
4time2warp0: folds
AtilaMoreira: folds
hichnick777: raises 324000 to 624000
kasper744: folds
maxsi10: folds
casey1186: folds
AYoshiK: folds
youdri15: folds
Uncalled bet (324000) returned to hichnick777
hichnick777 collected 990000 from pot
hichnick777: doesn't show hand
*** SUMMARY ***
Total pot 990000 | Rake 0
Seat 1: youdri15 (big blind) folded before Flop
Seat 2: 4time2warp0 folded before Flop (didn't bet)
Seat 3: AtilaMoreira folded before Flop (didn't bet)
Seat 4: hichnick777 collected (990000)
Seat 5: kasper744 folded before Flop (didn't bet)
Seat 6: maxsi10 folded before Flop (didn't bet)
Seat 8: casey1186 (button) folded before Flop (didn't bet)
Seat 9: AYoshiK (small blind) folded before Flop


*********** # 474 **************
PokerStars Hand #176681913493: Tournament #2054568934, $20+$2 USD Hold'em No Limit - Level XLVI (150000/300000) - 2017/10/09 8:13:44 MSK [2017/10/09 1:13:44 ET]
Table '2054568934 624' 9-max Seat #9 is the button
Seat 1: youdri15 (6804401 in chips)
Seat 2: 4time2warp0 (8112986 in chips)
Seat 3: AtilaMoreira (6031869 in chips)
Seat 4: hichnick777 (5642780 in chips)
Seat 5: kasper744 (11639520 in chips)
Seat 6: maxsi10 (14068280 in chips)
Seat 8: casey1186 (23758842 in chips)
Seat 9: AYoshiK (14671322 in chips)
youdri15: posts the ante 30000
4time2warp0: posts the ante 30000
AtilaMoreira: posts the ante 30000
hichnick777: posts the ante 30000
kasper744: posts the ante 30000
maxsi10: posts the ante 30000
casey1186: posts the ante 30000
AYoshiK: posts the ante 30000
youdri15: posts small blind 150000
4time2warp0: posts big blind 300000
*** HOLE CARDS ***
Dealt to hichnick777 [Jh 3s]
AtilaMoreira: folds
hichnick777: folds
kasper744: folds
maxsi10: folds
casey1186: folds
AYoshiK: folds
youdri15: raises 300000 to 600000
4time2warp0: raises 1200000 to 1800000
youdri15: folds
Uncalled bet (1200000) returned to 4time2warp0
4time2warp0 collected 1440000 from pot
4time2warp0: doesn't show hand
*** SUMMARY ***
Total pot 1440000 | Rake 0
Seat 1: youdri15 (small blind) folded before Flop
Seat 2: 4time2warp0 (big blind) collected (1440000)
Seat 3: AtilaMoreira folded before Flop (didn't bet)
Seat 4: hichnick777 folded before Flop (didn't bet)
Seat 5: kasper744 folded before Flop (didn't bet)
Seat 6: maxsi10 folded before Flop (didn't bet)
Seat 8: casey1186 folded before Flop (didn't bet)
Seat 9: AYoshiK (button) folded before Flop (didn't bet)


*********** # 475 **************
PokerStars Hand #176681921926: Tournament #2054568934, $20+$2 USD Hold'em No Limit - Level XLVI (150000/300000) - 2017/10/09 8:14:23 MSK [2017/10/09 1:14:23 ET]
Table '2054568934 624' 9-max Seat #1 is the button
Seat 1: youdri15 (6174401 in chips)
Seat 2: 4time2warp0 (8922986 in chips)
Seat 3: AtilaMoreira (6001869 in chips)
Seat 4: hichnick777 (5612780 in chips)
Seat 5: kasper744 (11609520 in chips)
Seat 6: maxsi10 (14038280 in chips)
Seat 8: casey1186 (23728842 in chips)
Seat 9: AYoshiK (14641322 in chips)
youdri15: posts the ante 30000
4time2warp0: posts the ante 30000
AtilaMoreira: posts the ante 30000
hichnick777: posts the ante 30000
kasper744: posts the ante 30000
maxsi10: posts the ante 30000
casey1186: posts the ante 30000
AYoshiK: posts the ante 30000
4time2warp0: posts small blind 150000
AtilaMoreira: posts big blind 300000
*** HOLE CARDS ***
Dealt to hichnick777 [Qd 2s]
hichnick777: folds
kasper744: folds
maxsi10: folds
casey1186: raises 600000 to 900000
AYoshiK: folds
youdri15: folds
4time2warp0: folds
AtilaMoreira: folds
Uncalled bet (600000) returned to casey1186
casey1186 collected 990000 from pot
casey1186: doesn't show hand
*** SUMMARY ***
Total pot 990000 | Rake 0
Seat 1: youdri15 (button) folded before Flop (didn't bet)
Seat 2: 4time2warp0 (small blind) folded before Flop
Seat 3: AtilaMoreira (big blind) folded before Flop
Seat 4: hichnick777 folded before Flop (didn't bet)
Seat 5: kasper744 folded before Flop (didn't bet)
Seat 6: maxsi10 folded before Flop (didn't bet)
Seat 8: casey1186 collected (990000)
Seat 9: AYoshiK folded before Flop (didn't bet)


*********** # 476 **************
PokerStars Hand #176681926697: Tournament #2054568934, $20+$2 USD Hold'em No Limit - Level XLVI (150000/300000) - 2017/10/09 8:14:44 MSK [2017/10/09 1:14:44 ET]
Table '2054568934 624' 9-max Seat #2 is the button
Seat 1: youdri15 (6144401 in chips)
Seat 2: 4time2warp0 (8742986 in chips)
Seat 3: AtilaMoreira (5671869 in chips)
Seat 4: hichnick777 (5582780 in chips)
Seat 5: kasper744 (11579520 in chips)
Seat 6: maxsi10 (14008280 in chips)
Seat 8: casey1186 (24388842 in chips)
Seat 9: AYoshiK (14611322 in chips)
youdri15: posts the ante 30000
4time2warp0: posts the ante 30000
AtilaMoreira: posts the ante 30000
hichnick777: posts the ante 30000
kasper744: posts the ante 30000
maxsi10: posts the ante 30000
casey1186: posts the ante 30000
AYoshiK: posts the ante 30000
AtilaMoreira: posts small blind 150000
hichnick777: posts big blind 300000
*** HOLE CARDS ***
Dealt to hichnick777 [5c 7s]
kasper744: folds
maxsi10: folds
casey1186: raises 600000 to 900000
AYoshiK: folds
youdri15: folds
4time2warp0: raises 1200000 to 2100000
AtilaMoreira: folds
hichnick777: folds
casey1186: folds
Uncalled bet (1200000) returned to 4time2warp0
4time2warp0 collected 2490000 from pot
4time2warp0: doesn't show hand
*** SUMMARY ***
Total pot 2490000 | Rake 0
Seat 1: youdri15 folded before Flop (didn't bet)
Seat 2: 4time2warp0 (button) collected (2490000)
Seat 3: AtilaMoreira (small blind) folded before Flop
Seat 4: hichnick777 (big blind) folded before Flop
Seat 5: kasper744 folded before Flop (didn't bet)
Seat 6: maxsi10 folded before Flop (didn't bet)
Seat 8: casey1186 folded before Flop
Seat 9: AYoshiK folded before Flop (didn't bet)


*********** # 477 **************
PokerStars Hand #176681933668: Tournament #2054568934, $20+$2 USD Hold'em No Limit - Level XLVI (150000/300000) - 2017/10/09 8:15:16 MSK [2017/10/09 1:15:16 ET]
Table '2054568934 624' 9-max Seat #3 is the button
Seat 1: youdri15 (6114401 in chips)
Seat 2: 4time2warp0 (10302986 in chips)
Seat 3: AtilaMoreira (5491869 in chips)
Seat 4: hichnick777 (5252780 in chips)
Seat 5: kasper744 (11549520 in chips)
Seat 6: maxsi10 (13978280 in chips)
Seat 8: casey1186 (23458842 in chips)
Seat 9: AYoshiK (14581322 in chips)
youdri15: posts the ante 30000
4time2warp0: posts the ante 30000
AtilaMoreira: posts the ante 30000
hichnick777: posts the ante 30000
kasper744: posts the ante 30000
maxsi10: posts the ante 30000
casey1186: posts the ante 30000
AYoshiK: posts the ante 30000
hichnick777: posts small blind 150000
kasper744: posts big blind 300000
*** HOLE CARDS ***
Dealt to hichnick777 [8s Qd]
maxsi10: raises 300000 to 600000
casey1186: folds
AYoshiK: folds
youdri15: folds
4time2warp0: folds
AtilaMoreira: raises 4861869 to 5461869 and is all-in
hichnick777: folds
kasper744: folds
maxsi10: folds
Uncalled bet (4861869) returned to AtilaMoreira
AtilaMoreira collected 1890000 from pot
*** SUMMARY ***
Total pot 1890000 | Rake 0
Seat 1: youdri15 folded before Flop (didn't bet)
Seat 2: 4time2warp0 folded before Flop (didn't bet)
Seat 3: AtilaMoreira (button) collected (1890000)
Seat 4: hichnick777 (small blind) folded before Flop
Seat 5: kasper744 (big blind) folded before Flop
Seat 6: maxsi10 folded before Flop
Seat 8: casey1186 folded before Flop (didn't bet)
Seat 9: AYoshiK folded before Flop (didn't bet)


*********** # 478 **************
PokerStars Hand #176681941238: Tournament #2054568934, $20+$2 USD Hold'em No Limit - Level XLVI (150000/300000) - 2017/10/09 8:15:50 MSK [2017/10/09 1:15:50 ET]
Table '2054568934 624' 9-max Seat #4 is the button
Seat 1: youdri15 (6084401 in chips)
Seat 2: 4time2warp0 (10272986 in chips)
Seat 3: AtilaMoreira (6751869 in chips)
Seat 4: hichnick777 (5072780 in chips)
Seat 5: kasper744 (11219520 in chips)
Seat 6: maxsi10 (13348280 in chips)
Seat 8: casey1186 (23428842 in chips)
Seat 9: AYoshiK (14551322 in chips)
youdri15: posts the ante 30000
4time2warp0: posts the ante 30000
AtilaMoreira: posts the ante 30000
hichnick777: posts the ante 30000
kasper744: posts the ante 30000
maxsi10: posts the ante 30000
casey1186: posts the ante 30000
AYoshiK: posts the ante 30000
kasper744: posts small blind 150000
maxsi10: posts big blind 300000
*** HOLE CARDS ***
Dealt to hichnick777 [7h As]
casey1186: folds
AYoshiK: folds
youdri15: raises 600000 to 900000
4time2warp0: folds
AtilaMoreira: folds
hichnick777: folds
kasper744: folds
maxsi10: folds
Uncalled bet (600000) returned to youdri15
youdri15 collected 990000 from pot
youdri15: doesn't show hand
*** SUMMARY ***
Total pot 990000 | Rake 0
Seat 1: youdri15 collected (990000)
Seat 2: 4time2warp0 folded before Flop (didn't bet)
Seat 3: AtilaMoreira folded before Flop (didn't bet)
Seat 4: hichnick777 (button) folded before Flop (didn't bet)
Seat 5: kasper744 (small blind) folded before Flop
Seat 6: maxsi10 (big blind) folded before Flop
Seat 8: casey1186 folded before Flop (didn't bet)
Seat 9: AYoshiK folded before Flop (didn't bet)


*********** # 479 **************
PokerStars Hand #176681947322: Tournament #2054568934, $20+$2 USD Hold'em No Limit - Level XLVI (150000/300000) - 2017/10/09 8:16:17 MSK [2017/10/09 1:16:17 ET]
Table '2054568934 624' 9-max Seat #5 is the button
Seat 1: youdri15 (6744401 in chips)
Seat 2: 4time2warp0 (10242986 in chips)
Seat 3: AtilaMoreira (6721869 in chips)
Seat 4: hichnick777 (5042780 in chips)
Seat 5: kasper744 (11039520 in chips)
Seat 6: maxsi10 (13018280 in chips)
Seat 8: casey1186 (23398842 in chips)
Seat 9: AYoshiK (14521322 in chips)
youdri15: posts the ante 30000
4time2warp0: posts the ante 30000
AtilaMoreira: posts the ante 30000
hichnick777: posts the ante 30000
kasper744: posts the ante 30000
maxsi10: posts the ante 30000
casey1186: posts the ante 30000
AYoshiK: posts the ante 30000
maxsi10: posts small blind 150000
casey1186: posts big blind 300000
*** HOLE CARDS ***
Dealt to hichnick777 [Qh Ac]
AYoshiK: folds
youdri15: folds
4time2warp0: folds
AtilaMoreira: folds
hichnick777: raises 324000 to 624000
kasper744: folds
maxsi10: folds
casey1186: folds
Uncalled bet (324000) returned to hichnick777
hichnick777 collected 990000 from pot
hichnick777: doesn't show hand
*** SUMMARY ***
Total pot 990000 | Rake 0
Seat 1: youdri15 folded before Flop (didn't bet)
Seat 2: 4time2warp0 folded before Flop (didn't bet)
Seat 3: AtilaMoreira folded before Flop (didn't bet)
Seat 4: hichnick777 collected (990000)
Seat 5: kasper744 (button) folded before Flop (didn't bet)
Seat 6: maxsi10 (small blind) folded before Flop
Seat 8: casey1186 (big blind) folded before Flop
Seat 9: AYoshiK folded before Flop (didn't bet)


*********** # 480 **************
PokerStars Hand #176681952921: Tournament #2054568934, $20+$2 USD Hold'em No Limit - Level XLVI (150000/300000) - 2017/10/09 8:16:42 MSK [2017/10/09 1:16:42 ET]
Table '2054568934 624' 9-max Seat #6 is the button
Seat 1: youdri15 (6714401 in chips)
Seat 2: 4time2warp0 (10212986 in chips)
Seat 3: AtilaMoreira (6691869 in chips)
Seat 4: hichnick777 (5702780 in chips)
Seat 5: kasper744 (11009520 in chips)
Seat 6: maxsi10 (12838280 in chips)
Seat 8: casey1186 (23068842 in chips)
Seat 9: AYoshiK (14491322 in chips)
youdri15: posts the ante 30000
4time2warp0: posts the ante 30000
AtilaMoreira: posts the ante 30000
hichnick777: posts the ante 30000
kasper744: posts the ante 30000
maxsi10: posts the ante 30000
casey1186: posts the ante 30000
AYoshiK: posts the ante 30000
casey1186: posts small blind 150000
AYoshiK: posts big blind 300000
*** HOLE CARDS ***
Dealt to hichnick777 [Ah 6h]
youdri15: raises 300000 to 600000
4time2warp0: folds
AtilaMoreira: folds
hichnick777: folds
kasper744: folds
maxsi10: folds
casey1186: folds
AYoshiK: calls 300000
*** FLOP *** [Kd 6s 4c]
AYoshiK: checks
youdri15: bets 900000
AYoshiK: folds
Uncalled bet (900000) returned to youdri15
youdri15 collected 1590000 from pot
youdri15: doesn't show hand
*** SUMMARY ***
Total pot 1590000 | Rake 0
Board [Kd 6s 4c]
Seat 1: youdri15 collected (1590000)
Seat 2: 4time2warp0 folded before Flop (didn't bet)
Seat 3: AtilaMoreira folded before Flop (didn't bet)
Seat 4: hichnick777 folded before Flop (didn't bet)
Seat 5: kasper744 folded before Flop (didn't bet)
Seat 6: maxsi10 (button) folded before Flop (didn't bet)
Seat 8: casey1186 (small blind) folded before Flop
Seat 9: AYoshiK (big blind) folded on the Flop


*********** # 481 **************
PokerStars Hand #176681969881: Tournament #2054568934, $20+$2 USD Hold'em No Limit - Level XLVI (150000/300000) - 2017/10/09 8:17:58 MSK [2017/10/09 1:17:58 ET]
Table '2054568934 624' 9-max Seat #8 is the button
Seat 1: youdri15 (7674401 in chips)
Seat 2: 4time2warp0 (10182986 in chips)
Seat 3: AtilaMoreira (6661869 in chips)
Seat 4: hichnick777 (5672780 in chips)
Seat 5: kasper744 (10979520 in chips)
Seat 6: maxsi10 (12808280 in chips)
Seat 8: casey1186 (22888842 in chips)
Seat 9: AYoshiK (13861322 in chips)
youdri15: posts the ante 30000
4time2warp0: posts the ante 30000
AtilaMoreira: posts the ante 30000
hichnick777: posts the ante 30000
kasper744: posts the ante 30000
maxsi10: posts the ante 30000
casey1186: posts the ante 30000
AYoshiK: posts the ante 30000
AYoshiK: posts small blind 150000
youdri15: posts big blind 300000
*** HOLE CARDS ***
Dealt to hichnick777 [2s 4c]
4time2warp0: folds
AtilaMoreira: raises 300000 to 600000
hichnick777: folds
kasper744: folds
maxsi10: folds
casey1186: folds
AYoshiK: folds
youdri15: folds
Uncalled bet (300000) returned to AtilaMoreira
AtilaMoreira collected 990000 from pot
*** SUMMARY ***
Total pot 990000 | Rake 0
Seat 1: youdri15 (big blind) folded before Flop
Seat 2: 4time2warp0 folded before Flop (didn't bet)
Seat 3: AtilaMoreira collected (990000)
Seat 4: hichnick777 folded before Flop (didn't bet)
Seat 5: kasper744 folded before Flop (didn't bet)
Seat 6: maxsi10 folded before Flop (didn't bet)
Seat 8: casey1186 (button) folded before Flop (didn't bet)
Seat 9: AYoshiK (small blind) folded before Flop


*********** # 482 **************
PokerStars Hand #176681976851: Tournament #2054568934, $20+$2 USD Hold'em No Limit - Level XLVI (150000/300000) - 2017/10/09 8:18:30 MSK [2017/10/09 1:18:30 ET]
Table '2054568934 624' 9-max Seat #9 is the button
Seat 1: youdri15 (7344401 in chips)
Seat 2: 4time2warp0 (10152986 in chips)
Seat 3: AtilaMoreira (7321869 in chips)
Seat 4: hichnick777 (5642780 in chips)
Seat 5: kasper744 (10949520 in chips)
Seat 6: maxsi10 (12778280 in chips)
Seat 8: casey1186 (22858842 in chips)
Seat 9: AYoshiK (13681322 in chips)
youdri15: posts the ante 30000
4time2warp0: posts the ante 30000
AtilaMoreira: posts the ante 30000
hichnick777: posts the ante 30000
kasper744: posts the ante 30000
maxsi10: posts the ante 30000
casey1186: posts the ante 30000
AYoshiK: posts the ante 30000
youdri15: posts small blind 150000
4time2warp0: posts big blind 300000
*** HOLE CARDS ***
Dealt to hichnick777 [8c 9s]
AtilaMoreira: folds
hichnick777: folds
kasper744: folds
maxsi10: folds
casey1186: raises 600000 to 900000
AYoshiK: folds
youdri15: folds
4time2warp0: folds
Uncalled bet (600000) returned to casey1186
casey1186 collected 990000 from pot
casey1186: doesn't show hand
*** SUMMARY ***
Total pot 990000 | Rake 0
Seat 1: youdri15 (small blind) folded before Flop
Seat 2: 4time2warp0 (big blind) folded before Flop
Seat 3: AtilaMoreira folded before Flop (didn't bet)
Seat 4: hichnick777 folded before Flop (didn't bet)
Seat 5: kasper744 folded before Flop (didn't bet)
Seat 6: maxsi10 folded before Flop (didn't bet)
Seat 8: casey1186 collected (990000)
Seat 9: AYoshiK (button) folded before Flop (didn't bet)


*********** # 483 **************
PokerStars Hand #176681981343: Tournament #2054568934, $20+$2 USD Hold'em No Limit - Level XLVI (150000/300000) - 2017/10/09 8:18:50 MSK [2017/10/09 1:18:50 ET]
Table '2054568934 624' 9-max Seat #1 is the button
Seat 1: youdri15 (7164401 in chips)
Seat 2: 4time2warp0 (9822986 in chips)
Seat 3: AtilaMoreira (7291869 in chips)
Seat 4: hichnick777 (5612780 in chips)
Seat 5: kasper744 (10919520 in chips)
Seat 6: maxsi10 (12748280 in chips)
Seat 8: casey1186 (23518842 in chips)
Seat 9: AYoshiK (13651322 in chips)
youdri15: posts the ante 30000
4time2warp0: posts the ante 30000
AtilaMoreira: posts the ante 30000
hichnick777: posts the ante 30000
kasper744: posts the ante 30000
maxsi10: posts the ante 30000
casey1186: posts the ante 30000
AYoshiK: posts the ante 30000
4time2warp0: posts small blind 150000
AtilaMoreira: posts big blind 300000
*** HOLE CARDS ***
Dealt to hichnick777 [Kd 9h]
hichnick777: folds
kasper744: folds
maxsi10: folds
casey1186: folds
AYoshiK: folds
youdri15: raises 600000 to 900000
4time2warp0: folds
AtilaMoreira: folds
Uncalled bet (600000) returned to youdri15
youdri15 collected 990000 from pot
youdri15: doesn't show hand
*** SUMMARY ***
Total pot 990000 | Rake 0
Seat 1: youdri15 (button) collected (990000)
Seat 2: 4time2warp0 (small blind) folded before Flop
Seat 3: AtilaMoreira (big blind) folded before Flop
Seat 4: hichnick777 folded before Flop (didn't bet)
Seat 5: kasper744 folded before Flop (didn't bet)
Seat 6: maxsi10 folded before Flop (didn't bet)
Seat 8: casey1186 folded before Flop (didn't bet)
Seat 9: AYoshiK folded before Flop (didn't bet)


*********** # 484 **************
PokerStars Hand #176681985546: Tournament #2054568934, $20+$2 USD Hold'em No Limit - Level XLVI (150000/300000) - 2017/10/09 8:19:09 MSK [2017/10/09 1:19:09 ET]
Table '2054568934 624' 9-max Seat #2 is the button
Seat 1: youdri15 (7824401 in chips)
Seat 2: 4time2warp0 (9642986 in chips)
Seat 3: AtilaMoreira (6961869 in chips)
Seat 4: hichnick777 (5582780 in chips)
Seat 5: kasper744 (10889520 in chips)
Seat 6: maxsi10 (12718280 in chips)
Seat 8: casey1186 (23488842 in chips)
Seat 9: AYoshiK (13621322 in chips)
youdri15: posts the ante 30000
4time2warp0: posts the ante 30000
AtilaMoreira: posts the ante 30000
hichnick777: posts the ante 30000
kasper744: posts the ante 30000
maxsi10: posts the ante 30000
casey1186: posts the ante 30000
AYoshiK: posts the ante 30000
AtilaMoreira: posts small blind 150000
hichnick777: posts big blind 300000
*** HOLE CARDS ***
Dealt to hichnick777 [3c Ah]
kasper744: folds
maxsi10: folds
casey1186: folds
AYoshiK: raises 318000 to 618000
youdri15: folds
4time2warp0: folds
AtilaMoreira: folds
hichnick777: calls 318000
*** FLOP *** [Jd Td 2s]
hichnick777: checks
AYoshiK: bets 715440
hichnick777: folds
Uncalled bet (715440) returned to AYoshiK
AYoshiK collected 1626000 from pot
AYoshiK: doesn't show hand
*** SUMMARY ***
Total pot 1626000 | Rake 0
Board [Jd Td 2s]
Seat 1: youdri15 folded before Flop (didn't bet)
Seat 2: 4time2warp0 (button) folded before Flop (didn't bet)
Seat 3: AtilaMoreira (small blind) folded before Flop
Seat 4: hichnick777 (big blind) folded on the Flop
Seat 5: kasper744 folded before Flop (didn't bet)
Seat 6: maxsi10 folded before Flop (didn't bet)
Seat 8: casey1186 folded before Flop (didn't bet)
Seat 9: AYoshiK collected (1626000)


*********** # 485 **************
PokerStars Hand #176681999116: Tournament #2054568934, $20+$2 USD Hold'em No Limit - Level XLVI (150000/300000) - 2017/10/09 8:20:11 MSK [2017/10/09 1:20:11 ET]
Table '2054568934 624' 9-max Seat #3 is the button
Seat 1: youdri15 (7794401 in chips)
Seat 2: 4time2warp0 (9612986 in chips)
Seat 3: AtilaMoreira (6781869 in chips)
Seat 4: hichnick777 (4934780 in chips)
Seat 5: kasper744 (10859520 in chips)
Seat 6: maxsi10 (12688280 in chips)
Seat 8: casey1186 (23458842 in chips)
Seat 9: AYoshiK (14599322 in chips)
youdri15: posts the ante 30000
4time2warp0: posts the ante 30000
AtilaMoreira: posts the ante 30000
hichnick777: posts the ante 30000
kasper744: posts the ante 30000
maxsi10: posts the ante 30000
casey1186: posts the ante 30000
AYoshiK: posts the ante 30000
hichnick777: posts small blind 150000
kasper744: posts big blind 300000
*** HOLE CARDS ***
Dealt to hichnick777 [3s 7s]
maxsi10: folds
casey1186: folds
AYoshiK: raises 318000 to 618000
youdri15: folds
4time2warp0: folds
AtilaMoreira: folds
hichnick777: folds
kasper744: folds
Uncalled bet (318000) returned to AYoshiK
AYoshiK collected 990000 from pot
AYoshiK: doesn't show hand
*** SUMMARY ***
Total pot 990000 | Rake 0
Seat 1: youdri15 folded before Flop (didn't bet)
Seat 2: 4time2warp0 folded before Flop (didn't bet)
Seat 3: AtilaMoreira (button) folded before Flop (didn't bet)
Seat 4: hichnick777 (small blind) folded before Flop
Seat 5: kasper744 (big blind) folded before Flop
Seat 6: maxsi10 folded before Flop (didn't bet)
Seat 8: casey1186 folded before Flop (didn't bet)
Seat 9: AYoshiK collected (990000)


*********** # 486 **************
PokerStars Hand #176682005225: Tournament #2054568934, $20+$2 USD Hold'em No Limit - Level XLVI (150000/300000) - 2017/10/09 8:20:40 MSK [2017/10/09 1:20:40 ET]
Table '2054568934 624' 9-max Seat #4 is the button
Seat 1: youdri15 (7764401 in chips)
Seat 2: 4time2warp0 (9582986 in chips)
Seat 3: AtilaMoreira (6751869 in chips)
Seat 4: hichnick777 (4754780 in chips)
Seat 5: kasper744 (10529520 in chips)
Seat 6: maxsi10 (12658280 in chips)
Seat 8: casey1186 (23428842 in chips)
Seat 9: AYoshiK (15259322 in chips)
youdri15: posts the ante 30000
4time2warp0: posts the ante 30000
AtilaMoreira: posts the ante 30000
hichnick777: posts the ante 30000
kasper744: posts the ante 30000
maxsi10: posts the ante 30000
casey1186: posts the ante 30000
AYoshiK: posts the ante 30000
kasper744: posts small blind 150000
maxsi10: posts big blind 300000
*** HOLE CARDS ***
Dealt to hichnick777 [2s Jd]
casey1186: folds
AYoshiK: folds
youdri15: folds
4time2warp0: folds
AtilaMoreira: folds
hichnick777: folds
kasper744: folds
Uncalled bet (150000) returned to maxsi10
maxsi10 collected 540000 from pot
*** SUMMARY ***
Total pot 540000 | Rake 0
Seat 1: youdri15 folded before Flop (didn't bet)
Seat 2: 4time2warp0 folded before Flop (didn't bet)
Seat 3: AtilaMoreira folded before Flop (didn't bet)
Seat 4: hichnick777 (button) folded before Flop (didn't bet)
Seat 5: kasper744 (small blind) folded before Flop
Seat 6: maxsi10 (big blind) collected (540000)
Seat 8: casey1186 folded before Flop (didn't bet)
Seat 9: AYoshiK folded before Flop (didn't bet)


*********** # 487 **************
PokerStars Hand #176682009020: Tournament #2054568934, $20+$2 USD Hold'em No Limit - Level XLVI (150000/300000) - 2017/10/09 8:20:57 MSK [2017/10/09 1:20:57 ET]
Table '2054568934 624' 9-max Seat #5 is the button
Seat 1: youdri15 (7734401 in chips)
Seat 2: 4time2warp0 (9552986 in chips)
Seat 3: AtilaMoreira (6721869 in chips)
Seat 4: hichnick777 (4724780 in chips)
Seat 5: kasper744 (10349520 in chips)
Seat 6: maxsi10 (13018280 in chips)
Seat 8: casey1186 (23398842 in chips)
Seat 9: AYoshiK (15229322 in chips)
youdri15: posts the ante 30000
4time2warp0: posts the ante 30000
AtilaMoreira: posts the ante 30000
hichnick777: posts the ante 30000
kasper744: posts the ante 30000
maxsi10: posts the ante 30000
casey1186: posts the ante 30000
AYoshiK: posts the ante 30000
maxsi10: posts small blind 150000
casey1186: posts big blind 300000
*** HOLE CARDS ***
Dealt to hichnick777 [Jc 2s]
AYoshiK: folds
youdri15: folds
4time2warp0: folds
AtilaMoreira: folds
hichnick777: folds
kasper744: folds
maxsi10: calls 150000
casey1186: checks
*** FLOP *** [8c 3s 8h]
maxsi10: bets 554400
casey1186: folds
Uncalled bet (554400) returned to maxsi10
maxsi10 collected 840000 from pot
*** SUMMARY ***
Total pot 840000 | Rake 0
Board [8c 3s 8h]
Seat 1: youdri15 folded before Flop (didn't bet)
Seat 2: 4time2warp0 folded before Flop (didn't bet)
Seat 3: AtilaMoreira folded before Flop (didn't bet)
Seat 4: hichnick777 folded before Flop (didn't bet)
Seat 5: kasper744 (button) folded before Flop (didn't bet)
Seat 6: maxsi10 (small blind) collected (840000)
Seat 8: casey1186 (big blind) folded on the Flop
Seat 9: AYoshiK folded before Flop (didn't bet)


*********** # 488 **************
PokerStars Hand #176682016818: Tournament #2054568934, $20+$2 USD Hold'em No Limit - Level XLVII (175000/350000) - 2017/10/09 8:21:33 MSK [2017/10/09 1:21:33 ET]
Table '2054568934 624' 9-max Seat #6 is the button
Seat 1: youdri15 (7704401 in chips)
Seat 2: 4time2warp0 (9522986 in chips)
Seat 3: AtilaMoreira (6691869 in chips)
Seat 4: hichnick777 (4694780 in chips)
Seat 5: kasper744 (10319520 in chips)
Seat 6: maxsi10 (13528280 in chips)
Seat 8: casey1186 (23068842 in chips)
Seat 9: AYoshiK (15199322 in chips)
youdri15: posts the ante 35000
4time2warp0: posts the ante 35000
AtilaMoreira: posts the ante 35000
hichnick777: posts the ante 35000
kasper744: posts the ante 35000
maxsi10: posts the ante 35000
casey1186: posts the ante 35000
AYoshiK: posts the ante 35000
casey1186: posts small blind 175000
AYoshiK: posts big blind 350000
*** HOLE CARDS ***
Dealt to hichnick777 [4c 3d]
youdri15: folds
4time2warp0: folds
AtilaMoreira: folds
hichnick777: folds
kasper744: raises 381500 to 731500
maxsi10: folds
casey1186: folds
AYoshiK: folds
Uncalled bet (381500) returned to kasper744
kasper744 collected 1155000 from pot
kasper744: doesn't show hand
*** SUMMARY ***
Total pot 1155000 | Rake 0
Seat 1: youdri15 folded before Flop (didn't bet)
Seat 2: 4time2warp0 folded before Flop (didn't bet)
Seat 3: AtilaMoreira folded before Flop (didn't bet)
Seat 4: hichnick777 folded before Flop (didn't bet)
Seat 5: kasper744 collected (1155000)
Seat 6: maxsi10 (button) folded before Flop (didn't bet)
Seat 8: casey1186 (small blind) folded before Flop
Seat 9: AYoshiK (big blind) folded before Flop


*********** # 489 **************
PokerStars Hand #176682023211: Tournament #2054568934, $20+$2 USD Hold'em No Limit - Level XLVII (175000/350000) - 2017/10/09 8:22:03 MSK [2017/10/09 1:22:03 ET]
Table '2054568934 624' 9-max Seat #8 is the button
Seat 1: youdri15 (7669401 in chips)
Seat 2: 4time2warp0 (9487986 in chips)
Seat 3: AtilaMoreira (6656869 in chips)
Seat 4: hichnick777 (4659780 in chips)
Seat 5: kasper744 (11089520 in chips)
Seat 6: maxsi10 (13493280 in chips)
Seat 8: casey1186 (22858842 in chips)
Seat 9: AYoshiK (14814322 in chips)
youdri15: posts the ante 35000
4time2warp0: posts the ante 35000
AtilaMoreira: posts the ante 35000
hichnick777: posts the ante 35000
kasper744: posts the ante 35000
maxsi10: posts the ante 35000
casey1186: posts the ante 35000
AYoshiK: posts the ante 35000
AYoshiK: posts small blind 175000
youdri15: posts big blind 350000
*** HOLE CARDS ***
Dealt to hichnick777 [2d 9s]
4time2warp0: raises 350000 to 700000
AtilaMoreira: folds
hichnick777: folds
kasper744: folds
maxsi10: folds
casey1186: folds
AYoshiK: folds
youdri15: folds
Uncalled bet (350000) returned to 4time2warp0
4time2warp0 collected 1155000 from pot
4time2warp0: doesn't show hand
*** SUMMARY ***
Total pot 1155000 | Rake 0
Seat 1: youdri15 (big blind) folded before Flop
Seat 2: 4time2warp0 collected (1155000)
Seat 3: AtilaMoreira folded before Flop (didn't bet)
Seat 4: hichnick777 folded before Flop (didn't bet)
Seat 5: kasper744 folded before Flop (didn't bet)
Seat 6: maxsi10 folded before Flop (didn't bet)
Seat 8: casey1186 (button) folded before Flop (didn't bet)
Seat 9: AYoshiK (small blind) folded before Flop


*********** # 490 **************
PokerStars Hand #176682027155: Tournament #2054568934, $20+$2 USD Hold'em No Limit - Level XLVII (175000/350000) - 2017/10/09 8:22:21 MSK [2017/10/09 1:22:21 ET]
Table '2054568934 624' 9-max Seat #9 is the button
Seat 1: youdri15 (7284401 in chips)
Seat 2: 4time2warp0 (10257986 in chips)
Seat 3: AtilaMoreira (6621869 in chips)
Seat 4: hichnick777 (4624780 in chips)
Seat 5: kasper744 (11054520 in chips)
Seat 6: maxsi10 (13458280 in chips)
Seat 8: casey1186 (22823842 in chips)
Seat 9: AYoshiK (14604322 in chips)
youdri15: posts the ante 35000
4time2warp0: posts the ante 35000
AtilaMoreira: posts the ante 35000
hichnick777: posts the ante 35000
kasper744: posts the ante 35000
maxsi10: posts the ante 35000
casey1186: posts the ante 35000
AYoshiK: posts the ante 35000
youdri15: posts small blind 175000
4time2warp0: posts big blind 350000
*** HOLE CARDS ***
Dealt to hichnick777 [Ad 2d]
AtilaMoreira: folds
hichnick777: folds
kasper744: folds
maxsi10: raises 350000 to 700000
casey1186: folds
AYoshiK: raises 1215785 to 1915785
youdri15: folds
4time2warp0: folds
maxsi10: folds
Uncalled bet (1215785) returned to AYoshiK
AYoshiK collected 2205000 from pot
AYoshiK: doesn't show hand
*** SUMMARY ***
Total pot 2205000 | Rake 0
Seat 1: youdri15 (small blind) folded before Flop
Seat 2: 4time2warp0 (big blind) folded before Flop
Seat 3: AtilaMoreira folded before Flop (didn't bet)
Seat 4: hichnick777 folded before Flop (didn't bet)
Seat 5: kasper744 folded before Flop (didn't bet)
Seat 6: maxsi10 folded before Flop
Seat 8: casey1186 folded before Flop (didn't bet)
Seat 9: AYoshiK (button) collected (2205000)


*********** # 491 **************
PokerStars Hand #176682034778: Tournament #2054568934, $20+$2 USD Hold'em No Limit - Level XLVII (175000/350000) - 2017/10/09 8:22:56 MSK [2017/10/09 1:22:56 ET]
Table '2054568934 624' 9-max Seat #1 is the button
Seat 1: youdri15 (7074401 in chips)
Seat 2: 4time2warp0 (9872986 in chips)
Seat 3: AtilaMoreira (6586869 in chips)
Seat 4: hichnick777 (4589780 in chips)
Seat 5: kasper744 (11019520 in chips)
Seat 6: maxsi10 (12723280 in chips)
Seat 8: casey1186 (22788842 in chips)
Seat 9: AYoshiK (16074322 in chips)
youdri15: posts the ante 35000
4time2warp0: posts the ante 35000
AtilaMoreira: posts the ante 35000
hichnick777: posts the ante 35000
kasper744: posts the ante 35000
maxsi10: posts the ante 35000
casey1186: posts the ante 35000
AYoshiK: posts the ante 35000
4time2warp0: posts small blind 175000
AtilaMoreira: posts big blind 350000
*** HOLE CARDS ***
Dealt to hichnick777 [5h 4c]
hichnick777: folds
kasper744: folds
maxsi10: folds
casey1186: raises 700000 to 1050000
AYoshiK: folds
youdri15: folds
4time2warp0: folds
AtilaMoreira: folds
Uncalled bet (700000) returned to casey1186
casey1186 collected 1155000 from pot
casey1186: doesn't show hand
*** SUMMARY ***
Total pot 1155000 | Rake 0
Seat 1: youdri15 (button) folded before Flop (didn't bet)
Seat 2: 4time2warp0 (small blind) folded before Flop
Seat 3: AtilaMoreira (big blind) folded before Flop
Seat 4: hichnick777 folded before Flop (didn't bet)
Seat 5: kasper744 folded before Flop (didn't bet)
Seat 6: maxsi10 folded before Flop (didn't bet)
Seat 8: casey1186 collected (1155000)
Seat 9: AYoshiK folded before Flop (didn't bet)


*********** # 492 **************
PokerStars Hand #176682037682: Tournament #2054568934, $20+$2 USD Hold'em No Limit - Level XLVII (175000/350000) - 2017/10/09 8:23:10 MSK [2017/10/09 1:23:10 ET]
Table '2054568934 624' 9-max Seat #2 is the button
Seat 1: youdri15 (7039401 in chips)
Seat 2: 4time2warp0 (9662986 in chips)
Seat 3: AtilaMoreira (6201869 in chips)
Seat 4: hichnick777 (4554780 in chips)
Seat 5: kasper744 (10984520 in chips)
Seat 6: maxsi10 (12688280 in chips)
Seat 8: casey1186 (23558842 in chips)
Seat 9: AYoshiK (16039322 in chips)
youdri15: posts the ante 35000
4time2warp0: posts the ante 35000
AtilaMoreira: posts the ante 35000
hichnick777: posts the ante 35000
kasper744: posts the ante 35000
maxsi10: posts the ante 35000
casey1186: posts the ante 35000
AYoshiK: posts the ante 35000
AtilaMoreira: posts small blind 175000
hichnick777: posts big blind 350000
*** HOLE CARDS ***
Dealt to hichnick777 [Ad 2d]
kasper744: folds
maxsi10: folds
casey1186: folds
AYoshiK: folds
youdri15: folds
4time2warp0: folds
AtilaMoreira: folds
Uncalled bet (175000) returned to hichnick777
hichnick777 collected 630000 from pot
hichnick777: doesn't show hand
*** SUMMARY ***
Total pot 630000 | Rake 0
Seat 1: youdri15 folded before Flop (didn't bet)
Seat 2: 4time2warp0 (button) folded before Flop (didn't bet)
Seat 3: AtilaMoreira (small blind) folded before Flop
Seat 4: hichnick777 (big blind) collected (630000)
Seat 5: kasper744 folded before Flop (didn't bet)
Seat 6: maxsi10 folded before Flop (didn't bet)
Seat 8: casey1186 folded before Flop (didn't bet)
Seat 9: AYoshiK folded before Flop (didn't bet)


*********** # 493 **************
PokerStars Hand #176682040332: Tournament #2054568934, $20+$2 USD Hold'em No Limit - Level XLVII (175000/350000) - 2017/10/09 8:23:22 MSK [2017/10/09 1:23:22 ET]
Table '2054568934 624' 9-max Seat #3 is the button
Seat 1: youdri15 (7004401 in chips)
Seat 2: 4time2warp0 (9627986 in chips)
Seat 3: AtilaMoreira (5991869 in chips)
Seat 4: hichnick777 (4974780 in chips)
Seat 5: kasper744 (10949520 in chips)
Seat 6: maxsi10 (12653280 in chips)
Seat 8: casey1186 (23523842 in chips)
Seat 9: AYoshiK (16004322 in chips)
youdri15: posts the ante 35000
4time2warp0: posts the ante 35000
AtilaMoreira: posts the ante 35000
hichnick777: posts the ante 35000
kasper744: posts the ante 35000
maxsi10: posts the ante 35000
casey1186: posts the ante 35000
AYoshiK: posts the ante 35000
hichnick777: posts small blind 175000
kasper744: posts big blind 350000
*** HOLE CARDS ***
Dealt to hichnick777 [2s Td]
maxsi10: folds
casey1186: folds
AYoshiK: folds
youdri15: raises 700000 to 1050000
4time2warp0: folds
AtilaMoreira: folds
hichnick777: folds
kasper744: folds
Uncalled bet (700000) returned to youdri15
youdri15 collected 1155000 from pot
youdri15: doesn't show hand
*** SUMMARY ***
Total pot 1155000 | Rake 0
Seat 1: youdri15 collected (1155000)
Seat 2: 4time2warp0 folded before Flop (didn't bet)
Seat 3: AtilaMoreira (button) folded before Flop (didn't bet)
Seat 4: hichnick777 (small blind) folded before Flop
Seat 5: kasper744 (big blind) folded before Flop
Seat 6: maxsi10 folded before Flop (didn't bet)
Seat 8: casey1186 folded before Flop (didn't bet)
Seat 9: AYoshiK folded before Flop (didn't bet)


*********** # 494 **************
PokerStars Hand #176682045062: Tournament #2054568934, $20+$2 USD Hold'em No Limit - Level XLVII (175000/350000) - 2017/10/09 8:23:44 MSK [2017/10/09 1:23:44 ET]
Table '2054568934 624' 9-max Seat #4 is the button
Seat 1: youdri15 (7774401 in chips)
Seat 2: 4time2warp0 (9592986 in chips)
Seat 3: AtilaMoreira (5956869 in chips)
Seat 4: hichnick777 (4764780 in chips)
Seat 5: kasper744 (10564520 in chips)
Seat 6: maxsi10 (12618280 in chips)
Seat 8: casey1186 (23488842 in chips)
Seat 9: AYoshiK (15969322 in chips)
youdri15: posts the ante 35000
4time2warp0: posts the ante 35000
AtilaMoreira: posts the ante 35000
hichnick777: posts the ante 35000
kasper744: posts the ante 35000
maxsi10: posts the ante 35000
casey1186: posts the ante 35000
AYoshiK: posts the ante 35000
kasper744: posts small blind 175000
maxsi10: posts big blind 350000
*** HOLE CARDS ***
Dealt to hichnick777 [9h Ts]
casey1186: folds
AYoshiK: folds
youdri15: folds
4time2warp0: folds
AtilaMoreira: folds
hichnick777: raises 378000 to 728000
kasper744: folds
maxsi10: folds
Uncalled bet (378000) returned to hichnick777
hichnick777 collected 1155000 from pot
hichnick777: doesn't show hand
*** SUMMARY ***
Total pot 1155000 | Rake 0
Seat 1: youdri15 folded before Flop (didn't bet)
Seat 2: 4time2warp0 folded before Flop (didn't bet)
Seat 3: AtilaMoreira folded before Flop (didn't bet)
Seat 4: hichnick777 (button) collected (1155000)
Seat 5: kasper744 (small blind) folded before Flop
Seat 6: maxsi10 (big blind) folded before Flop
Seat 8: casey1186 folded before Flop (didn't bet)
Seat 9: AYoshiK folded before Flop (didn't bet)


*********** # 495 **************
PokerStars Hand #176682051369: Tournament #2054568934, $20+$2 USD Hold'em No Limit - Level XLVII (175000/350000) - 2017/10/09 8:24:13 MSK [2017/10/09 1:24:13 ET]
Table '2054568934 624' 9-max Seat #5 is the button
Seat 1: youdri15 (7739401 in chips)
Seat 2: 4time2warp0 (9557986 in chips)
Seat 3: AtilaMoreira (5921869 in chips)
Seat 4: hichnick777 (5534780 in chips)
Seat 5: kasper744 (10354520 in chips)
Seat 6: maxsi10 (12233280 in chips)
Seat 8: casey1186 (23453842 in chips)
Seat 9: AYoshiK (15934322 in chips)
youdri15: posts the ante 35000
4time2warp0: posts the ante 35000
AtilaMoreira: posts the ante 35000
hichnick777: posts the ante 35000
kasper744: posts the ante 35000
maxsi10: posts the ante 35000
casey1186: posts the ante 35000
AYoshiK: posts the ante 35000
maxsi10: posts small blind 175000
casey1186: posts big blind 350000
*** HOLE CARDS ***
Dealt to hichnick777 [7s Ah]
AYoshiK: folds
youdri15: folds
4time2warp0: folds
AtilaMoreira: folds
hichnick777: raises 378000 to 728000
kasper744: folds
maxsi10: folds
casey1186: folds
Uncalled bet (378000) returned to hichnick777
hichnick777 collected 1155000 from pot
hichnick777: doesn't show hand
*** SUMMARY ***
Total pot 1155000 | Rake 0
Seat 1: youdri15 folded before Flop (didn't bet)
Seat 2: 4time2warp0 folded before Flop (didn't bet)
Seat 3: AtilaMoreira folded before Flop (didn't bet)
Seat 4: hichnick777 collected (1155000)
Seat 5: kasper744 (button) folded before Flop (didn't bet)
Seat 6: maxsi10 (small blind) folded before Flop
Seat 8: casey1186 (big blind) folded before Flop
Seat 9: AYoshiK folded before Flop (didn't bet)


*********** # 496 **************
PokerStars Hand #176682056420: Tournament #2054568934, $20+$2 USD Hold'em No Limit - Level XLVII (175000/350000) - 2017/10/09 8:24:37 MSK [2017/10/09 1:24:37 ET]
Table '2054568934 624' 9-max Seat #6 is the button
Seat 1: youdri15 (7704401 in chips)
Seat 2: 4time2warp0 (9522986 in chips)
Seat 3: AtilaMoreira (5886869 in chips)
Seat 4: hichnick777 (6304780 in chips)
Seat 5: kasper744 (10319520 in chips)
Seat 6: maxsi10 (12023280 in chips)
Seat 8: casey1186 (23068842 in chips)
Seat 9: AYoshiK (15899322 in chips)
youdri15: posts the ante 35000
4time2warp0: posts the ante 35000
AtilaMoreira: posts the ante 35000
hichnick777: posts the ante 35000
kasper744: posts the ante 35000
maxsi10: posts the ante 35000
casey1186: posts the ante 35000
AYoshiK: posts the ante 35000
casey1186: posts small blind 175000
AYoshiK: posts big blind 350000
*** HOLE CARDS ***
Dealt to hichnick777 [8d Qc]
youdri15: folds
4time2warp0: folds
AtilaMoreira: folds
hichnick777: folds
kasper744: folds
maxsi10: raises 350000 to 700000
casey1186: folds
AYoshiK: raises 1475895 to 2175895
maxsi10: folds
Uncalled bet (1475895) returned to AYoshiK
AYoshiK collected 1855000 from pot
AYoshiK: doesn't show hand
*** SUMMARY ***
Total pot 1855000 | Rake 0
Seat 1: youdri15 folded before Flop (didn't bet)
Seat 2: 4time2warp0 folded before Flop (didn't bet)
Seat 3: AtilaMoreira folded before Flop (didn't bet)
Seat 4: hichnick777 folded before Flop (didn't bet)
Seat 5: kasper744 folded before Flop (didn't bet)
Seat 6: maxsi10 (button) folded before Flop
Seat 8: casey1186 (small blind) folded before Flop
Seat 9: AYoshiK (big blind) collected (1855000)


*********** # 497 **************
PokerStars Hand #176682066200: Tournament #2054568934, $20+$2 USD Hold'em No Limit - Level XLVII (175000/350000) - 2017/10/09 8:25:23 MSK [2017/10/09 1:25:23 ET]
Table '2054568934 624' 9-max Seat #8 is the button
Seat 1: youdri15 (7669401 in chips)
Seat 2: 4time2warp0 (9487986 in chips)
Seat 3: AtilaMoreira (5851869 in chips)
Seat 4: hichnick777 (6269780 in chips)
Seat 5: kasper744 (10284520 in chips)
Seat 6: maxsi10 (11288280 in chips)
Seat 8: casey1186 (22858842 in chips)
Seat 9: AYoshiK (17019322 in chips)
youdri15: posts the ante 35000
4time2warp0: posts the ante 35000
AtilaMoreira: posts the ante 35000
hichnick777: posts the ante 35000
kasper744: posts the ante 35000
maxsi10: posts the ante 35000
casey1186: posts the ante 35000
AYoshiK: posts the ante 35000
AYoshiK: posts small blind 175000
youdri15: posts big blind 350000
*** HOLE CARDS ***
Dealt to hichnick777 [5d Ts]
4time2warp0: folds
AtilaMoreira: folds
hichnick777: folds
kasper744: folds
maxsi10: raises 350000 to 700000
casey1186: folds
AYoshiK: folds
youdri15: folds
Uncalled bet (350000) returned to maxsi10
maxsi10 collected 1155000 from pot
*** SUMMARY ***
Total pot 1155000 | Rake 0
Seat 1: youdri15 (big blind) folded before Flop
Seat 2: 4time2warp0 folded before Flop (didn't bet)
Seat 3: AtilaMoreira folded before Flop (didn't bet)
Seat 4: hichnick777 folded before Flop (didn't bet)
Seat 5: kasper744 folded before Flop (didn't bet)
Seat 6: maxsi10 collected (1155000)
Seat 8: casey1186 (button) folded before Flop (didn't bet)
Seat 9: AYoshiK (small blind) folded before Flop


*********** # 498 **************
PokerStars Hand #176682070471: Tournament #2054568934, $20+$2 USD Hold'em No Limit - Level XLVII (175000/350000) - 2017/10/09 8:25:43 MSK [2017/10/09 1:25:43 ET]
Table '2054568934 624' 9-max Seat #9 is the button
Seat 1: youdri15 (7284401 in chips)
Seat 2: 4time2warp0 (9452986 in chips)
Seat 3: AtilaMoreira (5816869 in chips)
Seat 4: hichnick777 (6234780 in chips)
Seat 5: kasper744 (10249520 in chips)
Seat 6: maxsi10 (12058280 in chips)
Seat 8: casey1186 (22823842 in chips)
Seat 9: AYoshiK (16809322 in chips)
youdri15: posts the ante 35000
4time2warp0: posts the ante 35000
AtilaMoreira: posts the ante 35000
hichnick777: posts the ante 35000
kasper744: posts the ante 35000
maxsi10: posts the ante 35000
casey1186: posts the ante 35000
AYoshiK: posts the ante 35000
youdri15: posts small blind 175000
4time2warp0: posts big blind 350000
*** HOLE CARDS ***
Dealt to hichnick777 [7s 5d]
AtilaMoreira: raises 350000 to 700000
hichnick777: folds
kasper744: folds
maxsi10: folds
casey1186: calls 700000
AYoshiK: raises 2554755 to 3254755
youdri15: folds
4time2warp0: folds
AtilaMoreira: folds
casey1186: folds
Uncalled bet (2554755) returned to AYoshiK
AYoshiK collected 2905000 from pot
AYoshiK: doesn't show hand
*** SUMMARY ***
Total pot 2905000 | Rake 0
Seat 1: youdri15 (small blind) folded before Flop
Seat 2: 4time2warp0 (big blind) folded before Flop
Seat 3: AtilaMoreira folded before Flop
Seat 4: hichnick777 folded before Flop (didn't bet)
Seat 5: kasper744 folded before Flop (didn't bet)
Seat 6: maxsi10 folded before Flop (didn't bet)
Seat 8: casey1186 folded before Flop
Seat 9: AYoshiK (button) collected (2905000)


*********** # 499 **************
PokerStars Hand #176682079734: Tournament #2054568934, $20+$2 USD Hold'em No Limit - Level XLVII (175000/350000) - 2017/10/09 8:26:26 MSK [2017/10/09 1:26:26 ET]
Table '2054568934 624' 9-max Seat #1 is the button
Seat 1: youdri15 (7074401 in chips)
Seat 2: 4time2warp0 (9067986 in chips)
Seat 3: AtilaMoreira (5081869 in chips)
Seat 4: hichnick777 (6199780 in chips)
Seat 5: kasper744 (10214520 in chips)
Seat 6: maxsi10 (12023280 in chips)
Seat 8: casey1186 (22088842 in chips)
Seat 9: AYoshiK (18979322 in chips)
youdri15: posts the ante 35000
4time2warp0: posts the ante 35000
AtilaMoreira: posts the ante 35000
hichnick777: posts the ante 35000
kasper744: posts the ante 35000
maxsi10: posts the ante 35000
casey1186: posts the ante 35000
AYoshiK: posts the ante 35000
4time2warp0: posts small blind 175000
AtilaMoreira: posts big blind 350000
*** HOLE CARDS ***
Dealt to hichnick777 [4d 3c]
hichnick777: folds
kasper744: folds
maxsi10: raises 350000 to 700000
casey1186: folds
AYoshiK: calls 700000
youdri15: calls 700000
4time2warp0: folds
AtilaMoreira: calls 350000
*** FLOP *** [Qh 5h 2s]
AtilaMoreira: checks
maxsi10: bets 1074150
AYoshiK: folds
youdri15: raises 5265251 to 6339401 and is all-in
AtilaMoreira: folds
maxsi10: calls 5265251
*** TURN *** [Qh 5h 2s] [6d]
*** RIVER *** [Qh 5h 2s 6d] [9s]
*** SHOW DOWN ***
maxsi10: shows [Ac As] (a pair of Aces)
youdri15: shows [5d 5c] (three of a kind, Fives)
youdri15 collected 15933802 from pot
*** SUMMARY ***
Total pot 15933802 | Rake 0
Board [Qh 5h 2s 6d 9s]
Seat 1: youdri15 (button) showed [5d 5c] and won (15933802) with three of a kind, Fives
Seat 2: 4time2warp0 (small blind) folded before Flop
Seat 3: AtilaMoreira (big blind) folded on the Flop
Seat 4: hichnick777 folded before Flop (didn't bet)
Seat 5: kasper744 folded before Flop (didn't bet)
Seat 6: maxsi10 showed [Ac As] and lost with a pair of Aces
Seat 8: casey1186 folded before Flop (didn't bet)
Seat 9: AYoshiK folded on the Flop


*********** # 500 **************
PokerStars Hand #176682096007: Tournament #2054568934, $20+$2 USD Hold'em No Limit - Level XLVII (175000/350000) - 2017/10/09 8:27:41 MSK [2017/10/09 1:27:41 ET]
Table '2054568934 624' 9-max Seat #2 is the button
Seat 1: youdri15 (15933802 in chips)
Seat 2: 4time2warp0 (8857986 in chips)
Seat 3: AtilaMoreira (4346869 in chips)
Seat 4: hichnick777 (6164780 in chips)
Seat 5: kasper744 (10179520 in chips)
Seat 6: maxsi10 (4948879 in chips)
Seat 8: casey1186 (22053842 in chips)
Seat 9: AYoshiK (18244322 in chips)
youdri15: posts the ante 35000
4time2warp0: posts the ante 35000
AtilaMoreira: posts the ante 35000
hichnick777: posts the ante 35000
kasper744: posts the ante 35000
maxsi10: posts the ante 35000
casey1186: posts the ante 35000
AYoshiK: posts the ante 35000
AtilaMoreira: posts small blind 175000
hichnick777: posts big blind 350000
*** HOLE CARDS ***
Dealt to hichnick777 [4c Js]
kasper744: folds
maxsi10: folds
casey1186: folds
AYoshiK: folds
youdri15: raises 350000 to 700000
4time2warp0: folds
AtilaMoreira: raises 3611869 to 4311869 and is all-in
hichnick777: folds
youdri15: calls 3611869
*** FLOP *** [Qs 9c Jd]
*** TURN *** [Qs 9c Jd] [4s]
*** RIVER *** [Qs 9c Jd 4s] [3h]
*** SHOW DOWN ***
AtilaMoreira: shows [7s As] (high card Ace)
youdri15: shows [Ac 2c] (high card Ace - lower kicker)
AtilaMoreira collected 9253738 from pot
*** SUMMARY ***
Total pot 9253738 | Rake 0
Board [Qs 9c Jd 4s 3h]
Seat 1: youdri15 showed [Ac 2c] and lost with high card Ace
Seat 2: 4time2warp0 (button) folded before Flop (didn't bet)
Seat 3: AtilaMoreira (small blind) showed [7s As] and won (9253738) with high card Ace
Seat 4: hichnick777 (big blind) folded before Flop
Seat 5: kasper744 folded before Flop (didn't bet)
Seat 6: maxsi10 folded before Flop (didn't bet)
Seat 8: casey1186 folded before Flop (didn't bet)
Seat 9: AYoshiK folded before Flop (didn't bet)


*********** # 501 **************
PokerStars Hand #176682104158: Tournament #2054568934, $20+$2 USD Hold'em No Limit - Level XLVII (175000/350000) - 2017/10/09 8:28:19 MSK [2017/10/09 1:28:19 ET]
Table '2054568934 624' 9-max Seat #3 is the button
Seat 1: youdri15 (11586933 in chips)
Seat 2: 4time2warp0 (8822986 in chips)
Seat 3: AtilaMoreira (9253738 in chips)
Seat 4: hichnick777 (5779780 in chips)
Seat 5: kasper744 (10144520 in chips)
Seat 6: maxsi10 (4913879 in chips)
Seat 8: casey1186 (22018842 in chips)
Seat 9: AYoshiK (18209322 in chips)
youdri15: posts the ante 35000
4time2warp0: posts the ante 35000
AtilaMoreira: posts the ante 35000
hichnick777: posts the ante 35000
kasper744: posts the ante 35000
maxsi10: posts the ante 35000
casey1186: posts the ante 35000
AYoshiK: posts the ante 35000
hichnick777: posts small blind 175000
kasper744: posts big blind 350000
*** HOLE CARDS ***
Dealt to hichnick777 [7c 8d]
maxsi10: folds
casey1186: raises 350000 to 700000
AYoshiK: folds
youdri15: calls 700000
4time2warp0: folds
AtilaMoreira: folds
hichnick777: folds
kasper744: folds
*** FLOP *** [2c 4s Ad]
casey1186: bets 2205000
youdri15: folds
Uncalled bet (2205000) returned to casey1186
casey1186 collected 2205000 from pot
casey1186: doesn't show hand
*** SUMMARY ***
Total pot 2205000 | Rake 0
Board [2c 4s Ad]
Seat 1: youdri15 folded on the Flop
Seat 2: 4time2warp0 folded before Flop (didn't bet)
Seat 3: AtilaMoreira (button) folded before Flop (didn't bet)
Seat 4: hichnick777 (small blind) folded before Flop
Seat 5: kasper744 (big blind) folded before Flop
Seat 6: maxsi10 folded before Flop (didn't bet)
Seat 8: casey1186 collected (2205000)
Seat 9: AYoshiK folded before Flop (didn't bet)


*********** # 502 **************
PokerStars Hand #176682109176: Tournament #2054568934, $20+$2 USD Hold'em No Limit - Level XLVII (175000/350000) - 2017/10/09 8:28:42 MSK [2017/10/09 1:28:42 ET]
Table '2054568934 624' 9-max Seat #4 is the button
Seat 1: youdri15 (10851933 in chips)
Seat 2: 4time2warp0 (8787986 in chips)
Seat 3: AtilaMoreira (9218738 in chips)
Seat 4: hichnick777 (5569780 in chips)
Seat 5: kasper744 (9759520 in chips)
Seat 6: maxsi10 (4878879 in chips)
Seat 8: casey1186 (23488842 in chips)
Seat 9: AYoshiK (18174322 in chips)
youdri15: posts the ante 35000
4time2warp0: posts the ante 35000
AtilaMoreira: posts the ante 35000
hichnick777: posts the ante 35000
kasper744: posts the ante 35000
maxsi10: posts the ante 35000
casey1186: posts the ante 35000
AYoshiK: posts the ante 35000
kasper744: posts small blind 175000
maxsi10: posts big blind 350000
*** HOLE CARDS ***
Dealt to hichnick777 [8s Ts]
casey1186: folds
AYoshiK: folds
youdri15: folds
4time2warp0: raises 350000 to 700000
AtilaMoreira: folds
hichnick777: folds
kasper744: folds
maxsi10: raises 4143879 to 4843879 and is all-in
4time2warp0: folds
Uncalled bet (4143879) returned to maxsi10
maxsi10 collected 1855000 from pot
*** SUMMARY ***
Total pot 1855000 | Rake 0
Seat 1: youdri15 folded before Flop (didn't bet)
Seat 2: 4time2warp0 folded before Flop
Seat 3: AtilaMoreira folded before Flop (didn't bet)
Seat 4: hichnick777 (button) folded before Flop (didn't bet)
Seat 5: kasper744 (small blind) folded before Flop
Seat 6: maxsi10 (big blind) collected (1855000)
Seat 8: casey1186 folded before Flop (didn't bet)
Seat 9: AYoshiK folded before Flop (didn't bet)


*********** # 503 **************
PokerStars Hand #176682116958: Tournament #2054568934, $20+$2 USD Hold'em No Limit - Level XLVII (175000/350000) - 2017/10/09 8:29:18 MSK [2017/10/09 1:29:18 ET]
Table '2054568934 624' 9-max Seat #5 is the button
Seat 1: youdri15 (10816933 in chips)
Seat 2: 4time2warp0 (8052986 in chips)
Seat 3: AtilaMoreira (9183738 in chips)
Seat 4: hichnick777 (5534780 in chips)
Seat 5: kasper744 (9549520 in chips)
Seat 6: maxsi10 (5998879 in chips)
Seat 8: casey1186 (23453842 in chips)
Seat 9: AYoshiK (18139322 in chips)
youdri15: posts the ante 35000
4time2warp0: posts the ante 35000
AtilaMoreira: posts the ante 35000
hichnick777: posts the ante 35000
kasper744: posts the ante 35000
maxsi10: posts the ante 35000
casey1186: posts the ante 35000
AYoshiK: posts the ante 35000
maxsi10: posts small blind 175000
casey1186: posts big blind 350000
*** HOLE CARDS ***
Dealt to hichnick777 [Qh 5d]
AYoshiK: folds
youdri15: folds
4time2warp0: folds
AtilaMoreira: folds
hichnick777: folds
kasper744: folds
maxsi10: folds
Uncalled bet (175000) returned to casey1186
casey1186 collected 630000 from pot
casey1186: doesn't show hand
*** SUMMARY ***
Total pot 630000 | Rake 0
Seat 1: youdri15 folded before Flop (didn't bet)
Seat 2: 4time2warp0 folded before Flop (didn't bet)
Seat 3: AtilaMoreira folded before Flop (didn't bet)
Seat 4: hichnick777 folded before Flop (didn't bet)
Seat 5: kasper744 (button) folded before Flop (didn't bet)
Seat 6: maxsi10 (small blind) folded before Flop
Seat 8: casey1186 (big blind) collected (630000)
Seat 9: AYoshiK folded before Flop (didn't bet)


*********** # 504 **************
PokerStars Hand #176682120365: Tournament #2054568934, $20+$2 USD Hold'em No Limit - Level XLVII (175000/350000) - 2017/10/09 8:29:34 MSK [2017/10/09 1:29:34 ET]
Table '2054568934 624' 9-max Seat #6 is the button
Seat 1: youdri15 (10781933 in chips)
Seat 2: 4time2warp0 (8017986 in chips)
Seat 3: AtilaMoreira (9148738 in chips)
Seat 4: hichnick777 (5499780 in chips)
Seat 5: kasper744 (9514520 in chips)
Seat 6: maxsi10 (5788879 in chips)
Seat 8: casey1186 (23873842 in chips)
Seat 9: AYoshiK (18104322 in chips)
youdri15: posts the ante 35000
4time2warp0: posts the ante 35000
AtilaMoreira: posts the ante 35000
hichnick777: posts the ante 35000
kasper744: posts the ante 35000
maxsi10: posts the ante 35000
casey1186: posts the ante 35000
AYoshiK: posts the ante 35000
casey1186: posts small blind 175000
AYoshiK: posts big blind 350000
*** HOLE CARDS ***
Dealt to hichnick777 [Qd 5s]
youdri15: raises 700000 to 1050000
4time2warp0: folds
AtilaMoreira: folds
hichnick777: folds
kasper744: folds
maxsi10: folds
casey1186: folds
AYoshiK: folds
Uncalled bet (700000) returned to youdri15
youdri15 collected 1155000 from pot
youdri15: doesn't show hand
*** SUMMARY ***
Total pot 1155000 | Rake 0
Seat 1: youdri15 collected (1155000)
Seat 2: 4time2warp0 folded before Flop (didn't bet)
Seat 3: AtilaMoreira folded before Flop (didn't bet)
Seat 4: hichnick777 folded before Flop (didn't bet)
Seat 5: kasper744 folded before Flop (didn't bet)
Seat 6: maxsi10 (button) folded before Flop (didn't bet)
Seat 8: casey1186 (small blind) folded before Flop
Seat 9: AYoshiK (big blind) folded before Flop


*********** # 505 **************
PokerStars Hand #176682125727: Tournament #2054568934, $20+$2 USD Hold'em No Limit - Level XLVII (175000/350000) - 2017/10/09 8:29:58 MSK [2017/10/09 1:29:58 ET]
Table '2054568934 624' 9-max Seat #8 is the button
Seat 1: youdri15 (11551933 in chips)
Seat 2: 4time2warp0 (7982986 in chips)
Seat 3: AtilaMoreira (9113738 in chips)
Seat 4: hichnick777 (5464780 in chips)
Seat 5: kasper744 (9479520 in chips)
Seat 6: maxsi10 (5753879 in chips)
Seat 8: casey1186 (23663842 in chips)
Seat 9: AYoshiK (17719322 in chips)
youdri15: posts the ante 35000
4time2warp0: posts the ante 35000
AtilaMoreira: posts the ante 35000
hichnick777: posts the ante 35000
kasper744: posts the ante 35000
maxsi10: posts the ante 35000
casey1186: posts the ante 35000
AYoshiK: posts the ante 35000
AYoshiK: posts small blind 175000
youdri15: posts big blind 350000
*** HOLE CARDS ***
Dealt to hichnick777 [9c 2s]
4time2warp0: folds
AtilaMoreira: folds
hichnick777: folds
kasper744: folds
maxsi10: folds
casey1186: folds
AYoshiK: raises 371000 to 721000
youdri15: calls 371000
*** FLOP *** [4s As Ac]
AYoshiK: bets 757680
youdri15: calls 757680
*** TURN *** [4s As Ac] [8c]
AYoshiK: bets 1424438
youdri15: calls 1424438
*** RIVER *** [4s As Ac 8c] [8h]
AYoshiK: bets 3408292
youdri15: calls 3408292
*** SHOW DOWN ***
AYoshiK: shows [3h 6h] (two pair, Aces and Eights)
youdri15: shows [Td Th] (two pair, Aces and Tens)
youdri15 collected 12902820 from pot
*** SUMMARY ***
Total pot 12902820 | Rake 0
Board [4s As Ac 8c 8h]
Seat 1: youdri15 (big blind) showed [Td Th] and won (12902820) with two pair, Aces and Tens
Seat 2: 4time2warp0 folded before Flop (didn't bet)
Seat 3: AtilaMoreira folded before Flop (didn't bet)
Seat 4: hichnick777 folded before Flop (didn't bet)
Seat 5: kasper744 folded before Flop (didn't bet)
Seat 6: maxsi10 folded before Flop (didn't bet)
Seat 8: casey1186 (button) folded before Flop (didn't bet)
Seat 9: AYoshiK (small blind) showed [3h 6h] and lost with two pair, Aces and Eights


*********** # 506 **************
PokerStars Hand #176682139473: Tournament #2054568934, $20+$2 USD Hold'em No Limit - Level XLVII (175000/350000) - 2017/10/09 8:31:02 MSK [2017/10/09 1:31:02 ET]
Table '2054568934 624' 9-max Seat #9 is the button
Seat 1: youdri15 (18108343 in chips)
Seat 2: 4time2warp0 (7947986 in chips)
Seat 3: AtilaMoreira (9078738 in chips)
Seat 4: hichnick777 (5429780 in chips)
Seat 5: kasper744 (9444520 in chips)
Seat 6: maxsi10 (5718879 in chips)
Seat 8: casey1186 (23628842 in chips)
Seat 9: AYoshiK (11372912 in chips)
youdri15: posts the ante 35000
4time2warp0: posts the ante 35000
AtilaMoreira: posts the ante 35000
hichnick777: posts the ante 35000
kasper744: posts the ante 35000
maxsi10: posts the ante 35000
casey1186: posts the ante 35000
AYoshiK: posts the ante 35000
youdri15: posts small blind 175000
4time2warp0: posts big blind 350000
*** HOLE CARDS ***
Dealt to hichnick777 [Tc Th]
AtilaMoreira: folds
casey1186 said, "nice call"
hichnick777: raises 378000 to 728000
kasper744: folds
maxsi10: folds
casey1186: folds
AYoshiK: calls 728000
youdri15: folds
4time2warp0: folds
*** FLOP *** [Ts Ad Kd]
hichnick777: bets 746130
AYoshiK: raises 746130 to 1492260
hichnick777: raises 3174520 to 4666780 and is all-in
AYoshiK: folds
Uncalled bet (3174520) returned to hichnick777
hichnick777 collected 5245520 from pot
hichnick777: doesn't show hand
*** SUMMARY ***
Total pot 5245520 | Rake 0
Board [Ts Ad Kd]
Seat 1: youdri15 (small blind) folded before Flop
Seat 2: 4time2warp0 (big blind) folded before Flop
Seat 3: AtilaMoreira folded before Flop (didn't bet)
Seat 4: hichnick777 collected (5245520)
Seat 5: kasper744 folded before Flop (didn't bet)
Seat 6: maxsi10 folded before Flop (didn't bet)
Seat 8: casey1186 folded before Flop (didn't bet)
Seat 9: AYoshiK (button) folded on the Flop


*********** # 507 **************
PokerStars Hand #176682161361: Tournament #2054568934, $20+$2 USD Hold'em No Limit - Level XLVII (175000/350000) - 2017/10/09 8:32:44 MSK [2017/10/09 1:32:44 ET]
Table '2054568934 624' 9-max Seat #1 is the button
Seat 1: youdri15 (17898343 in chips)
Seat 2: 4time2warp0 (7562986 in chips)
Seat 3: AtilaMoreira (9043738 in chips)
Seat 4: hichnick777 (8420040 in chips)
Seat 5: kasper744 (9409520 in chips)
Seat 6: maxsi10 (5683879 in chips)
Seat 8: casey1186 (23593842 in chips)
Seat 9: AYoshiK (9117652 in chips)
youdri15: posts the ante 35000
4time2warp0: posts the ante 35000
AtilaMoreira: posts the ante 35000
hichnick777: posts the ante 35000
kasper744: posts the ante 35000
maxsi10: posts the ante 35000
casey1186: posts the ante 35000
AYoshiK: posts the ante 35000
4time2warp0: posts small blind 175000
AtilaMoreira: posts big blind 350000
*** HOLE CARDS ***
Dealt to hichnick777 [5c Jh]
hichnick777: folds
kasper744: folds
maxsi10: folds
casey1186: raises 700000 to 1050000
AYoshiK: folds
youdri15: calls 1050000
4time2warp0: folds
AtilaMoreira: folds
*** FLOP *** [4s 9c 7h]
casey1186: checks
youdri15: checks
*** TURN *** [4s 9c 7h] [As]
casey1186: checks
youdri15: bets 1400000
casey1186: calls 1400000
*** RIVER *** [4s 9c 7h As] [8s]
casey1186: checks
youdri15: checks
*** SHOW DOWN ***
casey1186: shows [8h 6s] (a pair of Eights)
youdri15: shows [Qh Ac] (a pair of Aces)
youdri15 collected 5705000 from pot
*** SUMMARY ***
Total pot 5705000 | Rake 0
Board [4s 9c 7h As 8s]
Seat 1: youdri15 (button) showed [Qh Ac] and won (5705000) with a pair of Aces
Seat 2: 4time2warp0 (small blind) folded before Flop
Seat 3: AtilaMoreira (big blind) folded before Flop
Seat 4: hichnick777 folded before Flop (didn't bet)
Seat 5: kasper744 folded before Flop (didn't bet)
Seat 6: maxsi10 folded before Flop (didn't bet)
Seat 8: casey1186 showed [8h 6s] and lost with a pair of Eights
Seat 9: AYoshiK folded before Flop (didn't bet)


*********** # 508 **************
PokerStars Hand #176682169074: Tournament #2054568934, $20+$2 USD Hold'em No Limit - Level XLVIII (200000/400000) - 2017/10/09 8:33:20 MSK [2017/10/09 1:33:20 ET]
Table '2054568934 624' 9-max Seat #2 is the button
Seat 1: youdri15 (21118343 in chips)
Seat 2: 4time2warp0 (7352986 in chips)
Seat 3: AtilaMoreira (8658738 in chips)
Seat 4: hichnick777 (8385040 in chips)
Seat 5: kasper744 (9374520 in chips)
Seat 6: maxsi10 (5648879 in chips)
Seat 8: casey1186 (21108842 in chips)
Seat 9: AYoshiK (9082652 in chips)
youdri15: posts the ante 40000
4time2warp0: posts the ante 40000
AtilaMoreira: posts the ante 40000
hichnick777: posts the ante 40000
kasper744: posts the ante 40000
maxsi10: posts the ante 40000
casey1186: posts the ante 40000
AYoshiK: posts the ante 40000
AtilaMoreira: posts small blind 200000
hichnick777: posts big blind 400000
*** HOLE CARDS ***
Dealt to hichnick777 [6d Js]
kasper744: folds
maxsi10: raises 5208879 to 5608879 and is all-in
casey1186: folds
AYoshiK: folds
youdri15: folds
4time2warp0: folds
AtilaMoreira: folds
hichnick777: folds
Uncalled bet (5208879) returned to maxsi10
maxsi10 collected 1320000 from pot
*** SUMMARY ***
Total pot 1320000 | Rake 0
Seat 1: youdri15 folded before Flop (didn't bet)
Seat 2: 4time2warp0 (button) folded before Flop (didn't bet)
Seat 3: AtilaMoreira (small blind) folded before Flop
Seat 4: hichnick777 (big blind) folded before Flop
Seat 5: kasper744 folded before Flop (didn't bet)
Seat 6: maxsi10 collected (1320000)
Seat 8: casey1186 folded before Flop (didn't bet)
Seat 9: AYoshiK folded before Flop (didn't bet)


*********** # 509 **************
PokerStars Hand #176682172562: Tournament #2054568934, $20+$2 USD Hold'em No Limit - Level XLVIII (200000/400000) - 2017/10/09 8:33:36 MSK [2017/10/09 1:33:36 ET]
Table '2054568934 624' 9-max Seat #3 is the button
Seat 1: youdri15 (21078343 in chips)
Seat 2: 4time2warp0 (7312986 in chips)
Seat 3: AtilaMoreira (8418738 in chips)
Seat 4: hichnick777 (7945040 in chips)
Seat 5: kasper744 (9334520 in chips)
Seat 6: maxsi10 (6528879 in chips)
Seat 8: casey1186 (21068842 in chips)
Seat 9: AYoshiK (9042652 in chips)
youdri15: posts the ante 40000
4time2warp0: posts the ante 40000
AtilaMoreira: posts the ante 40000
hichnick777: posts the ante 40000
kasper744: posts the ante 40000
maxsi10: posts the ante 40000
casey1186: posts the ante 40000
AYoshiK: posts the ante 40000
hichnick777: posts small blind 200000
kasper744: posts big blind 400000
*** HOLE CARDS ***
Dealt to hichnick777 [Jh 4s]
maxsi10: folds
casey1186: folds
AYoshiK: folds
youdri15: folds
4time2warp0: folds
AtilaMoreira: raises 400000 to 800000
hichnick777: folds
kasper744: folds
Uncalled bet (400000) returned to AtilaMoreira
AtilaMoreira collected 1320000 from pot
*** SUMMARY ***
Total pot 1320000 | Rake 0
Seat 1: youdri15 folded before Flop (didn't bet)
Seat 2: 4time2warp0 folded before Flop (didn't bet)
Seat 3: AtilaMoreira (button) collected (1320000)
Seat 4: hichnick777 (small blind) folded before Flop
Seat 5: kasper744 (big blind) folded before Flop
Seat 6: maxsi10 folded before Flop (didn't bet)
Seat 8: casey1186 folded before Flop (didn't bet)
Seat 9: AYoshiK folded before Flop (didn't bet)


*********** # 510 **************
PokerStars Hand #176682180483: Tournament #2054568934, $20+$2 USD Hold'em No Limit - Level XLVIII (200000/400000) - 2017/10/09 8:34:13 MSK [2017/10/09 1:34:13 ET]
Table '2054568934 624' 9-max Seat #4 is the button
Seat 1: youdri15 (21038343 in chips)
Seat 2: 4time2warp0 (7272986 in chips)
Seat 3: AtilaMoreira (9298738 in chips)
Seat 4: hichnick777 (7705040 in chips)
Seat 5: kasper744 (8894520 in chips)
Seat 6: maxsi10 (6488879 in chips)
Seat 8: casey1186 (21028842 in chips)
Seat 9: AYoshiK (9002652 in chips)
youdri15: posts the ante 40000
4time2warp0: posts the ante 40000
AtilaMoreira: posts the ante 40000
hichnick777: posts the ante 40000
kasper744: posts the ante 40000
maxsi10: posts the ante 40000
casey1186: posts the ante 40000
AYoshiK: posts the ante 40000
kasper744: posts small blind 200000
maxsi10: posts big blind 400000
*** HOLE CARDS ***
Dealt to hichnick777 [3h 7h]
casey1186: folds
AYoshiK: folds
youdri15: folds
4time2warp0: folds
AtilaMoreira: folds
hichnick777: raises 432000 to 832000
kasper744: folds
maxsi10: folds
Uncalled bet (432000) returned to hichnick777
hichnick777 collected 1320000 from pot
hichnick777: doesn't show hand
*** SUMMARY ***
Total pot 1320000 | Rake 0
Seat 1: youdri15 folded before Flop (didn't bet)
Seat 2: 4time2warp0 folded before Flop (didn't bet)
Seat 3: AtilaMoreira folded before Flop (didn't bet)
Seat 4: hichnick777 (button) collected (1320000)
Seat 5: kasper744 (small blind) folded before Flop
Seat 6: maxsi10 (big blind) folded before Flop
Seat 8: casey1186 folded before Flop (didn't bet)
Seat 9: AYoshiK folded before Flop (didn't bet)


*********** # 511 **************
PokerStars Hand #176682186661: Tournament #2054568934, $20+$2 USD Hold'em No Limit - Level XLVIII (200000/400000) - 2017/10/09 8:34:42 MSK [2017/10/09 1:34:42 ET]
Table '2054568934 624' 9-max Seat #5 is the button
Seat 1: youdri15 (20998343 in chips)
Seat 2: 4time2warp0 (7232986 in chips)
Seat 3: AtilaMoreira (9258738 in chips)
Seat 4: hichnick777 (8585040 in chips)
Seat 5: kasper744 (8654520 in chips)
Seat 6: maxsi10 (6048879 in chips)
Seat 8: casey1186 (20988842 in chips)
Seat 9: AYoshiK (8962652 in chips)
youdri15: posts the ante 40000
4time2warp0: posts the ante 40000
AtilaMoreira: posts the ante 40000
hichnick777: posts the ante 40000
kasper744: posts the ante 40000
maxsi10: posts the ante 40000
casey1186: posts the ante 40000
AYoshiK: posts the ante 40000
maxsi10: posts small blind 200000
casey1186: posts big blind 400000
*** HOLE CARDS ***
Dealt to hichnick777 [8c 4c]
AYoshiK: folds
youdri15: raises 600000 to 1000000
4time2warp0: folds
AtilaMoreira: folds
hichnick777: folds
kasper744: raises 7614520 to 8614520 and is all-in
maxsi10: folds
casey1186: folds
youdri15: folds [Ac]
Uncalled bet (7614520) returned to kasper744
kasper744 collected 2920000 from pot
kasper744: doesn't show hand
*** SUMMARY ***
Total pot 2920000 | Rake 0
Seat 1: youdri15 folded before Flop
Seat 2: 4time2warp0 folded before Flop (didn't bet)
Seat 3: AtilaMoreira folded before Flop (didn't bet)
Seat 4: hichnick777 folded before Flop (didn't bet)
Seat 5: kasper744 (button) collected (2920000)
Seat 6: maxsi10 (small blind) folded before Flop
Seat 8: casey1186 (big blind) folded before Flop
Seat 9: AYoshiK folded before Flop (didn't bet)


*********** # 512 **************
PokerStars Hand #176682196572: Tournament #2054568934, $20+$2 USD Hold'em No Limit - Level XLVIII (200000/400000) - 2017/10/09 8:35:28 MSK [2017/10/09 1:35:28 ET]
Table '2054568934 624' 9-max Seat #6 is the button
Seat 1: youdri15 (19958343 in chips)
Seat 2: 4time2warp0 (7192986 in chips)
Seat 3: AtilaMoreira (9218738 in chips)
Seat 4: hichnick777 (8545040 in chips)
Seat 5: kasper744 (10534520 in chips)
Seat 6: maxsi10 (5808879 in chips)
Seat 8: casey1186 (20548842 in chips)
Seat 9: AYoshiK (8922652 in chips)
youdri15: posts the ante 40000
4time2warp0: posts the ante 40000
AtilaMoreira: posts the ante 40000
hichnick777: posts the ante 40000
kasper744: posts the ante 40000
maxsi10: posts the ante 40000
casey1186: posts the ante 40000
AYoshiK: posts the ante 40000
casey1186: posts small blind 200000
AYoshiK: posts big blind 400000
*** HOLE CARDS ***
Dealt to hichnick777 [2s Kh]
youdri15: raises 400000 to 800000
4time2warp0: folds
AtilaMoreira: folds
hichnick777: folds
kasper744: folds
maxsi10: raises 4968879 to 5768879 and is all-in
casey1186: folds
AYoshiK: folds
youdri15: calls 4968879
*** FLOP *** [Ts 4d 4s]
*** TURN *** [Ts 4d 4s] [3s]
*** RIVER *** [Ts 4d 4s 3s] [4c]
*** SHOW DOWN ***
youdri15: shows [9s Ks] (a flush, King high)
maxsi10: shows [Ad Tc] (a full house, Fours full of Tens)
maxsi10 collected 12457758 from pot
*** SUMMARY ***
Total pot 12457758 | Rake 0
Board [Ts 4d 4s 3s 4c]
Seat 1: youdri15 showed [9s Ks] and lost with a flush, King high
Seat 2: 4time2warp0 folded before Flop (didn't bet)
Seat 3: AtilaMoreira folded before Flop (didn't bet)
Seat 4: hichnick777 folded before Flop (didn't bet)
Seat 5: kasper744 folded before Flop (didn't bet)
Seat 6: maxsi10 (button) showed [Ad Tc] and won (12457758) with a full house, Fours full of Tens
Seat 8: casey1186 (small blind) folded before Flop
Seat 9: AYoshiK (big blind) folded before Flop


*********** # 513 **************
PokerStars Hand #176682205082: Tournament #2054568934, $20+$2 USD Hold'em No Limit - Level XLVIII (200000/400000) - 2017/10/09 8:36:08 MSK [2017/10/09 1:36:08 ET]
Table '2054568934 624' 9-max Seat #8 is the button
Seat 1: youdri15 (14149464 in chips)
Seat 2: 4time2warp0 (7152986 in chips)
Seat 3: AtilaMoreira (9178738 in chips)
Seat 4: hichnick777 (8505040 in chips)
Seat 5: kasper744 (10494520 in chips)
Seat 6: maxsi10 (12457758 in chips)
Seat 8: casey1186 (20308842 in chips)
Seat 9: AYoshiK (8482652 in chips)
youdri15: posts the ante 40000
4time2warp0: posts the ante 40000
AtilaMoreira: posts the ante 40000
hichnick777: posts the ante 40000
kasper744: posts the ante 40000
maxsi10: posts the ante 40000
casey1186: posts the ante 40000
AYoshiK: posts the ante 40000
AYoshiK: posts small blind 200000
youdri15: posts big blind 400000
*** HOLE CARDS ***
Dealt to hichnick777 [Ad Js]
casey1186 said, "lol"
4time2warp0: folds
AtilaMoreira: folds
hichnick777: raises 432000 to 832000
kasper744: folds
maxsi10: folds
casey1186: folds
AYoshiK: folds
youdri15: folds
Uncalled bet (432000) returned to hichnick777
hichnick777 collected 1320000 from pot
hichnick777: doesn't show hand
*** SUMMARY ***
Total pot 1320000 | Rake 0
Seat 1: youdri15 (big blind) folded before Flop
Seat 2: 4time2warp0 folded before Flop (didn't bet)
Seat 3: AtilaMoreira folded before Flop (didn't bet)
Seat 4: hichnick777 collected (1320000)
Seat 5: kasper744 folded before Flop (didn't bet)
Seat 6: maxsi10 folded before Flop (didn't bet)
Seat 8: casey1186 (button) folded before Flop (didn't bet)
Seat 9: AYoshiK (small blind) folded before Flop


*********** # 514 **************
PokerStars Hand #176682212609: Tournament #2054568934, $20+$2 USD Hold'em No Limit - Level XLVIII (200000/400000) - 2017/10/09 8:36:43 MSK [2017/10/09 1:36:43 ET]
Table '2054568934 624' 9-max Seat #9 is the button
Seat 1: youdri15 (13709464 in chips)
Seat 2: 4time2warp0 (7112986 in chips)
Seat 3: AtilaMoreira (9138738 in chips)
Seat 4: hichnick777 (9385040 in chips)
Seat 5: kasper744 (10454520 in chips)
Seat 6: maxsi10 (12417758 in chips)
Seat 8: casey1186 (20268842 in chips)
Seat 9: AYoshiK (8242652 in chips)
youdri15: posts the ante 40000
4time2warp0: posts the ante 40000
AtilaMoreira: posts the ante 40000
hichnick777: posts the ante 40000
kasper744: posts the ante 40000
maxsi10: posts the ante 40000
casey1186: posts the ante 40000
AYoshiK: posts the ante 40000
youdri15: posts small blind 200000
4time2warp0: posts big blind 400000
*** HOLE CARDS ***
Dealt to hichnick777 [7d Kc]
AtilaMoreira: folds
hichnick777: folds
kasper744: folds
maxsi10: folds
casey1186: raises 800000 to 1200000
AYoshiK: folds
youdri15: folds
4time2warp0: folds
Uncalled bet (800000) returned to casey1186
casey1186 collected 1320000 from pot
casey1186: doesn't show hand
*** SUMMARY ***
Total pot 1320000 | Rake 0
Seat 1: youdri15 (small blind) folded before Flop
Seat 2: 4time2warp0 (big blind) folded before Flop
Seat 3: AtilaMoreira folded before Flop (didn't bet)
Seat 4: hichnick777 folded before Flop (didn't bet)
Seat 5: kasper744 folded before Flop (didn't bet)
Seat 6: maxsi10 folded before Flop (didn't bet)
Seat 8: casey1186 collected (1320000)
Seat 9: AYoshiK (button) folded before Flop (didn't bet)


*********** # 515 **************
PokerStars Hand #176682218882: Tournament #2054568934, $20+$2 USD Hold'em No Limit - Level XLVIII (200000/400000) - 2017/10/09 8:37:12 MSK [2017/10/09 1:37:12 ET]
Table '2054568934 624' 9-max Seat #1 is the button
Seat 1: youdri15 (13469464 in chips)
Seat 2: 4time2warp0 (6672986 in chips)
Seat 3: AtilaMoreira (9098738 in chips)
Seat 4: hichnick777 (9345040 in chips)
Seat 5: kasper744 (10414520 in chips)
Seat 6: maxsi10 (12377758 in chips)
Seat 8: casey1186 (21148842 in chips)
Seat 9: AYoshiK (8202652 in chips)
youdri15: posts the ante 40000
4time2warp0: posts the ante 40000
AtilaMoreira: posts the ante 40000
hichnick777: posts the ante 40000
kasper744: posts the ante 40000
maxsi10: posts the ante 40000
casey1186: posts the ante 40000
AYoshiK: posts the ante 40000
4time2warp0: posts small blind 200000
AtilaMoreira: posts big blind 400000
*** HOLE CARDS ***
Dealt to hichnick777 [8s 9c]
hichnick777: folds
kasper744: folds
maxsi10: folds
casey1186: folds
AYoshiK: raises 424000 to 824000
youdri15: folds
4time2warp0: folds
AtilaMoreira: raises 8234738 to 9058738 and is all-in
AYoshiK: folds
Uncalled bet (8234738) returned to AtilaMoreira
AtilaMoreira collected 2168000 from pot
*** SUMMARY ***
Total pot 2168000 | Rake 0
Seat 1: youdri15 (button) folded before Flop (didn't bet)
Seat 2: 4time2warp0 (small blind) folded before Flop
Seat 3: AtilaMoreira (big blind) collected (2168000)
Seat 4: hichnick777 folded before Flop (didn't bet)
Seat 5: kasper744 folded before Flop (didn't bet)
Seat 6: maxsi10 folded before Flop (didn't bet)
Seat 8: casey1186 folded before Flop (didn't bet)
Seat 9: AYoshiK folded before Flop


*********** # 516 **************
PokerStars Hand #176682228405: Tournament #2054568934, $20+$2 USD Hold'em No Limit - Level XLVIII (200000/400000) - 2017/10/09 8:37:57 MSK [2017/10/09 1:37:57 ET]
Table '2054568934 624' 9-max Seat #2 is the button
Seat 1: youdri15 (13429464 in chips)
Seat 2: 4time2warp0 (6432986 in chips)
Seat 3: AtilaMoreira (10402738 in chips)
Seat 4: hichnick777 (9305040 in chips)
Seat 5: kasper744 (10374520 in chips)
Seat 6: maxsi10 (12337758 in chips)
Seat 8: casey1186 (21108842 in chips)
Seat 9: AYoshiK (7338652 in chips)
youdri15: posts the ante 40000
4time2warp0: posts the ante 40000
AtilaMoreira: posts the ante 40000
hichnick777: posts the ante 40000
kasper744: posts the ante 40000
maxsi10: posts the ante 40000
casey1186: posts the ante 40000
AYoshiK: posts the ante 40000
AtilaMoreira: posts small blind 200000
hichnick777: posts big blind 400000
*** HOLE CARDS ***
Dealt to hichnick777 [2h Qs]
kasper744: raises 9934520 to 10334520 and is all-in
maxsi10: folds
casey1186: folds
AYoshiK: folds
youdri15: folds
4time2warp0: calls 6392986 and is all-in
AtilaMoreira: folds
hichnick777: folds
Uncalled bet (3941534) returned to kasper744
*** FLOP *** [5d Ks Kc]
*** TURN *** [5d Ks Kc] [4d]
*** RIVER *** [5d Ks Kc 4d] [Qd]
*** SHOW DOWN ***
kasper744: shows [Qh As] (two pair, Kings and Queens)
4time2warp0: shows [Ah Kh] (three of a kind, Kings)
4time2warp0 collected 13705972 from pot
*** SUMMARY ***
Total pot 13705972 | Rake 0
Board [5d Ks Kc 4d Qd]
Seat 1: youdri15 folded before Flop (didn't bet)
Seat 2: 4time2warp0 (button) showed [Ah Kh] and won (13705972) with three of a kind, Kings
Seat 3: AtilaMoreira (small blind) folded before Flop
Seat 4: hichnick777 (big blind) folded before Flop
Seat 5: kasper744 showed [Qh As] and lost with two pair, Kings and Queens
Seat 6: maxsi10 folded before Flop (didn't bet)
Seat 8: casey1186 folded before Flop (didn't bet)
Seat 9: AYoshiK folded before Flop (didn't bet)


*********** # 517 **************
PokerStars Hand #176682236986: Tournament #2054568934, $20+$2 USD Hold'em No Limit - Level XLVIII (200000/400000) - 2017/10/09 8:38:36 MSK [2017/10/09 1:38:36 ET]
Table '2054568934 624' 9-max Seat #3 is the button
Seat 1: youdri15 (13389464 in chips)
Seat 2: 4time2warp0 (13705972 in chips)
Seat 3: AtilaMoreira (10162738 in chips)
Seat 4: hichnick777 (8865040 in chips)
Seat 5: kasper744 (3941534 in chips)
Seat 6: maxsi10 (12297758 in chips)
Seat 8: casey1186 (21068842 in chips)
Seat 9: AYoshiK (7298652 in chips)
youdri15: posts the ante 40000
4time2warp0: posts the ante 40000
AtilaMoreira: posts the ante 40000
hichnick777: posts the ante 40000
kasper744: posts the ante 40000
maxsi10: posts the ante 40000
casey1186: posts the ante 40000
AYoshiK: posts the ante 40000
hichnick777: posts small blind 200000
kasper744: posts big blind 400000
*** HOLE CARDS ***
Dealt to hichnick777 [4h 2d]
maxsi10: folds
casey1186: folds
AYoshiK: folds
youdri15: folds
4time2warp0: folds
AtilaMoreira: folds
hichnick777: folds
Uncalled bet (200000) returned to kasper744
kasper744 collected 720000 from pot
kasper744: doesn't show hand
*** SUMMARY ***
Total pot 720000 | Rake 0
Seat 1: youdri15 folded before Flop (didn't bet)
Seat 2: 4time2warp0 folded before Flop (didn't bet)
Seat 3: AtilaMoreira (button) folded before Flop (didn't bet)
Seat 4: hichnick777 (small blind) folded before Flop
Seat 5: kasper744 (big blind) collected (720000)
Seat 6: maxsi10 folded before Flop (didn't bet)
Seat 8: casey1186 folded before Flop (didn't bet)
Seat 9: AYoshiK folded before Flop (didn't bet)


*********** # 518 **************
PokerStars Hand #176682242924: Tournament #2054568934, $20+$2 USD Hold'em No Limit - Level XLVIII (200000/400000) - 2017/10/09 8:39:04 MSK [2017/10/09 1:39:04 ET]
Table '2054568934 624' 9-max Seat #4 is the button
Seat 1: youdri15 (13349464 in chips)
Seat 2: 4time2warp0 (13665972 in chips)
Seat 3: AtilaMoreira (10122738 in chips)
Seat 4: hichnick777 (8625040 in chips)
Seat 5: kasper744 (4421534 in chips)
Seat 6: maxsi10 (12257758 in chips)
Seat 8: casey1186 (21028842 in chips)
Seat 9: AYoshiK (7258652 in chips)
youdri15: posts the ante 40000
4time2warp0: posts the ante 40000
AtilaMoreira: posts the ante 40000
hichnick777: posts the ante 40000
kasper744: posts the ante 40000
maxsi10: posts the ante 40000
casey1186: posts the ante 40000
AYoshiK: posts the ante 40000
kasper744: posts small blind 200000
maxsi10: posts big blind 400000
*** HOLE CARDS ***
Dealt to hichnick777 [5c 9c]
casey1186: calls 400000
AYoshiK: folds
youdri15: folds
4time2warp0: folds
AtilaMoreira: folds
hichnick777: folds
kasper744: calls 200000
maxsi10: checks
*** FLOP *** [Js 2h Td]
kasper744: checks
maxsi10: checks
casey1186: bets 1520000
kasper744: calls 1520000
maxsi10: folds
*** TURN *** [Js 2h Td] [Th]
kasper744: bets 2461534 and is all-in
casey1186: folds
Uncalled bet (2461534) returned to kasper744
kasper744 collected 4560000 from pot
kasper744: doesn't show hand
*** SUMMARY ***
Total pot 4560000 | Rake 0
Board [Js 2h Td Th]
Seat 1: youdri15 folded before Flop (didn't bet)
Seat 2: 4time2warp0 folded before Flop (didn't bet)
Seat 3: AtilaMoreira folded before Flop (didn't bet)
Seat 4: hichnick777 (button) folded before Flop (didn't bet)
Seat 5: kasper744 (small blind) collected (4560000)
Seat 6: maxsi10 (big blind) folded on the Flop
Seat 8: casey1186 folded on the Turn
Seat 9: AYoshiK folded before Flop (didn't bet)


*********** # 519 **************
PokerStars Hand #176682255275: Tournament #2054568934, $20+$2 USD Hold'em No Limit - Level XLVIII (200000/400000) - 2017/10/09 8:40:01 MSK [2017/10/09 1:40:01 ET]
Table '2054568934 624' 9-max Seat #5 is the button
Seat 1: youdri15 (13309464 in chips)
Seat 2: 4time2warp0 (13625972 in chips)
Seat 3: AtilaMoreira (10082738 in chips)
Seat 4: hichnick777 (8585040 in chips)
Seat 5: kasper744 (7021534 in chips)
Seat 6: maxsi10 (11817758 in chips)
Seat 8: casey1186 (19068842 in chips)
Seat 9: AYoshiK (7218652 in chips)
youdri15: posts the ante 40000
4time2warp0: posts the ante 40000
AtilaMoreira: posts the ante 40000
hichnick777: posts the ante 40000
kasper744: posts the ante 40000
maxsi10: posts the ante 40000
casey1186: posts the ante 40000
AYoshiK: posts the ante 40000
maxsi10: posts small blind 200000
casey1186: posts big blind 400000
*** HOLE CARDS ***
Dealt to hichnick777 [4c 2d]
AYoshiK: folds
youdri15: raises 600000 to 1000000
4time2warp0: folds
AtilaMoreira: folds
hichnick777: folds
kasper744: calls 1000000
maxsi10: folds
casey1186: folds
*** FLOP *** [Td 6s 9s]
youdri15: checks
kasper744: bets 800000
youdri15: calls 800000
*** TURN *** [Td 6s 9s] [Jc]
youdri15: checks
kasper744: checks
*** RIVER *** [Td 6s 9s Jc] [7d]
youdri15: checks
kasper744: bets 2000000
youdri15: folds
Uncalled bet (2000000) returned to kasper744
kasper744 collected 4520000 from pot
kasper744: doesn't show hand
*** SUMMARY ***
Total pot 4520000 | Rake 0
Board [Td 6s 9s Jc 7d]
Seat 1: youdri15 folded on the River
Seat 2: 4time2warp0 folded before Flop (didn't bet)
Seat 3: AtilaMoreira folded before Flop (didn't bet)
Seat 4: hichnick777 folded before Flop (didn't bet)
Seat 5: kasper744 (button) collected (4520000)
Seat 6: maxsi10 (small blind) folded before Flop
Seat 8: casey1186 (big blind) folded before Flop
Seat 9: AYoshiK folded before Flop (didn't bet)


*********** # 520 **************
PokerStars Hand #176682270353: Tournament #2054568934, $20+$2 USD Hold'em No Limit - Level XLVIII (200000/400000) - 2017/10/09 8:41:10 MSK [2017/10/09 1:41:10 ET]
Table '2054568934 624' 9-max Seat #6 is the button
Seat 1: youdri15 (11469464 in chips)
Seat 2: 4time2warp0 (13585972 in chips)
Seat 3: AtilaMoreira (10042738 in chips)
Seat 4: hichnick777 (8545040 in chips)
Seat 5: kasper744 (9701534 in chips)
Seat 6: maxsi10 (11577758 in chips)
Seat 8: casey1186 (18628842 in chips)
Seat 9: AYoshiK (7178652 in chips)
youdri15: posts the ante 40000
4time2warp0: posts the ante 40000
AtilaMoreira: posts the ante 40000
hichnick777: posts the ante 40000
kasper744: posts the ante 40000
maxsi10: posts the ante 40000
casey1186: posts the ante 40000
AYoshiK: posts the ante 40000
casey1186: posts small blind 200000
AYoshiK: posts big blind 400000
*** HOLE CARDS ***
Dealt to hichnick777 [Qc Jc]
youdri15: folds
4time2warp0: folds
AtilaMoreira: folds
hichnick777: raises 432000 to 832000
kasper744: folds
maxsi10: folds
casey1186: folds
AYoshiK: folds
Uncalled bet (432000) returned to hichnick777
hichnick777 collected 1320000 from pot
hichnick777: doesn't show hand
*** SUMMARY ***
Total pot 1320000 | Rake 0
Seat 1: youdri15 folded before Flop (didn't bet)
Seat 2: 4time2warp0 folded before Flop (didn't bet)
Seat 3: AtilaMoreira folded before Flop (didn't bet)
Seat 4: hichnick777 collected (1320000)
Seat 5: kasper744 folded before Flop (didn't bet)
Seat 6: maxsi10 (button) folded before Flop (didn't bet)
Seat 8: casey1186 (small blind) folded before Flop
Seat 9: AYoshiK (big blind) folded before Flop


*********** # 521 **************
PokerStars Hand #176682276573: Tournament #2054568934, $20+$2 USD Hold'em No Limit - Level XLVIII (200000/400000) - 2017/10/09 8:41:39 MSK [2017/10/09 1:41:39 ET]
Table '2054568934 624' 9-max Seat #8 is the button
Seat 1: youdri15 (11429464 in chips)
Seat 2: 4time2warp0 (13545972 in chips)
Seat 3: AtilaMoreira (10002738 in chips)
Seat 4: hichnick777 (9425040 in chips)
Seat 5: kasper744 (9661534 in chips)
Seat 6: maxsi10 (11537758 in chips)
Seat 8: casey1186 (18388842 in chips)
Seat 9: AYoshiK (6738652 in chips)
youdri15: posts the ante 40000
4time2warp0: posts the ante 40000
AtilaMoreira: posts the ante 40000
hichnick777: posts the ante 40000
kasper744: posts the ante 40000
maxsi10: posts the ante 40000
casey1186: posts the ante 40000
AYoshiK: posts the ante 40000
AYoshiK: posts small blind 200000
youdri15: posts big blind 400000
*** HOLE CARDS ***
Dealt to hichnick777 [Jd Tc]
4time2warp0: folds
AtilaMoreira: folds
hichnick777: folds
kasper744: folds
maxsi10: folds
casey1186: raises 800000 to 1200000
AYoshiK: folds
youdri15: calls 800000
*** FLOP *** [6s Ad 5h]
youdri15: bets 2000000
casey1186: calls 2000000
*** TURN *** [6s Ad 5h] [8d]
youdri15: checks
casey1186: bets 3460000
youdri15: folds
Uncalled bet (3460000) returned to casey1186
casey1186 collected 6920000 from pot
casey1186: shows [6h]
*** SUMMARY ***
Total pot 6920000 | Rake 0
Board [6s Ad 5h 8d]
Seat 1: youdri15 (big blind) folded on the Turn
Seat 2: 4time2warp0 folded before Flop (didn't bet)
Seat 3: AtilaMoreira folded before Flop (didn't bet)
Seat 4: hichnick777 folded before Flop (didn't bet)
Seat 5: kasper744 folded before Flop (didn't bet)
Seat 6: maxsi10 folded before Flop (didn't bet)
Seat 8: casey1186 (button) collected (6920000)
Seat 9: AYoshiK (small blind) folded before Flop


*********** # 522 **************
PokerStars Hand #176682285513: Tournament #2054568934, $20+$2 USD Hold'em No Limit - Level XLVIII (200000/400000) - 2017/10/09 8:42:21 MSK [2017/10/09 1:42:21 ET]
Table '2054568934 624' 9-max Seat #9 is the button
Seat 1: youdri15 (8189464 in chips)
Seat 2: 4time2warp0 (13505972 in chips)
Seat 3: AtilaMoreira (9962738 in chips)
Seat 4: hichnick777 (9385040 in chips)
Seat 5: kasper744 (9621534 in chips)
Seat 6: maxsi10 (11497758 in chips)
Seat 8: casey1186 (22068842 in chips)
Seat 9: AYoshiK (6498652 in chips)
youdri15: posts the ante 40000
4time2warp0: posts the ante 40000
AtilaMoreira: posts the ante 40000
hichnick777: posts the ante 40000
kasper744: posts the ante 40000
maxsi10: posts the ante 40000
casey1186: posts the ante 40000
AYoshiK: posts the ante 40000
youdri15: posts small blind 200000
4time2warp0: posts big blind 400000
*** HOLE CARDS ***
Dealt to hichnick777 [8h 3h]
AtilaMoreira: folds
hichnick777: folds
kasper744: folds
maxsi10: folds
casey1186: folds
AYoshiK: folds
youdri15: folds
Uncalled bet (200000) returned to 4time2warp0
4time2warp0 collected 720000 from pot
4time2warp0: doesn't show hand
*** SUMMARY ***
Total pot 720000 | Rake 0
Seat 1: youdri15 (small blind) folded before Flop
Seat 2: 4time2warp0 (big blind) collected (720000)
Seat 3: AtilaMoreira folded before Flop (didn't bet)
Seat 4: hichnick777 folded before Flop (didn't bet)
Seat 5: kasper744 folded before Flop (didn't bet)
Seat 6: maxsi10 folded before Flop (didn't bet)
Seat 8: casey1186 folded before Flop (didn't bet)
Seat 9: AYoshiK (button) folded before Flop (didn't bet)


*********** # 523 **************
PokerStars Hand #176682288321: Tournament #2054568934, $20+$2 USD Hold'em No Limit - Level XLVIII (200000/400000) - 2017/10/09 8:42:34 MSK [2017/10/09 1:42:34 ET]
Table '2054568934 624' 9-max Seat #1 is the button
Seat 1: youdri15 (7949464 in chips)
Seat 2: 4time2warp0 (13985972 in chips)
Seat 3: AtilaMoreira (9922738 in chips)
Seat 4: hichnick777 (9345040 in chips)
Seat 5: kasper744 (9581534 in chips)
Seat 6: maxsi10 (11457758 in chips)
Seat 8: casey1186 (22028842 in chips)
Seat 9: AYoshiK (6458652 in chips)
youdri15: posts the ante 40000
4time2warp0: posts the ante 40000
AtilaMoreira: posts the ante 40000
hichnick777: posts the ante 40000
kasper744: posts the ante 40000
maxsi10: posts the ante 40000
casey1186: posts the ante 40000
AYoshiK: posts the ante 40000
4time2warp0: posts small blind 200000
AtilaMoreira: posts big blind 400000
*** HOLE CARDS ***
Dealt to hichnick777 [6s 8s]
hichnick777: folds
kasper744: folds
maxsi10: folds
casey1186: folds
AYoshiK: raises 424000 to 824000
youdri15: folds
4time2warp0: folds
AtilaMoreira: folds
Uncalled bet (424000) returned to AYoshiK
AYoshiK collected 1320000 from pot
AYoshiK: doesn't show hand
*** SUMMARY ***
Total pot 1320000 | Rake 0
Seat 1: youdri15 (button) folded before Flop (didn't bet)
Seat 2: 4time2warp0 (small blind) folded before Flop
Seat 3: AtilaMoreira (big blind) folded before Flop
Seat 4: hichnick777 folded before Flop (didn't bet)
Seat 5: kasper744 folded before Flop (didn't bet)
Seat 6: maxsi10 folded before Flop (didn't bet)
Seat 8: casey1186 folded before Flop (didn't bet)
Seat 9: AYoshiK collected (1320000)


*********** # 524 **************
PokerStars Hand #176682294158: Tournament #2054568934, $20+$2 USD Hold'em No Limit - Level XLVIII (200000/400000) - 2017/10/09 8:43:01 MSK [2017/10/09 1:43:01 ET]
Table '2054568934 624' 9-max Seat #2 is the button
Seat 1: youdri15 (7909464 in chips)
Seat 2: 4time2warp0 (13745972 in chips)
Seat 3: AtilaMoreira (9482738 in chips)
Seat 4: hichnick777 (9305040 in chips)
Seat 5: kasper744 (9541534 in chips)
Seat 6: maxsi10 (11417758 in chips)
Seat 8: casey1186 (21988842 in chips)
Seat 9: AYoshiK (7338652 in chips)
youdri15: posts the ante 40000
4time2warp0: posts the ante 40000
AtilaMoreira: posts the ante 40000
hichnick777: posts the ante 40000
kasper744: posts the ante 40000
maxsi10: posts the ante 40000
casey1186: posts the ante 40000
AYoshiK: posts the ante 40000
AtilaMoreira: posts small blind 200000
hichnick777: posts big blind 400000
*** HOLE CARDS ***
Dealt to hichnick777 [Kd 4c]
kasper744: folds
maxsi10: folds
casey1186: folds
AYoshiK: folds
youdri15: folds
4time2warp0: folds
AtilaMoreira: folds
Uncalled bet (200000) returned to hichnick777
hichnick777 collected 720000 from pot
hichnick777: doesn't show hand
*** SUMMARY ***
Total pot 720000 | Rake 0
Seat 1: youdri15 folded before Flop (didn't bet)
Seat 2: 4time2warp0 (button) folded before Flop (didn't bet)
Seat 3: AtilaMoreira (small blind) folded before Flop
Seat 4: hichnick777 (big blind) collected (720000)
Seat 5: kasper744 folded before Flop (didn't bet)
Seat 6: maxsi10 folded before Flop (didn't bet)
Seat 8: casey1186 folded before Flop (didn't bet)
Seat 9: AYoshiK folded before Flop (didn't bet)


*********** # 525 **************
PokerStars Hand #176682297136: Tournament #2054568934, $20+$2 USD Hold'em No Limit - Level XLVIII (200000/400000) - 2017/10/09 8:43:15 MSK [2017/10/09 1:43:15 ET]
Table '2054568934 624' 9-max Seat #3 is the button
Seat 1: youdri15 (7869464 in chips)
Seat 2: 4time2warp0 (13705972 in chips)
Seat 3: AtilaMoreira (9242738 in chips)
Seat 4: hichnick777 (9785040 in chips)
Seat 5: kasper744 (9501534 in chips)
Seat 6: maxsi10 (11377758 in chips)
Seat 8: casey1186 (21948842 in chips)
Seat 9: AYoshiK (7298652 in chips)
youdri15: posts the ante 40000
4time2warp0: posts the ante 40000
AtilaMoreira: posts the ante 40000
hichnick777: posts the ante 40000
kasper744: posts the ante 40000
maxsi10: posts the ante 40000
casey1186: posts the ante 40000
AYoshiK: posts the ante 40000
hichnick777: posts small blind 200000
kasper744: posts big blind 400000
*** HOLE CARDS ***
Dealt to hichnick777 [Qc Jc]
maxsi10: folds
casey1186: folds
AYoshiK: folds
youdri15: folds
4time2warp0: folds
AtilaMoreira: folds
hichnick777: raises 500000 to 900000
kasper744: raises 8561534 to 9461534 and is all-in
hichnick777: folds
Uncalled bet (8561534) returned to kasper744
kasper744 collected 2120000 from pot
kasper744: doesn't show hand
*** SUMMARY ***
Total pot 2120000 | Rake 0
Seat 1: youdri15 folded before Flop (didn't bet)
Seat 2: 4time2warp0 folded before Flop (didn't bet)
Seat 3: AtilaMoreira (button) folded before Flop (didn't bet)
Seat 4: hichnick777 (small blind) folded before Flop
Seat 5: kasper744 (big blind) collected (2120000)
Seat 6: maxsi10 folded before Flop (didn't bet)
Seat 8: casey1186 folded before Flop (didn't bet)
Seat 9: AYoshiK folded before Flop (didn't bet)


*********** # 526 **************
PokerStars Hand #176682308536: Tournament #2054568934, $20+$2 USD Hold'em No Limit - Level XLVIII (200000/400000) - 2017/10/09 8:44:08 MSK [2017/10/09 1:44:08 ET]
Table '2054568934 624' 9-max Seat #4 is the button
Seat 1: youdri15 (7829464 in chips)
Seat 2: 4time2warp0 (13665972 in chips)
Seat 3: AtilaMoreira (9202738 in chips)
Seat 4: hichnick777 (8845040 in chips)
Seat 5: kasper744 (10681534 in chips)
Seat 6: maxsi10 (11337758 in chips)
Seat 8: casey1186 (21908842 in chips)
Seat 9: AYoshiK (7258652 in chips)
youdri15: posts the ante 40000
4time2warp0: posts the ante 40000
AtilaMoreira: posts the ante 40000
hichnick777: posts the ante 40000
kasper744: posts the ante 40000
maxsi10: posts the ante 40000
casey1186: posts the ante 40000
AYoshiK: posts the ante 40000
kasper744: posts small blind 200000
maxsi10: posts big blind 400000
*** HOLE CARDS ***
Dealt to hichnick777 [3s 7s]
casey1186: folds
AYoshiK: raises 424000 to 824000
youdri15: folds
4time2warp0: folds
AtilaMoreira: folds
hichnick777: folds
kasper744: folds
maxsi10: folds
Uncalled bet (424000) returned to AYoshiK
AYoshiK collected 1320000 from pot
AYoshiK: doesn't show hand
*** SUMMARY ***
Total pot 1320000 | Rake 0
Seat 1: youdri15 folded before Flop (didn't bet)
Seat 2: 4time2warp0 folded before Flop (didn't bet)
Seat 3: AtilaMoreira folded before Flop (didn't bet)
Seat 4: hichnick777 (button) folded before Flop (didn't bet)
Seat 5: kasper744 (small blind) folded before Flop
Seat 6: maxsi10 (big blind) folded before Flop
Seat 8: casey1186 folded before Flop (didn't bet)
Seat 9: AYoshiK collected (1320000)


*********** # 527 **************
PokerStars Hand #176682315504: Tournament #2054568934, $20+$2 USD Hold'em No Limit - Level XLVIII (200000/400000) - 2017/10/09 8:44:41 MSK [2017/10/09 1:44:41 ET]
Table '2054568934 624' 9-max Seat #5 is the button
Seat 1: youdri15 (7789464 in chips)
Seat 2: 4time2warp0 (13625972 in chips)
Seat 3: AtilaMoreira (9162738 in chips)
Seat 4: hichnick777 (8805040 in chips)
Seat 5: kasper744 (10441534 in chips)
Seat 6: maxsi10 (10897758 in chips)
Seat 8: casey1186 (21868842 in chips)
Seat 9: AYoshiK (8138652 in chips)
youdri15: posts the ante 40000
4time2warp0: posts the ante 40000
AtilaMoreira: posts the ante 40000
hichnick777: posts the ante 40000
kasper744: posts the ante 40000
maxsi10: posts the ante 40000
casey1186: posts the ante 40000
AYoshiK: posts the ante 40000
maxsi10: posts small blind 200000
casey1186: posts big blind 400000
*** HOLE CARDS ***
Dealt to hichnick777 [6c 5d]
AYoshiK: folds
youdri15: folds
4time2warp0: folds
AtilaMoreira: raises 400000 to 800000
hichnick777: folds
kasper744: calls 800000
maxsi10: folds
casey1186: calls 400000
*** FLOP *** [9d Ks 3s]
casey1186: checks
AtilaMoreira: bets 765000
kasper744: calls 765000
casey1186: folds
*** TURN *** [9d Ks 3s] [9c]
AtilaMoreira: checks
kasper744: bets 1000000
AtilaMoreira: folds
Uncalled bet (1000000) returned to kasper744
kasper744 collected 4450000 from pot
kasper744: doesn't show hand
*** SUMMARY ***
Total pot 4450000 | Rake 0
Board [9d Ks 3s 9c]
Seat 1: youdri15 folded before Flop (didn't bet)
Seat 2: 4time2warp0 folded before Flop (didn't bet)
Seat 3: AtilaMoreira folded on the Turn
Seat 4: hichnick777 folded before Flop (didn't bet)
Seat 5: kasper744 (button) collected (4450000)
Seat 6: maxsi10 (small blind) folded before Flop
Seat 8: casey1186 (big blind) folded on the Flop
Seat 9: AYoshiK folded before Flop (didn't bet)


*********** # 528 **************
PokerStars Hand #176682338082: Tournament #2054568934, $20+$2 USD Hold'em No Limit - Level XLIX (250000/500000) - 2017/10/09 8:46:26 MSK [2017/10/09 1:46:26 ET]
Table '2054568934 624' 9-max Seat #6 is the button
Seat 1: youdri15 (7749464 in chips)
Seat 2: 4time2warp0 (13585972 in chips)
Seat 3: AtilaMoreira (7557738 in chips)
Seat 4: hichnick777 (8765040 in chips)
Seat 5: kasper744 (13286534 in chips)
Seat 6: maxsi10 (10657758 in chips)
Seat 8: casey1186 (21028842 in chips)
Seat 9: AYoshiK (8098652 in chips)
youdri15: posts the ante 50000
4time2warp0: posts the ante 50000
AtilaMoreira: posts the ante 50000
hichnick777: posts the ante 50000
kasper744: posts the ante 50000
maxsi10: posts the ante 50000
casey1186: posts the ante 50000
AYoshiK: posts the ante 50000
casey1186: posts small blind 250000
AYoshiK: posts big blind 500000
*** HOLE CARDS ***
Dealt to hichnick777 [4s 9h]
youdri15: folds
4time2warp0: folds
AtilaMoreira: folds
hichnick777: folds
kasper744: folds
maxsi10: folds
casey1186: raises 1000000 to 1500000
AYoshiK: folds
Uncalled bet (1000000) returned to casey1186
casey1186 collected 1400000 from pot
casey1186: doesn't show hand
*** SUMMARY ***
Total pot 1400000 | Rake 0
Seat 1: youdri15 folded before Flop (didn't bet)
Seat 2: 4time2warp0 folded before Flop (didn't bet)
Seat 3: AtilaMoreira folded before Flop (didn't bet)
Seat 4: hichnick777 folded before Flop (didn't bet)
Seat 5: kasper744 folded before Flop (didn't bet)
Seat 6: maxsi10 (button) folded before Flop (didn't bet)
Seat 8: casey1186 (small blind) collected (1400000)
Seat 9: AYoshiK (big blind) folded before Flop


*********** # 529 **************
PokerStars Hand #176682343338: Tournament #2054568934, $20+$2 USD Hold'em No Limit - Level XLIX (250000/500000) - 2017/10/09 8:46:50 MSK [2017/10/09 1:46:50 ET]
Table '2054568934 624' 9-max Seat #8 is the button
Seat 1: youdri15 (7699464 in chips)
Seat 2: 4time2warp0 (13535972 in chips)
Seat 3: AtilaMoreira (7507738 in chips)
Seat 4: hichnick777 (8715040 in chips)
Seat 5: kasper744 (13236534 in chips)
Seat 6: maxsi10 (10607758 in chips)
Seat 8: casey1186 (21878842 in chips)
Seat 9: AYoshiK (7548652 in chips)
youdri15: posts the ante 50000
4time2warp0: posts the ante 50000
AtilaMoreira: posts the ante 50000
hichnick777: posts the ante 50000
kasper744: posts the ante 50000
maxsi10: posts the ante 50000
casey1186: posts the ante 50000
AYoshiK: posts the ante 50000
AYoshiK: posts small blind 250000
youdri15: posts big blind 500000
*** HOLE CARDS ***
Dealt to hichnick777 [Ts Jh]
4time2warp0: folds
AtilaMoreira: folds
hichnick777: folds
kasper744: folds
maxsi10: folds
casey1186: folds
AYoshiK: folds
Uncalled bet (250000) returned to youdri15
youdri15 collected 900000 from pot
youdri15: doesn't show hand
*** SUMMARY ***
Total pot 900000 | Rake 0
Seat 1: youdri15 (big blind) collected (900000)
Seat 2: 4time2warp0 folded before Flop (didn't bet)
Seat 3: AtilaMoreira folded before Flop (didn't bet)
Seat 4: hichnick777 folded before Flop (didn't bet)
Seat 5: kasper744 folded before Flop (didn't bet)
Seat 6: maxsi10 folded before Flop (didn't bet)
Seat 8: casey1186 (button) folded before Flop (didn't bet)
Seat 9: AYoshiK (small blind) folded before Flop


*********** # 530 **************
PokerStars Hand #176682346975: Tournament #2054568934, $20+$2 USD Hold'em No Limit - Level XLIX (250000/500000) - 2017/10/09 8:47:07 MSK [2017/10/09 1:47:07 ET]
Table '2054568934 624' 9-max Seat #9 is the button
Seat 1: youdri15 (8299464 in chips)
Seat 2: 4time2warp0 (13485972 in chips)
Seat 3: AtilaMoreira (7457738 in chips)
Seat 4: hichnick777 (8665040 in chips)
Seat 5: kasper744 (13186534 in chips)
Seat 6: maxsi10 (10557758 in chips)
Seat 8: casey1186 (21828842 in chips)
Seat 9: AYoshiK (7248652 in chips)
youdri15: posts the ante 50000
4time2warp0: posts the ante 50000
AtilaMoreira: posts the ante 50000
hichnick777: posts the ante 50000
kasper744: posts the ante 50000
maxsi10: posts the ante 50000
casey1186: posts the ante 50000
AYoshiK: posts the ante 50000
youdri15: posts small blind 250000
4time2warp0: posts big blind 500000
*** HOLE CARDS ***
Dealt to hichnick777 [5s 4s]
AtilaMoreira: folds
hichnick777: folds
kasper744: folds
maxsi10: folds
casey1186: folds
AYoshiK: folds
youdri15: raises 750000 to 1250000
4time2warp0: folds
Uncalled bet (750000) returned to youdri15
youdri15 collected 1400000 from pot
youdri15: doesn't show hand
*** SUMMARY ***
Total pot 1400000 | Rake 0
Seat 1: youdri15 (small blind) collected (1400000)
Seat 2: 4time2warp0 (big blind) folded before Flop
Seat 3: AtilaMoreira folded before Flop (didn't bet)
Seat 4: hichnick777 folded before Flop (didn't bet)
Seat 5: kasper744 folded before Flop (didn't bet)
Seat 6: maxsi10 folded before Flop (didn't bet)
Seat 8: casey1186 folded before Flop (didn't bet)
Seat 9: AYoshiK (button) folded before Flop (didn't bet)


*********** # 531 **************
PokerStars Hand #176682354403: Tournament #2054568934, $20+$2 USD Hold'em No Limit - Level XLIX (250000/500000) - 2017/10/09 8:47:42 MSK [2017/10/09 1:47:42 ET]
Table '2054568934 624' 9-max Seat #1 is the button
Seat 1: youdri15 (9149464 in chips)
Seat 2: 4time2warp0 (12935972 in chips)
Seat 3: AtilaMoreira (7407738 in chips)
Seat 4: hichnick777 (8615040 in chips)
Seat 5: kasper744 (13136534 in chips)
Seat 6: maxsi10 (10507758 in chips)
Seat 8: casey1186 (21778842 in chips)
Seat 9: AYoshiK (7198652 in chips)
youdri15: posts the ante 50000
4time2warp0: posts the ante 50000
AtilaMoreira: posts the ante 50000
hichnick777: posts the ante 50000
kasper744: posts the ante 50000
maxsi10: posts the ante 50000
casey1186: posts the ante 50000
AYoshiK: posts the ante 50000
4time2warp0: posts small blind 250000
AtilaMoreira: posts big blind 500000
*** HOLE CARDS ***
Dealt to hichnick777 [Qs 3c]
hichnick777: folds
kasper744: folds
maxsi10: folds
casey1186: folds
AYoshiK: folds
youdri15: raises 500000 to 1000000
4time2warp0: folds
AtilaMoreira: calls 500000
*** FLOP *** [Td 8d Ac]
AtilaMoreira: checks
youdri15: checks
*** TURN *** [Td 8d Ac] [Kc]
AtilaMoreira: checks
youdri15: checks
*** RIVER *** [Td 8d Ac Kc] [Ts]
AtilaMoreira: checks
youdri15: bets 1500000
AtilaMoreira: folds
Uncalled bet (1500000) returned to youdri15
youdri15 collected 2650000 from pot
youdri15: doesn't show hand
*** SUMMARY ***
Total pot 2650000 | Rake 0
Board [Td 8d Ac Kc Ts]
Seat 1: youdri15 (button) collected (2650000)
Seat 2: 4time2warp0 (small blind) folded before Flop
Seat 3: AtilaMoreira (big blind) folded on the River
Seat 4: hichnick777 folded before Flop (didn't bet)
Seat 5: kasper744 folded before Flop (didn't bet)
Seat 6: maxsi10 folded before Flop (didn't bet)
Seat 8: casey1186 folded before Flop (didn't bet)
Seat 9: AYoshiK folded before Flop (didn't bet)


*********** # 532 **************
PokerStars Hand #176682365599: Tournament #2054568934, $20+$2 USD Hold'em No Limit - Level XLIX (250000/500000) - 2017/10/09 8:48:34 MSK [2017/10/09 1:48:34 ET]
Table '2054568934 624' 9-max Seat #2 is the button
Seat 1: youdri15 (10749464 in chips)
Seat 2: 4time2warp0 (12635972 in chips)
Seat 3: AtilaMoreira (6357738 in chips)
Seat 4: hichnick777 (8565040 in chips)
Seat 5: kasper744 (13086534 in chips)
Seat 6: maxsi10 (10457758 in chips)
Seat 8: casey1186 (21728842 in chips)
Seat 9: AYoshiK (7148652 in chips)
youdri15: posts the ante 50000
4time2warp0: posts the ante 50000
AtilaMoreira: posts the ante 50000
hichnick777: posts the ante 50000
kasper744: posts the ante 50000
maxsi10: posts the ante 50000
casey1186: posts the ante 50000
AYoshiK: posts the ante 50000
AtilaMoreira: posts small blind 250000
hichnick777: posts big blind 500000
*** HOLE CARDS ***
Dealt to hichnick777 [6d Qc]
kasper744: folds
maxsi10: folds
casey1186: folds
AYoshiK: raises 530000 to 1030000
youdri15: folds
4time2warp0: folds
AtilaMoreira: folds
hichnick777: folds
Uncalled bet (530000) returned to AYoshiK
AYoshiK collected 1650000 from pot
AYoshiK: doesn't show hand
*** SUMMARY ***
Total pot 1650000 | Rake 0
Seat 1: youdri15 folded before Flop (didn't bet)
Seat 2: 4time2warp0 (button) folded before Flop (didn't bet)
Seat 3: AtilaMoreira (small blind) folded before Flop
Seat 4: hichnick777 (big blind) folded before Flop
Seat 5: kasper744 folded before Flop (didn't bet)
Seat 6: maxsi10 folded before Flop (didn't bet)
Seat 8: casey1186 folded before Flop (didn't bet)
Seat 9: AYoshiK collected (1650000)


*********** # 533 **************
PokerStars Hand #176682370868: Tournament #2054568934, $20+$2 USD Hold'em No Limit - Level XLIX (250000/500000) - 2017/10/09 8:48:59 MSK [2017/10/09 1:48:59 ET]
Table '2054568934 624' 9-max Seat #3 is the button
Seat 1: youdri15 (10699464 in chips)
Seat 2: 4time2warp0 (12585972 in chips)
Seat 3: AtilaMoreira (6057738 in chips)
Seat 4: hichnick777 (8015040 in chips)
Seat 5: kasper744 (13036534 in chips)
Seat 6: maxsi10 (10407758 in chips)
Seat 8: casey1186 (21678842 in chips)
Seat 9: AYoshiK (8248652 in chips)
youdri15: posts the ante 50000
4time2warp0: posts the ante 50000
AtilaMoreira: posts the ante 50000
hichnick777: posts the ante 50000
kasper744: posts the ante 50000
maxsi10: posts the ante 50000
casey1186: posts the ante 50000
AYoshiK: posts the ante 50000
hichnick777: posts small blind 250000
kasper744: posts big blind 500000
*** HOLE CARDS ***
Dealt to hichnick777 [6s Jd]
maxsi10: folds
casey1186: folds
AYoshiK: folds
youdri15: folds
4time2warp0: folds
AtilaMoreira: folds
hichnick777: calls 250000
kasper744: raises 850776 to 1350776
hichnick777: folds
Uncalled bet (850776) returned to kasper744
kasper744 collected 1400000 from pot
kasper744: doesn't show hand
*** SUMMARY ***
Total pot 1400000 | Rake 0
Seat 1: youdri15 folded before Flop (didn't bet)
Seat 2: 4time2warp0 folded before Flop (didn't bet)
Seat 3: AtilaMoreira (button) folded before Flop (didn't bet)
Seat 4: hichnick777 (small blind) folded before Flop
Seat 5: kasper744 (big blind) collected (1400000)
Seat 6: maxsi10 folded before Flop (didn't bet)
Seat 8: casey1186 folded before Flop (didn't bet)
Seat 9: AYoshiK folded before Flop (didn't bet)


*********** # 534 **************
PokerStars Hand #176682383115: Tournament #2054568934, $20+$2 USD Hold'em No Limit - Level XLIX (250000/500000) - 2017/10/09 8:49:57 MSK [2017/10/09 1:49:57 ET]
Table '2054568934 624' 9-max Seat #4 is the button
Seat 1: youdri15 (10649464 in chips)
Seat 2: 4time2warp0 (12535972 in chips)
Seat 3: AtilaMoreira (6007738 in chips)
Seat 4: hichnick777 (7465040 in chips)
Seat 5: kasper744 (13886534 in chips)
Seat 6: maxsi10 (10357758 in chips)
Seat 8: casey1186 (21628842 in chips)
Seat 9: AYoshiK (8198652 in chips)
youdri15: posts the ante 50000
4time2warp0: posts the ante 50000
AtilaMoreira: posts the ante 50000
hichnick777: posts the ante 50000
kasper744: posts the ante 50000
maxsi10: posts the ante 50000
casey1186: posts the ante 50000
AYoshiK: posts the ante 50000
kasper744: posts small blind 250000
maxsi10: posts big blind 500000
*** HOLE CARDS ***
Dealt to hichnick777 [Tc 3d]
casey1186: raises 1000000 to 1500000
AYoshiK: folds
youdri15: folds
4time2warp0: raises 3000000 to 4500000
AtilaMoreira: folds
hichnick777: folds
kasper744: folds
maxsi10: folds
casey1186: folds
Uncalled bet (3000000) returned to 4time2warp0
4time2warp0 collected 4150000 from pot
4time2warp0: doesn't show hand
*** SUMMARY ***
Total pot 4150000 | Rake 0
Seat 1: youdri15 folded before Flop (didn't bet)
Seat 2: 4time2warp0 collected (4150000)
Seat 3: AtilaMoreira folded before Flop (didn't bet)
Seat 4: hichnick777 (button) folded before Flop (didn't bet)
Seat 5: kasper744 (small blind) folded before Flop
Seat 6: maxsi10 (big blind) folded before Flop
Seat 8: casey1186 folded before Flop
Seat 9: AYoshiK folded before Flop (didn't bet)


*********** # 535 **************
PokerStars Hand #176682387605: Tournament #2054568934, $20+$2 USD Hold'em No Limit - Level XLIX (250000/500000) - 2017/10/09 8:50:18 MSK [2017/10/09 1:50:18 ET]
Table '2054568934 624' 9-max Seat #5 is the button
Seat 1: youdri15 (10599464 in chips)
Seat 2: 4time2warp0 (15135972 in chips)
Seat 3: AtilaMoreira (5957738 in chips)
Seat 4: hichnick777 (7415040 in chips)
Seat 5: kasper744 (13586534 in chips)
Seat 6: maxsi10 (9807758 in chips)
Seat 8: casey1186 (20078842 in chips)
Seat 9: AYoshiK (8148652 in chips)
youdri15: posts the ante 50000
4time2warp0: posts the ante 50000
AtilaMoreira: posts the ante 50000
hichnick777: posts the ante 50000
kasper744: posts the ante 50000
maxsi10: posts the ante 50000
casey1186: posts the ante 50000
AYoshiK: posts the ante 50000
maxsi10: posts small blind 250000
casey1186: posts big blind 500000
*** HOLE CARDS ***
Dealt to hichnick777 [9s 9c]
AYoshiK: folds
youdri15: folds
4time2warp0: folds
AtilaMoreira: folds
hichnick777: raises 540000 to 1040000
kasper744: folds
maxsi10: folds
casey1186: calls 540000
*** FLOP *** [2h Qd Js]
casey1186: checks
youdri15 is disconnected
hichnick777: checks
*** TURN *** [2h Qd Js] [5s]
casey1186: bets 2730000
hichnick777: folds
Uncalled bet (2730000) returned to casey1186
casey1186 collected 2730000 from pot
casey1186: doesn't show hand
*** SUMMARY ***
Total pot 2730000 | Rake 0
Board [2h Qd Js 5s]
Seat 1: youdri15 folded before Flop (didn't bet)
Seat 2: 4time2warp0 folded before Flop (didn't bet)
Seat 3: AtilaMoreira folded before Flop (didn't bet)
Seat 4: hichnick777 folded on the Turn
Seat 5: kasper744 (button) folded before Flop (didn't bet)
Seat 6: maxsi10 (small blind) folded before Flop
Seat 8: casey1186 (big blind) collected (2730000)
Seat 9: AYoshiK folded before Flop (didn't bet)


*********** # 536 **************
PokerStars Hand #176682409026: Tournament #2054568934, $20+$2 USD Hold'em No Limit - Level XLIX (250000/500000) - 2017/10/09 8:51:58 MSK [2017/10/09 1:51:58 ET]
Table '2054568934 624' 9-max Seat #6 is the button
Seat 1: youdri15 (10549464 in chips)
Seat 2: 4time2warp0 (15085972 in chips)
Seat 3: AtilaMoreira (5907738 in chips)
Seat 4: hichnick777 (6325040 in chips)
Seat 5: kasper744 (13536534 in chips)
Seat 6: maxsi10 (9507758 in chips)
Seat 8: casey1186 (21718842 in chips)
Seat 9: AYoshiK (8098652 in chips)
youdri15: posts the ante 50000
4time2warp0: posts the ante 50000
AtilaMoreira: posts the ante 50000
hichnick777: posts the ante 50000
kasper744: posts the ante 50000
maxsi10: posts the ante 50000
casey1186: posts the ante 50000
AYoshiK: posts the ante 50000
casey1186: posts small blind 250000
AYoshiK: posts big blind 500000
*** HOLE CARDS ***
Dealt to hichnick777 [Qh 8d]
youdri15 is connected
youdri15 is connected
casey1186 said, "aj"
youdri15: folds
4time2warp0: folds
AtilaMoreira: raises 5357738 to 5857738 and is all-in
hichnick777: folds
kasper744: folds
maxsi10: folds
casey1186: folds
AYoshiK: folds
Uncalled bet (5357738) returned to AtilaMoreira
AtilaMoreira collected 1650000 from pot
*** SUMMARY ***
Total pot 1650000 | Rake 0
Seat 1: youdri15 folded before Flop (didn't bet)
Seat 2: 4time2warp0 folded before Flop (didn't bet)
Seat 3: AtilaMoreira collected (1650000)
Seat 4: hichnick777 folded before Flop (didn't bet)
Seat 5: kasper744 folded before Flop (didn't bet)
Seat 6: maxsi10 (button) folded before Flop (didn't bet)
Seat 8: casey1186 (small blind) folded before Flop
Seat 9: AYoshiK (big blind) folded before Flop


*********** # 537 **************
PokerStars Hand #176682418881: Tournament #2054568934, $20+$2 USD Hold'em No Limit - Level XLIX (250000/500000) - 2017/10/09 8:52:45 MSK [2017/10/09 1:52:45 ET]
Table '2054568934 624' 9-max Seat #8 is the button
Seat 1: youdri15 (10499464 in chips)
Seat 2: 4time2warp0 (15035972 in chips)
Seat 3: AtilaMoreira (7007738 in chips)
Seat 4: hichnick777 (6275040 in chips)
Seat 5: kasper744 (13486534 in chips)
Seat 6: maxsi10 (9457758 in chips)
Seat 8: casey1186 (21418842 in chips)
Seat 9: AYoshiK (7548652 in chips)
youdri15: posts the ante 50000
4time2warp0: posts the ante 50000
AtilaMoreira: posts the ante 50000
hichnick777: posts the ante 50000
kasper744: posts the ante 50000
maxsi10: posts the ante 50000
casey1186: posts the ante 50000
AYoshiK: posts the ante 50000
AYoshiK: posts small blind 250000
youdri15: posts big blind 500000
*** HOLE CARDS ***
Dealt to hichnick777 [Ks 5d]
4time2warp0: folds
AtilaMoreira: folds
hichnick777: folds
kasper744: folds
maxsi10: folds
casey1186: folds
AYoshiK: raises 6998652 to 7498652 and is all-in
youdri15: folds
Uncalled bet (6998652) returned to AYoshiK
AYoshiK collected 1400000 from pot
AYoshiK: doesn't show hand
*** SUMMARY ***
Total pot 1400000 | Rake 0
Seat 1: youdri15 (big blind) folded before Flop
Seat 2: 4time2warp0 folded before Flop (didn't bet)
Seat 3: AtilaMoreira folded before Flop (didn't bet)
Seat 4: hichnick777 folded before Flop (didn't bet)
Seat 5: kasper744 folded before Flop (didn't bet)
Seat 6: maxsi10 folded before Flop (didn't bet)
Seat 8: casey1186 (button) folded before Flop (didn't bet)
Seat 9: AYoshiK (small blind) collected (1400000)


*********** # 538 **************
PokerStars Hand #176682425090: Tournament #2054568934, $20+$2 USD Hold'em No Limit - Level XLIX (250000/500000) - 2017/10/09 8:53:15 MSK [2017/10/09 1:53:15 ET]
Table '2054568934 624' 9-max Seat #9 is the button
Seat 1: youdri15 (9949464 in chips)
Seat 2: 4time2warp0 (14985972 in chips)
Seat 3: AtilaMoreira (6957738 in chips)
Seat 4: hichnick777 (6225040 in chips)
Seat 5: kasper744 (13436534 in chips)
Seat 6: maxsi10 (9407758 in chips)
Seat 8: casey1186 (21368842 in chips)
Seat 9: AYoshiK (8398652 in chips)
youdri15: posts the ante 50000
4time2warp0: posts the ante 50000
AtilaMoreira: posts the ante 50000
hichnick777: posts the ante 50000
kasper744: posts the ante 50000
maxsi10: posts the ante 50000
casey1186: posts the ante 50000
AYoshiK: posts the ante 50000
youdri15: posts small blind 250000
4time2warp0: posts big blind 500000
*** HOLE CARDS ***
Dealt to hichnick777 [7d Qs]
AtilaMoreira: folds
hichnick777: folds
kasper744: folds
maxsi10: folds
casey1186: folds
AYoshiK: folds
youdri15: folds
Uncalled bet (250000) returned to 4time2warp0
4time2warp0 collected 900000 from pot
4time2warp0: doesn't show hand
*** SUMMARY ***
Total pot 900000 | Rake 0
Seat 1: youdri15 (small blind) folded before Flop
Seat 2: 4time2warp0 (big blind) collected (900000)
Seat 3: AtilaMoreira folded before Flop (didn't bet)
Seat 4: hichnick777 folded before Flop (didn't bet)
Seat 5: kasper744 folded before Flop (didn't bet)
Seat 6: maxsi10 folded before Flop (didn't bet)
Seat 8: casey1186 folded before Flop (didn't bet)
Seat 9: AYoshiK (button) folded before Flop (didn't bet)


*********** # 539 **************
PokerStars Hand #176682427512: Tournament #2054568934, $20+$2 USD Hold'em No Limit - Level XLIX (250000/500000) - 2017/10/09 8:53:26 MSK [2017/10/09 1:53:26 ET]
Table '2054568934 624' 9-max Seat #1 is the button
Seat 1: youdri15 (9649464 in chips)
Seat 2: 4time2warp0 (15585972 in chips)
Seat 3: AtilaMoreira (6907738 in chips)
Seat 4: hichnick777 (6175040 in chips)
Seat 5: kasper744 (13386534 in chips)
Seat 6: maxsi10 (9357758 in chips)
Seat 8: casey1186 (21318842 in chips)
Seat 9: AYoshiK (8348652 in chips)
youdri15: posts the ante 50000
4time2warp0: posts the ante 50000
AtilaMoreira: posts the ante 50000
hichnick777: posts the ante 50000
kasper744: posts the ante 50000
maxsi10: posts the ante 50000
casey1186: posts the ante 50000
AYoshiK: posts the ante 50000
4time2warp0: posts small blind 250000
AtilaMoreira: posts big blind 500000
*** HOLE CARDS ***
Dealt to hichnick777 [Kd 3h]
hichnick777: calls 500000
kasper744: raises 12836534 to 13336534 and is all-in
maxsi10: folds
casey1186: raises 7932308 to 21268842 and is all-in
AYoshiK: folds
youdri15: folds
4time2warp0: folds
AtilaMoreira: folds
hichnick777: folds
Uncalled bet (7932308) returned to casey1186
*** FLOP *** [Js 7c 2s]
*** TURN *** [Js 7c 2s] [Kc]
*** RIVER *** [Js 7c 2s Kc] [2h]
*** SHOW DOWN ***
kasper744: shows [Qd As] (a pair of Deuces)
casey1186: shows [Ah Ad] (two pair, Aces and Deuces)
casey1186 collected 28323068 from pot
kasper744 finished the tournament in 8th place and received $1653.97.
*** SUMMARY ***
Total pot 28323068 | Rake 0
Board [Js 7c 2s Kc 2h]
Seat 1: youdri15 (button) folded before Flop (didn't bet)
Seat 2: 4time2warp0 (small blind) folded before Flop
Seat 3: AtilaMoreira (big blind) folded before Flop
Seat 4: hichnick777 folded before Flop
Seat 5: kasper744 showed [Qd As] and lost with a pair of Deuces
Seat 6: maxsi10 folded before Flop (didn't bet)
Seat 8: casey1186 showed [Ah Ad] and won (28323068) with two pair, Aces and Deuces
Seat 9: AYoshiK folded before Flop (didn't bet)


*********** # 540 **************
PokerStars Hand #176682433054: Tournament #2054568934, $20+$2 USD Hold'em No Limit - Level XLIX (250000/500000) - 2017/10/09 8:53:52 MSK [2017/10/09 1:53:52 ET]
Table '2054568934 624' 9-max Seat #2 is the button
Seat 1: youdri15 (9599464 in chips)
Seat 2: 4time2warp0 (15285972 in chips)
Seat 3: AtilaMoreira (6357738 in chips)
Seat 4: hichnick777 (5625040 in chips)
Seat 6: maxsi10 (9307758 in chips)
Seat 8: casey1186 (36255376 in chips)
Seat 9: AYoshiK (8298652 in chips)
youdri15: posts the ante 50000
4time2warp0: posts the ante 50000
AtilaMoreira: posts the ante 50000
hichnick777: posts the ante 50000
maxsi10: posts the ante 50000
casey1186: posts the ante 50000
AYoshiK: posts the ante 50000
AtilaMoreira: posts small blind 250000
hichnick777: posts big blind 500000
*** HOLE CARDS ***
Dealt to hichnick777 [Th 2s]
maxsi10: folds
casey1186: raises 1000000 to 1500000
AYoshiK: folds
youdri15: folds
4time2warp0: folds
AtilaMoreira: folds
hichnick777: folds
Uncalled bet (1000000) returned to casey1186
casey1186 collected 1600000 from pot
casey1186: doesn't show hand
*** SUMMARY ***
Total pot 1600000 | Rake 0
Seat 1: youdri15 folded before Flop (didn't bet)
Seat 2: 4time2warp0 (button) folded before Flop (didn't bet)
Seat 3: AtilaMoreira (small blind) folded before Flop
Seat 4: hichnick777 (big blind) folded before Flop
Seat 6: maxsi10 folded before Flop (didn't bet)
Seat 8: casey1186 collected (1600000)
Seat 9: AYoshiK folded before Flop (didn't bet)


*********** # 541 **************
PokerStars Hand #176682437108: Tournament #2054568934, $20+$2 USD Hold'em No Limit - Level XLIX (250000/500000) - 2017/10/09 8:54:11 MSK [2017/10/09 1:54:11 ET]
Table '2054568934 624' 9-max Seat #3 is the button
Seat 1: youdri15 (9549464 in chips)
Seat 2: 4time2warp0 (15235972 in chips)
Seat 3: AtilaMoreira (6057738 in chips)
Seat 4: hichnick777 (5075040 in chips)
Seat 6: maxsi10 (9257758 in chips)
Seat 8: casey1186 (37305376 in chips)
Seat 9: AYoshiK (8248652 in chips)
youdri15: posts the ante 50000
4time2warp0: posts the ante 50000
AtilaMoreira: posts the ante 50000
hichnick777: posts the ante 50000
maxsi10: posts the ante 50000
casey1186: posts the ante 50000
AYoshiK: posts the ante 50000
hichnick777: posts small blind 250000
maxsi10: posts big blind 500000
*** HOLE CARDS ***
Dealt to hichnick777 [Jh Ks]
casey1186: folds
AYoshiK: folds
youdri15: folds
4time2warp0: folds
AtilaMoreira: raises 5507738 to 6007738 and is all-in
hichnick777: folds
maxsi10: folds
Uncalled bet (5507738) returned to AtilaMoreira
AtilaMoreira collected 1600000 from pot
*** SUMMARY ***
Total pot 1600000 | Rake 0
Seat 1: youdri15 folded before Flop (didn't bet)
Seat 2: 4time2warp0 folded before Flop (didn't bet)
Seat 3: AtilaMoreira (button) collected (1600000)
Seat 4: hichnick777 (small blind) folded before Flop
Seat 6: maxsi10 (big blind) folded before Flop
Seat 8: casey1186 folded before Flop (didn't bet)
Seat 9: AYoshiK folded before Flop (didn't bet)


*********** # 542 **************
PokerStars Hand #176682443365: Tournament #2054568934, $20+$2 USD Hold'em No Limit - Level XLIX (250000/500000) - 2017/10/09 8:54:41 MSK [2017/10/09 1:54:41 ET]
Table '2054568934 624' 9-max Seat #4 is the button
Seat 1: youdri15 (9499464 in chips)
Seat 2: 4time2warp0 (15185972 in chips)
Seat 3: AtilaMoreira (7107738 in chips)
Seat 4: hichnick777 (4775040 in chips)
Seat 6: maxsi10 (8707758 in chips)
Seat 8: casey1186 (37255376 in chips)
Seat 9: AYoshiK (8198652 in chips)
youdri15: posts the ante 50000
4time2warp0: posts the ante 50000
AtilaMoreira: posts the ante 50000
hichnick777: posts the ante 50000
maxsi10: posts the ante 50000
casey1186: posts the ante 50000
AYoshiK: posts the ante 50000
maxsi10: posts small blind 250000
casey1186: posts big blind 500000
*** HOLE CARDS ***
Dealt to hichnick777 [7d Ad]
AYoshiK: folds
youdri15: folds
4time2warp0: raises 500000 to 1000000
AtilaMoreira: raises 6057738 to 7057738 and is all-in
hichnick777: folds
maxsi10: folds
casey1186: folds
4time2warp0: folds
Uncalled bet (6057738) returned to AtilaMoreira
AtilaMoreira collected 3100000 from pot
*** SUMMARY ***
Total pot 3100000 | Rake 0
Seat 1: youdri15 folded before Flop (didn't bet)
Seat 2: 4time2warp0 folded before Flop
Seat 3: AtilaMoreira collected (3100000)
Seat 4: hichnick777 (button) folded before Flop (didn't bet)
Seat 6: maxsi10 (small blind) folded before Flop
Seat 8: casey1186 (big blind) folded before Flop
Seat 9: AYoshiK folded before Flop (didn't bet)


*********** # 543 **************
PokerStars Hand #176682448891: Tournament #2054568934, $20+$2 USD Hold'em No Limit - Level XLIX (250000/500000) - 2017/10/09 8:55:07 MSK [2017/10/09 1:55:07 ET]
Table '2054568934 624' 9-max Seat #6 is the button
Seat 1: youdri15 (9449464 in chips)
Seat 2: 4time2warp0 (14135972 in chips)
Seat 3: AtilaMoreira (9157738 in chips)
Seat 4: hichnick777 (4725040 in chips)
Seat 6: maxsi10 (8407758 in chips)
Seat 8: casey1186 (36705376 in chips)
Seat 9: AYoshiK (8148652 in chips)
youdri15: posts the ante 50000
4time2warp0: posts the ante 50000
AtilaMoreira: posts the ante 50000
hichnick777: posts the ante 50000
maxsi10: posts the ante 50000
casey1186: posts the ante 50000
AYoshiK: posts the ante 50000
casey1186: posts small blind 250000
AYoshiK: posts big blind 500000
*** HOLE CARDS ***
Dealt to hichnick777 [8c Kc]
youdri15: raises 500000 to 1000000
4time2warp0: folds
AtilaMoreira: folds
hichnick777: folds
maxsi10: folds
casey1186: folds
AYoshiK: raises 7098652 to 8098652 and is all-in
youdri15: folds
Uncalled bet (7098652) returned to AYoshiK
AYoshiK collected 2600000 from pot
AYoshiK: doesn't show hand
casey1186 is disconnected
youdri15 is disconnected
hichnick777 is disconnected
AYoshiK is disconnected
maxsi10 is disconnected
*** SUMMARY ***
Total pot 2600000 | Rake 0
Seat 1: youdri15 folded before Flop
Seat 2: 4time2warp0 folded before Flop (didn't bet)
Seat 3: AtilaMoreira folded before Flop (didn't bet)
Seat 4: hichnick777 folded before Flop (didn't bet)
Seat 6: maxsi10 (button) folded before Flop (didn't bet)
Seat 8: casey1186 (small blind) folded before Flop
Seat 9: AYoshiK (big blind) collected (2600000)


*********** # 544 **************
PokerStars Hand #176682510273: Tournament #2054568934, $20+$2 USD Hold'em No Limit - Level XLIX (250000/500000) - 2017/10/09 9:00:24 MSK [2017/10/09 2:00:24 ET]
Table '2054568934 624' 9-max Seat #8 is the button
Seat 1: youdri15 (8399464 in chips)
Seat 2: 4time2warp0 (14085972 in chips)
Seat 3: AtilaMoreira (9107738 in chips)
Seat 4: hichnick777 (4675040 in chips)
Seat 6: maxsi10 (8357758 in chips)
Seat 8: casey1186 (36405376 in chips)
Seat 9: AYoshiK (9698652 in chips)
youdri15: posts the ante 50000
4time2warp0: posts the ante 50000
AtilaMoreira: posts the ante 50000
hichnick777: posts the ante 50000
maxsi10: posts the ante 50000
casey1186: posts the ante 50000
AYoshiK: posts the ante 50000
AYoshiK: posts small blind 250000
youdri15: posts big blind 500000
*** HOLE CARDS ***
Dealt to hichnick777 [Js 2s]
4time2warp0: folds
AtilaMoreira: folds
hichnick777: folds
maxsi10: folds
casey1186: raises 1000000 to 1500000
AYoshiK: folds
youdri15 is disconnected
youdri15 is connected
youdri15 is disconnected
youdri15 is connected
youdri15 is connected
youdri15: folds
Uncalled bet (1000000) returned to casey1186
casey1186 collected 1600000 from pot
casey1186: doesn't show hand
*** SUMMARY ***
Total pot 1600000 | Rake 0
Seat 1: youdri15 (big blind) folded before Flop
Seat 2: 4time2warp0 folded before Flop (didn't bet)
Seat 3: AtilaMoreira folded before Flop (didn't bet)
Seat 4: hichnick777 folded before Flop (didn't bet)
Seat 6: maxsi10 folded before Flop (didn't bet)
Seat 8: casey1186 (button) collected (1600000)
Seat 9: AYoshiK (small blind) folded before Flop


*********** # 545 **************
PokerStars Hand #176682518421: Tournament #2054568934, $20+$2 USD Hold'em No Limit - Level XLIX (250000/500000) - 2017/10/09 9:01:05 MSK [2017/10/09 2:01:05 ET]
Table '2054568934 624' 9-max Seat #9 is the button
Seat 1: youdri15 (7849464 in chips)
Seat 2: 4time2warp0 (14035972 in chips)
Seat 3: AtilaMoreira (9057738 in chips)
Seat 4: hichnick777 (4625040 in chips)
Seat 6: maxsi10 (8307758 in chips)
Seat 8: casey1186 (37455376 in chips)
Seat 9: AYoshiK (9398652 in chips)
youdri15: posts the ante 50000
4time2warp0: posts the ante 50000
AtilaMoreira: posts the ante 50000
hichnick777: posts the ante 50000
maxsi10: posts the ante 50000
casey1186: posts the ante 50000
AYoshiK: posts the ante 50000
youdri15: posts small blind 250000
4time2warp0: posts big blind 500000
*** HOLE CARDS ***
Dealt to hichnick777 [5h Ah]
AtilaMoreira: folds
hichnick777: raises 4075040 to 4575040 and is all-in
maxsi10: folds
casey1186: calls 4575040
AYoshiK: folds
youdri15: folds
4time2warp0: folds
*** FLOP *** [Kh 3s Ac]
*** TURN *** [Kh 3s Ac] [4s]
*** RIVER *** [Kh 3s Ac 4s] [Qd]
*** SHOW DOWN ***
hichnick777: shows [5h Ah] (a pair of Aces)
casey1186: shows [8d 8c] (a pair of Eights)
hichnick777 collected 10250080 from pot
*** SUMMARY ***
Total pot 10250080 | Rake 0
Board [Kh 3s Ac 4s Qd]
Seat 1: youdri15 (small blind) folded before Flop
Seat 2: 4time2warp0 (big blind) folded before Flop
Seat 3: AtilaMoreira folded before Flop (didn't bet)
Seat 4: hichnick777 showed [5h Ah] and won (10250080) with a pair of Aces
Seat 6: maxsi10 folded before Flop (didn't bet)
Seat 8: casey1186 showed [8d 8c] and lost with a pair of Eights
Seat 9: AYoshiK (button) folded before Flop (didn't bet)


*********** # 546 **************
PokerStars Hand #176682523606: Tournament #2054568934, $20+$2 USD Hold'em No Limit - Level XLIX (250000/500000) - 2017/10/09 9:01:29 MSK [2017/10/09 2:01:29 ET]
Table '2054568934 624' 9-max Seat #1 is the button
Seat 1: youdri15 (7549464 in chips)
Seat 2: 4time2warp0 (13485972 in chips)
Seat 3: AtilaMoreira (9007738 in chips)
Seat 4: hichnick777 (10250080 in chips)
Seat 6: maxsi10 (8257758 in chips)
Seat 8: casey1186 (32830336 in chips)
Seat 9: AYoshiK (9348652 in chips)
youdri15: posts the ante 50000
4time2warp0: posts the ante 50000
AtilaMoreira: posts the ante 50000
hichnick777: posts the ante 50000
maxsi10: posts the ante 50000
casey1186: posts the ante 50000
AYoshiK: posts the ante 50000
4time2warp0: posts small blind 250000
AtilaMoreira: posts big blind 500000
*** HOLE CARDS ***
Dealt to hichnick777 [Qd 4s]
hichnick777: folds
maxsi10: folds
casey1186: folds
AYoshiK: folds
youdri15: raises 1000000 to 1500000
4time2warp0: folds
AtilaMoreira: folds
Uncalled bet (1000000) returned to youdri15
youdri15 collected 1600000 from pot
youdri15: doesn't show hand
*** SUMMARY ***
Total pot 1600000 | Rake 0
Seat 1: youdri15 (button) collected (1600000)
Seat 2: 4time2warp0 (small blind) folded before Flop
Seat 3: AtilaMoreira (big blind) folded before Flop
Seat 4: hichnick777 folded before Flop (didn't bet)
Seat 6: maxsi10 folded before Flop (didn't bet)
Seat 8: casey1186 folded before Flop (didn't bet)
Seat 9: AYoshiK folded before Flop (didn't bet)


*********** # 547 **************
PokerStars Hand #176682526598: Tournament #2054568934, $20+$2 USD Hold'em No Limit - Level XLIX (250000/500000) - 2017/10/09 9:01:43 MSK [2017/10/09 2:01:43 ET]
Table '2054568934 624' 9-max Seat #2 is the button
Seat 1: youdri15 (8599464 in chips)
Seat 2: 4time2warp0 (13185972 in chips)
Seat 3: AtilaMoreira (8457738 in chips)
Seat 4: hichnick777 (10200080 in chips)
Seat 6: maxsi10 (8207758 in chips)
Seat 8: casey1186 (32780336 in chips)
Seat 9: AYoshiK (9298652 in chips)
youdri15: posts the ante 50000
4time2warp0: posts the ante 50000
AtilaMoreira: posts the ante 50000
hichnick777: posts the ante 50000
maxsi10: posts the ante 50000
casey1186: posts the ante 50000
AYoshiK: posts the ante 50000
AtilaMoreira: posts small blind 250000
hichnick777: posts big blind 500000
*** HOLE CARDS ***
Dealt to hichnick777 [3h 4h]
maxsi10: folds
casey1186: folds
AYoshiK: folds
youdri15: folds
4time2warp0: folds
AtilaMoreira: raises 1000000 to 1500000
hichnick777: calls 1000000
*** FLOP *** [7d Kh Ac]
AtilaMoreira: bets 975500
hichnick777: calls 975500
*** TURN *** [7d Kh Ac] [5d]
AtilaMoreira: bets 1749330
hichnick777: folds
Uncalled bet (1749330) returned to AtilaMoreira
AtilaMoreira collected 5301000 from pot
*** SUMMARY ***
Total pot 5301000 | Rake 0
Board [7d Kh Ac 5d]
Seat 1: youdri15 folded before Flop (didn't bet)
Seat 2: 4time2warp0 (button) folded before Flop (didn't bet)
Seat 3: AtilaMoreira (small blind) collected (5301000)
Seat 4: hichnick777 (big blind) folded on the Turn
Seat 6: maxsi10 folded before Flop (didn't bet)
Seat 8: casey1186 folded before Flop (didn't bet)
Seat 9: AYoshiK folded before Flop (didn't bet)


*********** # 548 **************
PokerStars Hand #176682548378: Tournament #2054568934, $20+$2 USD Hold'em No Limit - Level L (300000/600000) - 2017/10/09 9:03:26 MSK [2017/10/09 2:03:26 ET]
Table '2054568934 624' 9-max Seat #3 is the button
Seat 1: youdri15 (8549464 in chips)
Seat 2: 4time2warp0 (13135972 in chips)
Seat 3: AtilaMoreira (11233238 in chips)
Seat 4: hichnick777 (7674580 in chips)
Seat 6: maxsi10 (8157758 in chips)
Seat 8: casey1186 (32730336 in chips)
Seat 9: AYoshiK (9248652 in chips)
youdri15: posts the ante 60000
4time2warp0: posts the ante 60000
AtilaMoreira: posts the ante 60000
hichnick777: posts the ante 60000
maxsi10: posts the ante 60000
casey1186: posts the ante 60000
AYoshiK: posts the ante 60000
hichnick777: posts small blind 300000
maxsi10: posts big blind 600000
*** HOLE CARDS ***
Dealt to hichnick777 [4c Ah]
casey1186: folds
AYoshiK: raises 636000 to 1236000
youdri15: folds
4time2warp0: folds
AtilaMoreira: folds
hichnick777: folds
maxsi10: folds
Uncalled bet (636000) returned to AYoshiK
AYoshiK collected 1920000 from pot
AYoshiK: doesn't show hand
*** SUMMARY ***
Total pot 1920000 | Rake 0
Seat 1: youdri15 folded before Flop (didn't bet)
Seat 2: 4time2warp0 folded before Flop (didn't bet)
Seat 3: AtilaMoreira (button) folded before Flop (didn't bet)
Seat 4: hichnick777 (small blind) folded before Flop
Seat 6: maxsi10 (big blind) folded before Flop
Seat 8: casey1186 folded before Flop (didn't bet)
Seat 9: AYoshiK collected (1920000)


*********** # 549 **************
PokerStars Hand #176682553784: Tournament #2054568934, $20+$2 USD Hold'em No Limit - Level L (300000/600000) - 2017/10/09 9:03:51 MSK [2017/10/09 2:03:51 ET]
Table '2054568934 624' 9-max Seat #4 is the button
Seat 1: youdri15 (8489464 in chips)
Seat 2: 4time2warp0 (13075972 in chips)
Seat 3: AtilaMoreira (11173238 in chips)
Seat 4: hichnick777 (7314580 in chips)
Seat 6: maxsi10 (7497758 in chips)
Seat 8: casey1186 (32670336 in chips)
Seat 9: AYoshiK (10508652 in chips)
youdri15: posts the ante 60000
4time2warp0: posts the ante 60000
AtilaMoreira: posts the ante 60000
hichnick777: posts the ante 60000
maxsi10: posts the ante 60000
casey1186: posts the ante 60000
AYoshiK: posts the ante 60000
maxsi10: posts small blind 300000
casey1186: posts big blind 600000
*** HOLE CARDS ***
Dealt to hichnick777 [As 5d]
AYoshiK: raises 1200000 to 1800000
youdri15: folds
4time2warp0: folds
AtilaMoreira: folds
hichnick777: folds
maxsi10: folds
casey1186: folds
Uncalled bet (1200000) returned to AYoshiK
AYoshiK collected 1920000 from pot
AYoshiK: doesn't show hand
*** SUMMARY ***
Total pot 1920000 | Rake 0
Seat 1: youdri15 folded before Flop (didn't bet)
Seat 2: 4time2warp0 folded before Flop (didn't bet)
Seat 3: AtilaMoreira folded before Flop (didn't bet)
Seat 4: hichnick777 (button) folded before Flop (didn't bet)
Seat 6: maxsi10 (small blind) folded before Flop
Seat 8: casey1186 (big blind) folded before Flop
Seat 9: AYoshiK collected (1920000)


*********** # 550 **************
PokerStars Hand #176682558753: Tournament #2054568934, $20+$2 USD Hold'em No Limit - Level L (300000/600000) - 2017/10/09 9:04:14 MSK [2017/10/09 2:04:14 ET]
Table '2054568934 624' 9-max Seat #6 is the button
Seat 1: youdri15 (8429464 in chips)
Seat 2: 4time2warp0 (13015972 in chips)
Seat 3: AtilaMoreira (11113238 in chips)
Seat 4: hichnick777 (7254580 in chips)
Seat 6: maxsi10 (7137758 in chips)
Seat 8: casey1186 (32010336 in chips)
Seat 9: AYoshiK (11768652 in chips)
youdri15: posts the ante 60000
4time2warp0: posts the ante 60000
AtilaMoreira: posts the ante 60000
hichnick777: posts the ante 60000
maxsi10: posts the ante 60000
casey1186: posts the ante 60000
AYoshiK: posts the ante 60000
casey1186: posts small blind 300000
AYoshiK: posts big blind 600000
*** HOLE CARDS ***
Dealt to hichnick777 [5c Ks]
youdri15: raises 600000 to 1200000
4time2warp0: folds
AtilaMoreira: folds
hichnick777: folds
maxsi10: folds
casey1186: folds
AYoshiK: folds
Uncalled bet (600000) returned to youdri15
youdri15 collected 1920000 from pot
youdri15: doesn't show hand
*** SUMMARY ***
Total pot 1920000 | Rake 0
Seat 1: youdri15 collected (1920000)
Seat 2: 4time2warp0 folded before Flop (didn't bet)
Seat 3: AtilaMoreira folded before Flop (didn't bet)
Seat 4: hichnick777 folded before Flop (didn't bet)
Seat 6: maxsi10 (button) folded before Flop (didn't bet)
Seat 8: casey1186 (small blind) folded before Flop
Seat 9: AYoshiK (big blind) folded before Flop


*********** # 551 **************
PokerStars Hand #176682564992: Tournament #2054568934, $20+$2 USD Hold'em No Limit - Level L (300000/600000) - 2017/10/09 9:04:43 MSK [2017/10/09 2:04:43 ET]
Table '2054568934 624' 9-max Seat #8 is the button
Seat 1: youdri15 (9689464 in chips)
Seat 2: 4time2warp0 (12955972 in chips)
Seat 3: AtilaMoreira (11053238 in chips)
Seat 4: hichnick777 (7194580 in chips)
Seat 6: maxsi10 (7077758 in chips)
Seat 8: casey1186 (31650336 in chips)
Seat 9: AYoshiK (11108652 in chips)
youdri15: posts the ante 60000
4time2warp0: posts the ante 60000
AtilaMoreira: posts the ante 60000
hichnick777: posts the ante 60000
maxsi10: posts the ante 60000
casey1186: posts the ante 60000
AYoshiK: posts the ante 60000
AYoshiK: posts small blind 300000
youdri15: posts big blind 600000
*** HOLE CARDS ***
Dealt to hichnick777 [8c Qd]
4time2warp0: folds
AtilaMoreira: folds
hichnick777: folds
maxsi10: folds
casey1186: raises 1200000 to 1800000
AYoshiK: folds
youdri15: folds
Uncalled bet (1200000) returned to casey1186
casey1186 collected 1920000 from pot
*** SUMMARY ***
Total pot 1920000 | Rake 0
Seat 1: youdri15 (big blind) folded before Flop
Seat 2: 4time2warp0 folded before Flop (didn't bet)
Seat 3: AtilaMoreira folded before Flop (didn't bet)
Seat 4: hichnick777 folded before Flop (didn't bet)
Seat 6: maxsi10 folded before Flop (didn't bet)
Seat 8: casey1186 (button) collected (1920000)
Seat 9: AYoshiK (small blind) folded before Flop


*********** # 552 **************
PokerStars Hand #176682569708: Tournament #2054568934, $20+$2 USD Hold'em No Limit - Level L (300000/600000) - 2017/10/09 9:05:05 MSK [2017/10/09 2:05:05 ET]
Table '2054568934 624' 9-max Seat #9 is the button
Seat 1: youdri15 (9029464 in chips)
Seat 2: 4time2warp0 (12895972 in chips)
Seat 3: AtilaMoreira (10993238 in chips)
Seat 4: hichnick777 (7134580 in chips)
Seat 6: maxsi10 (7017758 in chips)
Seat 8: casey1186 (32910336 in chips)
Seat 9: AYoshiK (10748652 in chips)
youdri15: posts the ante 60000
4time2warp0: posts the ante 60000
AtilaMoreira: posts the ante 60000
hichnick777: posts the ante 60000
maxsi10: posts the ante 60000
casey1186: posts the ante 60000
AYoshiK: posts the ante 60000
youdri15: posts small blind 300000
4time2warp0: posts big blind 600000
*** HOLE CARDS ***
Dealt to hichnick777 [Qc 6c]
AtilaMoreira: folds
hichnick777: folds
maxsi10: folds
casey1186: folds
AYoshiK: folds
youdri15: raises 1200000 to 1800000
4time2warp0: folds
Uncalled bet (1200000) returned to youdri15
youdri15 collected 1620000 from pot
youdri15: doesn't show hand
*** SUMMARY ***
Total pot 1620000 | Rake 0
Seat 1: youdri15 (small blind) collected (1620000)
Seat 2: 4time2warp0 (big blind) folded before Flop
Seat 3: AtilaMoreira folded before Flop (didn't bet)
Seat 4: hichnick777 folded before Flop (didn't bet)
Seat 6: maxsi10 folded before Flop (didn't bet)
Seat 8: casey1186 folded before Flop (didn't bet)
Seat 9: AYoshiK (button) folded before Flop (didn't bet)


*********** # 553 **************
PokerStars Hand #176682577785: Tournament #2054568934, $20+$2 USD Hold'em No Limit - Level L (300000/600000) - 2017/10/09 9:05:42 MSK [2017/10/09 2:05:42 ET]
Table '2054568934 624' 9-max Seat #1 is the button
Seat 1: youdri15 (9989464 in chips)
Seat 2: 4time2warp0 (12235972 in chips)
Seat 3: AtilaMoreira (10933238 in chips)
Seat 4: hichnick777 (7074580 in chips)
Seat 6: maxsi10 (6957758 in chips)
Seat 8: casey1186 (32850336 in chips)
Seat 9: AYoshiK (10688652 in chips)
youdri15: posts the ante 60000
4time2warp0: posts the ante 60000
AtilaMoreira: posts the ante 60000
hichnick777: posts the ante 60000
maxsi10: posts the ante 60000
casey1186: posts the ante 60000
AYoshiK: posts the ante 60000
4time2warp0: posts small blind 300000
AtilaMoreira: posts big blind 600000
*** HOLE CARDS ***
Dealt to hichnick777 [As Ac]
hichnick777: raises 6414580 to 7014580 and is all-in
maxsi10: folds
casey1186: folds
AYoshiK: folds
youdri15: folds
4time2warp0: folds
AtilaMoreira: folds
Uncalled bet (6414580) returned to hichnick777
hichnick777 collected 1920000 from pot
hichnick777: doesn't show hand
*** SUMMARY ***
Total pot 1920000 | Rake 0
Seat 1: youdri15 (button) folded before Flop (didn't bet)
Seat 2: 4time2warp0 (small blind) folded before Flop
Seat 3: AtilaMoreira (big blind) folded before Flop
Seat 4: hichnick777 collected (1920000)
Seat 6: maxsi10 folded before Flop (didn't bet)
Seat 8: casey1186 folded before Flop (didn't bet)
Seat 9: AYoshiK folded before Flop (didn't bet)


*********** # 554 **************
PokerStars Hand #176682581320: Tournament #2054568934, $20+$2 USD Hold'em No Limit - Level L (300000/600000) - 2017/10/09 9:05:58 MSK [2017/10/09 2:05:58 ET]
Table '2054568934 624' 9-max Seat #2 is the button
Seat 1: youdri15 (9929464 in chips)
Seat 2: 4time2warp0 (11875972 in chips)
Seat 3: AtilaMoreira (10273238 in chips)
Seat 4: hichnick777 (8334580 in chips)
Seat 6: maxsi10 (6897758 in chips)
Seat 8: casey1186 (32790336 in chips)
Seat 9: AYoshiK (10628652 in chips)
youdri15: posts the ante 60000
4time2warp0: posts the ante 60000
AtilaMoreira: posts the ante 60000
hichnick777: posts the ante 60000
maxsi10: posts the ante 60000
casey1186: posts the ante 60000
AYoshiK: posts the ante 60000
AtilaMoreira: posts small blind 300000
hichnick777: posts big blind 600000
*** HOLE CARDS ***
Dealt to hichnick777 [Qh Kc]
maxsi10: folds
casey1186: folds
AYoshiK: raises 636000 to 1236000
youdri15: folds
4time2warp0: folds
AtilaMoreira: folds
hichnick777: raises 7038580 to 8274580 and is all-in
AYoshiK: folds
Uncalled bet (7038580) returned to hichnick777
hichnick777 collected 3192000 from pot
hichnick777: doesn't show hand
*** SUMMARY ***
Total pot 3192000 | Rake 0
Seat 1: youdri15 folded before Flop (didn't bet)
Seat 2: 4time2warp0 (button) folded before Flop (didn't bet)
Seat 3: AtilaMoreira (small blind) folded before Flop
Seat 4: hichnick777 (big blind) collected (3192000)
Seat 6: maxsi10 folded before Flop (didn't bet)
Seat 8: casey1186 folded before Flop (didn't bet)
Seat 9: AYoshiK folded before Flop


*********** # 555 **************
PokerStars Hand #176682592666: Tournament #2054568934, $20+$2 USD Hold'em No Limit - Level L (300000/600000) - 2017/10/09 9:06:50 MSK [2017/10/09 2:06:50 ET]
Table '2054568934 624' 9-max Seat #3 is the button
Seat 1: youdri15 (9869464 in chips)
Seat 2: 4time2warp0 (11815972 in chips)
Seat 3: AtilaMoreira (9913238 in chips)
Seat 4: hichnick777 (10230580 in chips)
Seat 6: maxsi10 (6837758 in chips)
Seat 8: casey1186 (32730336 in chips)
Seat 9: AYoshiK (9332652 in chips)
youdri15: posts the ante 60000
4time2warp0: posts the ante 60000
AtilaMoreira: posts the ante 60000
hichnick777: posts the ante 60000
maxsi10: posts the ante 60000
casey1186: posts the ante 60000
AYoshiK: posts the ante 60000
hichnick777: posts small blind 300000
maxsi10: posts big blind 600000
*** HOLE CARDS ***
Dealt to hichnick777 [2c 8h]
casey1186: folds
AYoshiK: folds
youdri15: folds
4time2warp0: raises 600000 to 1200000
AtilaMoreira: folds
hichnick777: folds
maxsi10: folds
Uncalled bet (600000) returned to 4time2warp0
4time2warp0 collected 1920000 from pot
4time2warp0: doesn't show hand
*** SUMMARY ***
Total pot 1920000 | Rake 0
Seat 1: youdri15 folded before Flop (didn't bet)
Seat 2: 4time2warp0 collected (1920000)
Seat 3: AtilaMoreira (button) folded before Flop (didn't bet)
Seat 4: hichnick777 (small blind) folded before Flop
Seat 6: maxsi10 (big blind) folded before Flop
Seat 8: casey1186 folded before Flop (didn't bet)
Seat 9: AYoshiK folded before Flop (didn't bet)


*********** # 556 **************
PokerStars Hand #176682596517: Tournament #2054568934, $20+$2 USD Hold'em No Limit - Level L (300000/600000) - 2017/10/09 9:07:08 MSK [2017/10/09 2:07:08 ET]
Table '2054568934 624' 9-max Seat #4 is the button
Seat 1: youdri15 (9809464 in chips)
Seat 2: 4time2warp0 (13075972 in chips)
Seat 3: AtilaMoreira (9853238 in chips)
Seat 4: hichnick777 (9870580 in chips)
Seat 6: maxsi10 (6177758 in chips)
Seat 8: casey1186 (32670336 in chips)
Seat 9: AYoshiK (9272652 in chips)
youdri15: posts the ante 60000
4time2warp0: posts the ante 60000
AtilaMoreira: posts the ante 60000
hichnick777: posts the ante 60000
maxsi10: posts the ante 60000
casey1186: posts the ante 60000
AYoshiK: posts the ante 60000
maxsi10: posts small blind 300000
casey1186: posts big blind 600000
*** HOLE CARDS ***
Dealt to hichnick777 [Th 5h]
AYoshiK: folds
youdri15: folds
4time2warp0: folds
AtilaMoreira: raises 9193238 to 9793238 and is all-in
hichnick777: folds
maxsi10: folds
casey1186: folds
Uncalled bet (9193238) returned to AtilaMoreira
AtilaMoreira collected 1920000 from pot
AtilaMoreira: doesn't show hand
*** SUMMARY ***
Total pot 1920000 | Rake 0
Seat 1: youdri15 folded before Flop (didn't bet)
Seat 2: 4time2warp0 folded before Flop (didn't bet)
Seat 3: AtilaMoreira collected (1920000)
Seat 4: hichnick777 (button) folded before Flop (didn't bet)
Seat 6: maxsi10 (small blind) folded before Flop
Seat 8: casey1186 (big blind) folded before Flop
Seat 9: AYoshiK folded before Flop (didn't bet)


*********** # 557 **************
PokerStars Hand #176682603417: Tournament #2054568934, $20+$2 USD Hold'em No Limit - Level L (300000/600000) - 2017/10/09 9:07:41 MSK [2017/10/09 2:07:41 ET]
Table '2054568934 624' 9-max Seat #6 is the button
Seat 1: youdri15 (9749464 in chips)
Seat 2: 4time2warp0 (13015972 in chips)
Seat 3: AtilaMoreira (11113238 in chips)
Seat 4: hichnick777 (9810580 in chips)
Seat 6: maxsi10 (5817758 in chips)
Seat 8: casey1186 (32010336 in chips)
Seat 9: AYoshiK (9212652 in chips)
youdri15: posts the ante 60000
4time2warp0: posts the ante 60000
AtilaMoreira: posts the ante 60000
hichnick777: posts the ante 60000
maxsi10: posts the ante 60000
casey1186: posts the ante 60000
AYoshiK: posts the ante 60000
casey1186: posts small blind 300000
AYoshiK: posts big blind 600000
*** HOLE CARDS ***
Dealt to hichnick777 [5s 2d]
youdri15: raises 600000 to 1200000
4time2warp0: folds
AtilaMoreira: folds
hichnick777: folds
maxsi10: folds
casey1186: calls 900000
AYoshiK: folds
*** FLOP *** [4d 7d Ks]
casey1186: bets 1710000
youdri15: folds
Uncalled bet (1710000) returned to casey1186
casey1186 collected 3420000 from pot
casey1186: doesn't show hand
*** SUMMARY ***
Total pot 3420000 | Rake 0
Board [4d 7d Ks]
Seat 1: youdri15 folded on the Flop
Seat 2: 4time2warp0 folded before Flop (didn't bet)
Seat 3: AtilaMoreira folded before Flop (didn't bet)
Seat 4: hichnick777 folded before Flop (didn't bet)
Seat 6: maxsi10 (button) folded before Flop (didn't bet)
Seat 8: casey1186 (small blind) collected (3420000)
Seat 9: AYoshiK (big blind) folded before Flop


*********** # 558 **************
PokerStars Hand #176682621841: Tournament #2054568934, $20+$2 USD Hold'em No Limit - Level L (300000/600000) - 2017/10/09 9:08:25 MSK [2017/10/09 2:08:25 ET]
Table '2054568934 624' 9-max Seat #8 is the button
Seat 1: youdri15 (8489464 in chips)
Seat 2: 4time2warp0 (12955972 in chips)
Seat 3: AtilaMoreira (11053238 in chips)
Seat 4: hichnick777 (9750580 in chips)
Seat 6: maxsi10 (5757758 in chips)
Seat 8: casey1186 (34170336 in chips)
Seat 9: AYoshiK (8552652 in chips)
youdri15: posts the ante 60000
4time2warp0: posts the ante 60000
AtilaMoreira: posts the ante 60000
hichnick777: posts the ante 60000
maxsi10: posts the ante 60000
casey1186: posts the ante 60000
AYoshiK: posts the ante 60000
AYoshiK: posts small blind 300000
youdri15: posts big blind 600000
*** HOLE CARDS ***
Dealt to hichnick777 [Ad 8h]
4time2warp0: raises 600000 to 1200000
AtilaMoreira: folds
hichnick777: folds
maxsi10: folds
casey1186: folds
AYoshiK: raises 7292652 to 8492652 and is all-in
youdri15: folds
4time2warp0: folds
Uncalled bet (7292652) returned to AYoshiK
AYoshiK collected 3420000 from pot
AYoshiK: doesn't show hand
*** SUMMARY ***
Total pot 3420000 | Rake 0
Seat 1: youdri15 (big blind) folded before Flop
Seat 2: 4time2warp0 folded before Flop
Seat 3: AtilaMoreira folded before Flop (didn't bet)
Seat 4: hichnick777 folded before Flop (didn't bet)
Seat 6: maxsi10 folded before Flop (didn't bet)
Seat 8: casey1186 (button) folded before Flop (didn't bet)
Seat 9: AYoshiK (small blind) collected (3420000)


*********** # 559 **************
PokerStars Hand #176682626170: Tournament #2054568934, $20+$2 USD Hold'em No Limit - Level L (300000/600000) - 2017/10/09 9:08:46 MSK [2017/10/09 2:08:46 ET]
Table '2054568934 624' 9-max Seat #9 is the button
Seat 1: youdri15 (7829464 in chips)
Seat 2: 4time2warp0 (11695972 in chips)
Seat 3: AtilaMoreira (10993238 in chips)
Seat 4: hichnick777 (9690580 in chips)
Seat 6: maxsi10 (5697758 in chips)
Seat 8: casey1186 (34110336 in chips)
Seat 9: AYoshiK (10712652 in chips)
youdri15: posts the ante 60000
4time2warp0: posts the ante 60000
AtilaMoreira: posts the ante 60000
hichnick777: posts the ante 60000
maxsi10: posts the ante 60000
casey1186: posts the ante 60000
AYoshiK: posts the ante 60000
youdri15: posts small blind 300000
4time2warp0: posts big blind 600000
*** HOLE CARDS ***
Dealt to hichnick777 [Qd 2c]
AtilaMoreira: folds
hichnick777: folds
maxsi10: folds
casey1186: raises 1200000 to 1800000
AYoshiK: folds
youdri15: folds
4time2warp0: folds
Uncalled bet (1200000) returned to casey1186
casey1186 collected 1920000 from pot
casey1186: doesn't show hand
*** SUMMARY ***
Total pot 1920000 | Rake 0
Seat 1: youdri15 (small blind) folded before Flop
Seat 2: 4time2warp0 (big blind) folded before Flop
Seat 3: AtilaMoreira folded before Flop (didn't bet)
Seat 4: hichnick777 folded before Flop (didn't bet)
Seat 6: maxsi10 folded before Flop (didn't bet)
Seat 8: casey1186 collected (1920000)
Seat 9: AYoshiK (button) folded before Flop (didn't bet)


*********** # 560 **************
PokerStars Hand #176682629105: Tournament #2054568934, $20+$2 USD Hold'em No Limit - Level L (300000/600000) - 2017/10/09 9:08:59 MSK [2017/10/09 2:08:59 ET]
Table '2054568934 624' 9-max Seat #1 is the button
Seat 1: youdri15 (7469464 in chips)
Seat 2: 4time2warp0 (11035972 in chips)
Seat 3: AtilaMoreira (10933238 in chips)
Seat 4: hichnick777 (9630580 in chips)
Seat 6: maxsi10 (5637758 in chips)
Seat 8: casey1186 (35370336 in chips)
Seat 9: AYoshiK (10652652 in chips)
youdri15: posts the ante 60000
4time2warp0: posts the ante 60000
AtilaMoreira: posts the ante 60000
hichnick777: posts the ante 60000
maxsi10: posts the ante 60000
casey1186: posts the ante 60000
AYoshiK: posts the ante 60000
4time2warp0: posts small blind 300000
AtilaMoreira: posts big blind 600000
*** HOLE CARDS ***
Dealt to hichnick777 [7c 8s]
hichnick777: folds
maxsi10: raises 4977758 to 5577758 and is all-in
casey1186: folds
AYoshiK: folds
youdri15: folds
4time2warp0: folds
AtilaMoreira: folds
Uncalled bet (4977758) returned to maxsi10
maxsi10 collected 1920000 from pot
*** SUMMARY ***
Total pot 1920000 | Rake 0
Seat 1: youdri15 (button) folded before Flop (didn't bet)
Seat 2: 4time2warp0 (small blind) folded before Flop
Seat 3: AtilaMoreira (big blind) folded before Flop
Seat 4: hichnick777 folded before Flop (didn't bet)
Seat 6: maxsi10 collected (1920000)
Seat 8: casey1186 folded before Flop (didn't bet)
Seat 9: AYoshiK folded before Flop (didn't bet)


*********** # 561 **************
PokerStars Hand #176682631893: Tournament #2054568934, $20+$2 USD Hold'em No Limit - Level L (300000/600000) - 2017/10/09 9:09:12 MSK [2017/10/09 2:09:12 ET]
Table '2054568934 624' 9-max Seat #2 is the button
Seat 1: youdri15 (7409464 in chips)
Seat 2: 4time2warp0 (10675972 in chips)
Seat 3: AtilaMoreira (10273238 in chips)
Seat 4: hichnick777 (9570580 in chips)
Seat 6: maxsi10 (6897758 in chips)
Seat 8: casey1186 (35310336 in chips)
Seat 9: AYoshiK (10592652 in chips)
youdri15: posts the ante 60000
4time2warp0: posts the ante 60000
AtilaMoreira: posts the ante 60000
hichnick777: posts the ante 60000
maxsi10: posts the ante 60000
casey1186: posts the ante 60000
AYoshiK: posts the ante 60000
AtilaMoreira: posts small blind 300000
hichnick777: posts big blind 600000
*** HOLE CARDS ***
Dealt to hichnick777 [Ts 3c]
maxsi10: folds
casey1186: folds
AYoshiK: folds
youdri15: raises 600000 to 1200000
4time2warp0: folds
AtilaMoreira: folds
hichnick777: folds
Uncalled bet (600000) returned to youdri15
youdri15 collected 1920000 from pot
youdri15: doesn't show hand
*** SUMMARY ***
Total pot 1920000 | Rake 0
Seat 1: youdri15 collected (1920000)
Seat 2: 4time2warp0 (button) folded before Flop (didn't bet)
Seat 3: AtilaMoreira (small blind) folded before Flop
Seat 4: hichnick777 (big blind) folded before Flop
Seat 6: maxsi10 folded before Flop (didn't bet)
Seat 8: casey1186 folded before Flop (didn't bet)
Seat 9: AYoshiK folded before Flop (didn't bet)


*********** # 562 **************
PokerStars Hand #176682635450: Tournament #2054568934, $20+$2 USD Hold'em No Limit - Level L (300000/600000) - 2017/10/09 9:09:29 MSK [2017/10/09 2:09:29 ET]
Table '2054568934 624' 9-max Seat #3 is the button
Seat 1: youdri15 (8669464 in chips)
Seat 2: 4time2warp0 (10615972 in chips)
Seat 3: AtilaMoreira (9913238 in chips)
Seat 4: hichnick777 (8910580 in chips)
Seat 6: maxsi10 (6837758 in chips)
Seat 8: casey1186 (35250336 in chips)
Seat 9: AYoshiK (10532652 in chips)
youdri15: posts the ante 60000
4time2warp0: posts the ante 60000
AtilaMoreira: posts the ante 60000
hichnick777: posts the ante 60000
maxsi10: posts the ante 60000
casey1186: posts the ante 60000
AYoshiK: posts the ante 60000
hichnick777: posts small blind 300000
maxsi10: posts big blind 600000
*** HOLE CARDS ***
Dealt to hichnick777 [Qc Kc]
casey1186: folds
AYoshiK: folds
youdri15: folds
4time2warp0: folds
AtilaMoreira: raises 600000 to 1200000
hichnick777: raises 7650580 to 8850580 and is all-in
maxsi10: folds
AtilaMoreira: folds
Uncalled bet (7650580) returned to hichnick777
hichnick777 collected 3420000 from pot
hichnick777: doesn't show hand
*** SUMMARY ***
Total pot 3420000 | Rake 0
Seat 1: youdri15 folded before Flop (didn't bet)
Seat 2: 4time2warp0 folded before Flop (didn't bet)
Seat 3: AtilaMoreira (button) folded before Flop
Seat 4: hichnick777 (small blind) collected (3420000)
Seat 6: maxsi10 (big blind) folded before Flop
Seat 8: casey1186 folded before Flop (didn't bet)
Seat 9: AYoshiK folded before Flop (didn't bet)


*********** # 563 **************
PokerStars Hand #176682645490: Tournament #2054568934, $20+$2 USD Hold'em No Limit - Level L (300000/600000) - 2017/10/09 9:10:15 MSK [2017/10/09 2:10:15 ET]
Table '2054568934 624' 9-max Seat #4 is the button
Seat 1: youdri15 (8609464 in chips)
Seat 2: 4time2warp0 (10555972 in chips)
Seat 3: AtilaMoreira (8653238 in chips)
Seat 4: hichnick777 (11070580 in chips)
Seat 6: maxsi10 (6177758 in chips)
Seat 8: casey1186 (35190336 in chips)
Seat 9: AYoshiK (10472652 in chips)
youdri15: posts the ante 60000
4time2warp0: posts the ante 60000
AtilaMoreira: posts the ante 60000
hichnick777: posts the ante 60000
maxsi10: posts the ante 60000
casey1186: posts the ante 60000
AYoshiK: posts the ante 60000
maxsi10: posts small blind 300000
casey1186: posts big blind 600000
*** HOLE CARDS ***
Dealt to hichnick777 [Qs 4c]
AYoshiK: folds
youdri15: folds
4time2warp0: folds
AtilaMoreira: folds
hichnick777: folds
maxsi10: raises 5517758 to 6117758 and is all-in
casey1186: folds
Uncalled bet (5517758) returned to maxsi10
maxsi10 collected 1620000 from pot
*** SUMMARY ***
Total pot 1620000 | Rake 0
Seat 1: youdri15 folded before Flop (didn't bet)
Seat 2: 4time2warp0 folded before Flop (didn't bet)
Seat 3: AtilaMoreira folded before Flop (didn't bet)
Seat 4: hichnick777 (button) folded before Flop (didn't bet)
Seat 6: maxsi10 (small blind) collected (1620000)
Seat 8: casey1186 (big blind) folded before Flop
Seat 9: AYoshiK folded before Flop (didn't bet)


*********** # 564 **************
PokerStars Hand #176682648472: Tournament #2054568934, $20+$2 USD Hold'em No Limit - Level L (300000/600000) - 2017/10/09 9:10:29 MSK [2017/10/09 2:10:29 ET]
Table '2054568934 624' 9-max Seat #6 is the button
Seat 1: youdri15 (8549464 in chips)
Seat 2: 4time2warp0 (10495972 in chips)
Seat 3: AtilaMoreira (8593238 in chips)
Seat 4: hichnick777 (11010580 in chips)
Seat 6: maxsi10 (7137758 in chips)
Seat 8: casey1186 (34530336 in chips)
Seat 9: AYoshiK (10412652 in chips)
youdri15: posts the ante 60000
4time2warp0: posts the ante 60000
AtilaMoreira: posts the ante 60000
hichnick777: posts the ante 60000
maxsi10: posts the ante 60000
casey1186: posts the ante 60000
AYoshiK: posts the ante 60000
casey1186: posts small blind 300000
AYoshiK: posts big blind 600000
*** HOLE CARDS ***
Dealt to hichnick777 [Th 7s]
youdri15: folds
4time2warp0: folds
AtilaMoreira: folds
hichnick777: folds
maxsi10: folds
casey1186: raises 1200000 to 1800000
AYoshiK: folds
Uncalled bet (1200000) returned to casey1186
casey1186 collected 1620000 from pot
casey1186: doesn't show hand
*** SUMMARY ***
Total pot 1620000 | Rake 0
Seat 1: youdri15 folded before Flop (didn't bet)
Seat 2: 4time2warp0 folded before Flop (didn't bet)
Seat 3: AtilaMoreira folded before Flop (didn't bet)
Seat 4: hichnick777 folded before Flop (didn't bet)
Seat 6: maxsi10 (button) folded before Flop (didn't bet)
Seat 8: casey1186 (small blind) collected (1620000)
Seat 9: AYoshiK (big blind) folded before Flop


*********** # 565 **************
PokerStars Hand #176682651728: Tournament #2054568934, $20+$2 USD Hold'em No Limit - Level L (300000/600000) - 2017/10/09 9:10:44 MSK [2017/10/09 2:10:44 ET]
Table '2054568934 624' 9-max Seat #8 is the button
Seat 1: youdri15 (8489464 in chips)
Seat 2: 4time2warp0 (10435972 in chips)
Seat 3: AtilaMoreira (8533238 in chips)
Seat 4: hichnick777 (10950580 in chips)
Seat 6: maxsi10 (7077758 in chips)
Seat 8: casey1186 (35490336 in chips)
Seat 9: AYoshiK (9752652 in chips)
youdri15: posts the ante 60000
4time2warp0: posts the ante 60000
AtilaMoreira: posts the ante 60000
hichnick777: posts the ante 60000
maxsi10: posts the ante 60000
casey1186: posts the ante 60000
AYoshiK: posts the ante 60000
AYoshiK: posts small blind 300000
youdri15: posts big blind 600000
*** HOLE CARDS ***
Dealt to hichnick777 [4d 9s]
4time2warp0: folds
AtilaMoreira: folds
hichnick777: folds
maxsi10: raises 6417758 to 7017758 and is all-in
casey1186: folds
AYoshiK: folds
youdri15: calls 6417758
*** FLOP *** [4h 5h 9h]
*** TURN *** [4h 5h 9h] [As]
*** RIVER *** [4h 5h 9h As] [8s]
*** SHOW DOWN ***
youdri15: shows [Ks Kc] (a pair of Kings)
maxsi10: shows [Ah 9c] (two pair, Aces and Nines)
maxsi10 collected 14755516 from pot
*** SUMMARY ***
Total pot 14755516 | Rake 0
Board [4h 5h 9h As 8s]
Seat 1: youdri15 (big blind) showed [Ks Kc] and lost with a pair of Kings
Seat 2: 4time2warp0 folded before Flop (didn't bet)
Seat 3: AtilaMoreira folded before Flop (didn't bet)
Seat 4: hichnick777 folded before Flop (didn't bet)
Seat 6: maxsi10 showed [Ah 9c] and won (14755516) with two pair, Aces and Nines
Seat 8: casey1186 (button) folded before Flop (didn't bet)
Seat 9: AYoshiK (small blind) folded before Flop


*********** # 566 **************
PokerStars Hand #176682661442: Tournament #2054568934, $20+$2 USD Hold'em No Limit - Level L (300000/600000) - 2017/10/09 9:11:29 MSK [2017/10/09 2:11:29 ET]
Table '2054568934 624' 9-max Seat #9 is the button
Seat 1: youdri15 (1411706 in chips)
Seat 2: 4time2warp0 (10375972 in chips)
Seat 3: AtilaMoreira (8473238 in chips)
Seat 4: hichnick777 (10890580 in chips)
Seat 6: maxsi10 (14755516 in chips)
Seat 8: casey1186 (35430336 in chips)
Seat 9: AYoshiK (9392652 in chips)
youdri15: posts the ante 60000
4time2warp0: posts the ante 60000
AtilaMoreira: posts the ante 60000
hichnick777: posts the ante 60000
maxsi10: posts the ante 60000
casey1186: posts the ante 60000
AYoshiK: posts the ante 60000
youdri15: posts small blind 300000
4time2warp0: posts big blind 600000
*** HOLE CARDS ***
Dealt to hichnick777 [8s Ks]
AtilaMoreira: folds
hichnick777: folds
youdri15 said, "pfff"
maxsi10: folds
casey1186: folds
AYoshiK: folds
youdri15: raises 751706 to 1351706 and is all-in
4time2warp0: calls 751706
*** FLOP *** [Ts Ah 3c]
*** TURN *** [Ts Ah 3c] [Ac]
*** RIVER *** [Ts Ah 3c Ac] [3s]
*** SHOW DOWN ***
youdri15: shows [Th 9h] (two pair, Aces and Tens)
4time2warp0: shows [As 7d] (a full house, Aces full of Threes)
4time2warp0 collected 3123412 from pot
youdri15 finished the tournament in 7th place and received $2405.27.
*** SUMMARY ***
Total pot 3123412 | Rake 0
Board [Ts Ah 3c Ac 3s]
Seat 1: youdri15 (small blind) showed [Th 9h] and lost with two pair, Aces and Tens
Seat 2: 4time2warp0 (big blind) showed [As 7d] and won (3123412) with a full house, Aces full of Threes
Seat 3: AtilaMoreira folded before Flop (didn't bet)
Seat 4: hichnick777 folded before Flop (didn't bet)
Seat 6: maxsi10 folded before Flop (didn't bet)
Seat 8: casey1186 folded before Flop (didn't bet)
Seat 9: AYoshiK (button) folded before Flop (didn't bet)


*********** # 567 **************
PokerStars Hand #176682667034: Tournament #2054568934, $20+$2 USD Hold'em No Limit - Level L (300000/600000) - 2017/10/09 9:11:55 MSK [2017/10/09 2:11:55 ET]
Table '2054568934 624' 9-max Seat #2 is the button
Seat 2: 4time2warp0 (12087678 in chips)
Seat 3: AtilaMoreira (8413238 in chips)
Seat 4: hichnick777 (10830580 in chips)
Seat 6: maxsi10 (14695516 in chips)
Seat 8: casey1186 (35370336 in chips)
Seat 9: AYoshiK (9332652 in chips)
4time2warp0: posts the ante 60000
AtilaMoreira: posts the ante 60000
hichnick777: posts the ante 60000
maxsi10: posts the ante 60000
casey1186: posts the ante 60000
AYoshiK: posts the ante 60000
AtilaMoreira: posts small blind 300000
hichnick777: posts big blind 600000
*** HOLE CARDS ***
Dealt to hichnick777 [3h Kd]
maxsi10: folds
casey1186: folds
AYoshiK: folds
4time2warp0: folds
AtilaMoreira: folds
Uncalled bet (300000) returned to hichnick777
hichnick777 collected 960000 from pot
hichnick777: doesn't show hand
*** SUMMARY ***
Total pot 960000 | Rake 0
Seat 2: 4time2warp0 (button) folded before Flop (didn't bet)
Seat 3: AtilaMoreira (small blind) folded before Flop
Seat 4: hichnick777 (big blind) collected (960000)
Seat 6: maxsi10 folded before Flop (didn't bet)
Seat 8: casey1186 folded before Flop (didn't bet)
Seat 9: AYoshiK folded before Flop (didn't bet)


*********** # 568 **************
PokerStars Hand #176682669706: Tournament #2054568934, $20+$2 USD Hold'em No Limit - Level L (300000/600000) - 2017/10/09 9:12:08 MSK [2017/10/09 2:12:08 ET]
Table '2054568934 624' 9-max Seat #3 is the button
Seat 2: 4time2warp0 (12027678 in chips)
Seat 3: AtilaMoreira (8053238 in chips)
Seat 4: hichnick777 (11430580 in chips)
Seat 6: maxsi10 (14635516 in chips)
Seat 8: casey1186 (35310336 in chips)
Seat 9: AYoshiK (9272652 in chips)
4time2warp0: posts the ante 60000
AtilaMoreira: posts the ante 60000
hichnick777: posts the ante 60000
maxsi10: posts the ante 60000
casey1186: posts the ante 60000
AYoshiK: posts the ante 60000
hichnick777: posts small blind 300000
maxsi10: posts big blind 600000
*** HOLE CARDS ***
Dealt to hichnick777 [7d 8d]
casey1186: raises 1200000 to 1800000
AYoshiK: folds
4time2warp0: folds
AtilaMoreira: folds
hichnick777: folds
maxsi10: folds
Uncalled bet (1200000) returned to casey1186
casey1186 collected 1860000 from pot
*** SUMMARY ***
Total pot 1860000 | Rake 0
Seat 2: 4time2warp0 folded before Flop (didn't bet)
Seat 3: AtilaMoreira (button) folded before Flop (didn't bet)
Seat 4: hichnick777 (small blind) folded before Flop
Seat 6: maxsi10 (big blind) folded before Flop
Seat 8: casey1186 collected (1860000)
Seat 9: AYoshiK folded before Flop (didn't bet)


*********** # 569 **************
PokerStars Hand #176682672059: Tournament #2054568934, $20+$2 USD Hold'em No Limit - Level L (300000/600000) - 2017/10/09 9:12:19 MSK [2017/10/09 2:12:19 ET]
Table '2054568934 624' 9-max Seat #4 is the button
Seat 2: 4time2warp0 (11967678 in chips)
Seat 3: AtilaMoreira (7993238 in chips)
Seat 4: hichnick777 (11070580 in chips)
Seat 6: maxsi10 (13975516 in chips)
Seat 8: casey1186 (36510336 in chips)
Seat 9: AYoshiK (9212652 in chips)
4time2warp0: posts the ante 60000
AtilaMoreira: posts the ante 60000
hichnick777: posts the ante 60000
maxsi10: posts the ante 60000
casey1186: posts the ante 60000
AYoshiK: posts the ante 60000
maxsi10: posts small blind 300000
casey1186: posts big blind 600000
*** HOLE CARDS ***
Dealt to hichnick777 [Qc As]
AYoshiK: folds
4time2warp0: folds
AtilaMoreira: folds
hichnick777: raises 648000 to 1248000
maxsi10: folds
casey1186: folds
Uncalled bet (648000) returned to hichnick777
hichnick777 collected 1860000 from pot
hichnick777: doesn't show hand
*** SUMMARY ***
Total pot 1860000 | Rake 0
Seat 2: 4time2warp0 folded before Flop (didn't bet)
Seat 3: AtilaMoreira folded before Flop (didn't bet)
Seat 4: hichnick777 (button) collected (1860000)
Seat 6: maxsi10 (small blind) folded before Flop
Seat 8: casey1186 (big blind) folded before Flop
Seat 9: AYoshiK folded before Flop (didn't bet)


*********** # 570 **************
PokerStars Hand #176682676548: Tournament #2054568934, $20+$2 USD Hold'em No Limit - Level L (300000/600000) - 2017/10/09 9:12:40 MSK [2017/10/09 2:12:40 ET]
Table '2054568934 624' 9-max Seat #6 is the button
Seat 2: 4time2warp0 (11907678 in chips)
Seat 3: AtilaMoreira (7933238 in chips)
Seat 4: hichnick777 (12270580 in chips)
Seat 6: maxsi10 (13615516 in chips)
Seat 8: casey1186 (35850336 in chips)
Seat 9: AYoshiK (9152652 in chips)
4time2warp0: posts the ante 60000
AtilaMoreira: posts the ante 60000
hichnick777: posts the ante 60000
maxsi10: posts the ante 60000
casey1186: posts the ante 60000
AYoshiK: posts the ante 60000
casey1186: posts small blind 300000
AYoshiK: posts big blind 600000
*** HOLE CARDS ***
Dealt to hichnick777 [8d 3d]
4time2warp0: folds
AtilaMoreira: folds
hichnick777: folds
maxsi10: raises 600000 to 1200000
casey1186: folds
AYoshiK: raises 7892652 to 9092652 and is all-in
maxsi10: folds
Uncalled bet (7892652) returned to AYoshiK
AYoshiK collected 3060000 from pot
AYoshiK: doesn't show hand
*** SUMMARY ***
Total pot 3060000 | Rake 0
Seat 2: 4time2warp0 folded before Flop (didn't bet)
Seat 3: AtilaMoreira folded before Flop (didn't bet)
Seat 4: hichnick777 folded before Flop (didn't bet)
Seat 6: maxsi10 (button) folded before Flop
Seat 8: casey1186 (small blind) folded before Flop
Seat 9: AYoshiK (big blind) collected (3060000)


*********** # 571 **************
PokerStars Hand #176682680397: Tournament #2054568934, $20+$2 USD Hold'em No Limit - Level L (300000/600000) - 2017/10/09 9:12:58 MSK [2017/10/09 2:12:58 ET]
Table '2054568934 624' 9-max Seat #8 is the button
Seat 2: 4time2warp0 (11847678 in chips)
Seat 3: AtilaMoreira (7873238 in chips)
Seat 4: hichnick777 (12210580 in chips)
Seat 6: maxsi10 (12355516 in chips)
Seat 8: casey1186 (35490336 in chips)
Seat 9: AYoshiK (10952652 in chips)
4time2warp0: posts the ante 60000
AtilaMoreira: posts the ante 60000
hichnick777: posts the ante 60000
maxsi10: posts the ante 60000
casey1186: posts the ante 60000
AYoshiK: posts the ante 60000
AYoshiK: posts small blind 300000
4time2warp0: posts big blind 600000
*** HOLE CARDS ***
Dealt to hichnick777 [5d 8s]
AtilaMoreira: folds
hichnick777: folds
maxsi10: folds
casey1186: raises 1860000 to 2460000
AYoshiK: folds
4time2warp0: raises 9327678 to 11787678 and is all-in
casey1186: calls 9327678
*** FLOP *** [6h Qs Tc]
*** TURN *** [6h Qs Tc] [Ts]
*** RIVER *** [6h Qs Tc Ts] [Kd]
*** SHOW DOWN ***
4time2warp0: shows [Kh Ac] (two pair, Kings and Tens)
casey1186: shows [As 9s] (a pair of Tens)
4time2warp0 collected 24235356 from pot
*** SUMMARY ***
Total pot 24235356 | Rake 0
Board [6h Qs Tc Ts Kd]
Seat 2: 4time2warp0 (big blind) showed [Kh Ac] and won (24235356) with two pair, Kings and Tens
Seat 3: AtilaMoreira folded before Flop (didn't bet)
Seat 4: hichnick777 folded before Flop (didn't bet)
Seat 6: maxsi10 folded before Flop (didn't bet)
Seat 8: casey1186 (button) showed [As 9s] and lost with a pair of Tens
Seat 9: AYoshiK (small blind) folded before Flop


*********** # 572 **************
PokerStars Hand #176682685560: Tournament #2054568934, $20+$2 USD Hold'em No Limit - Level L (300000/600000) - 2017/10/09 9:13:22 MSK [2017/10/09 2:13:22 ET]
Table '2054568934 624' 9-max Seat #9 is the button
Seat 2: 4time2warp0 (24235356 in chips)
Seat 3: AtilaMoreira (7813238 in chips)
Seat 4: hichnick777 (12150580 in chips)
Seat 6: maxsi10 (12295516 in chips)
Seat 8: casey1186 (23642658 in chips)
Seat 9: AYoshiK (10592652 in chips)
4time2warp0: posts the ante 60000
AtilaMoreira: posts the ante 60000
hichnick777: posts the ante 60000
maxsi10: posts the ante 60000
casey1186: posts the ante 60000
AYoshiK: posts the ante 60000
4time2warp0: posts small blind 300000
AtilaMoreira: posts big blind 600000
*** HOLE CARDS ***
Dealt to hichnick777 [Ts 5d]
hichnick777: folds
maxsi10: folds
casey1186: raises 1200000 to 1800000
AYoshiK: folds
4time2warp0: folds
AtilaMoreira: folds
Uncalled bet (1200000) returned to casey1186
casey1186 collected 1860000 from pot
casey1186: doesn't show hand
*** SUMMARY ***
Total pot 1860000 | Rake 0
Seat 2: 4time2warp0 (small blind) folded before Flop
Seat 3: AtilaMoreira (big blind) folded before Flop
Seat 4: hichnick777 folded before Flop (didn't bet)
Seat 6: maxsi10 folded before Flop (didn't bet)
Seat 8: casey1186 collected (1860000)
Seat 9: AYoshiK (button) folded before Flop (didn't bet)


*********** # 573 **************
PokerStars Hand #176682687872: Tournament #2054568934, $20+$2 USD Hold'em No Limit - Level L (300000/600000) - 2017/10/09 9:13:33 MSK [2017/10/09 2:13:33 ET]
Table '2054568934 624' 9-max Seat #2 is the button
Seat 2: 4time2warp0 (23875356 in chips)
Seat 3: AtilaMoreira (7153238 in chips)
Seat 4: hichnick777 (12090580 in chips)
Seat 6: maxsi10 (12235516 in chips)
Seat 8: casey1186 (24842658 in chips)
Seat 9: AYoshiK (10532652 in chips)
4time2warp0: posts the ante 60000
AtilaMoreira: posts the ante 60000
hichnick777: posts the ante 60000
maxsi10: posts the ante 60000
casey1186: posts the ante 60000
AYoshiK: posts the ante 60000
AtilaMoreira: posts small blind 300000
hichnick777: posts big blind 600000
*** HOLE CARDS ***
Dealt to hichnick777 [6d Jh]
maxsi10: folds
casey1186: raises 1200000 to 1800000
AYoshiK: folds
4time2warp0: folds
AtilaMoreira: folds
hichnick777: folds
Uncalled bet (1200000) returned to casey1186
casey1186 collected 1860000 from pot
casey1186: doesn't show hand
*** SUMMARY ***
Total pot 1860000 | Rake 0
Seat 2: 4time2warp0 (button) folded before Flop (didn't bet)
Seat 3: AtilaMoreira (small blind) folded before Flop
Seat 4: hichnick777 (big blind) folded before Flop
Seat 6: maxsi10 folded before Flop (didn't bet)
Seat 8: casey1186 collected (1860000)
Seat 9: AYoshiK folded before Flop (didn't bet)


*********** # 574 **************
PokerStars Hand #176682691885: Tournament #2054568934, $20+$2 USD Hold'em No Limit - Level L (300000/600000) - 2017/10/09 9:13:51 MSK [2017/10/09 2:13:51 ET]
Table '2054568934 624' 9-max Seat #3 is the button
Seat 2: 4time2warp0 (23815356 in chips)
Seat 3: AtilaMoreira (6793238 in chips)
Seat 4: hichnick777 (11430580 in chips)
Seat 6: maxsi10 (12175516 in chips)
Seat 8: casey1186 (26042658 in chips)
Seat 9: AYoshiK (10472652 in chips)
4time2warp0: posts the ante 60000
AtilaMoreira: posts the ante 60000
hichnick777: posts the ante 60000
maxsi10: posts the ante 60000
casey1186: posts the ante 60000
AYoshiK: posts the ante 60000
hichnick777: posts small blind 300000
maxsi10: posts big blind 600000
*** HOLE CARDS ***
Dealt to hichnick777 [2d 3s]
casey1186: folds
AYoshiK: raises 9812652 to 10412652 and is all-in
4time2warp0: folds
AtilaMoreira: folds
hichnick777: folds
maxsi10: folds
Uncalled bet (9812652) returned to AYoshiK
AYoshiK collected 1860000 from pot
AYoshiK: doesn't show hand
*** SUMMARY ***
Total pot 1860000 | Rake 0
Seat 2: 4time2warp0 folded before Flop (didn't bet)
Seat 3: AtilaMoreira (button) folded before Flop (didn't bet)
Seat 4: hichnick777 (small blind) folded before Flop
Seat 6: maxsi10 (big blind) folded before Flop
Seat 8: casey1186 folded before Flop (didn't bet)
Seat 9: AYoshiK collected (1860000)


*********** # 575 **************
PokerStars Hand #176682694169: Tournament #2054568934, $20+$2 USD Hold'em No Limit - Level L (300000/600000) - 2017/10/09 9:14:02 MSK [2017/10/09 2:14:02 ET]
Table '2054568934 624' 9-max Seat #4 is the button
Seat 2: 4time2warp0 (23755356 in chips)
Seat 3: AtilaMoreira (6733238 in chips)
Seat 4: hichnick777 (11070580 in chips)
Seat 6: maxsi10 (11515516 in chips)
Seat 8: casey1186 (25982658 in chips)
Seat 9: AYoshiK (11672652 in chips)
4time2warp0: posts the ante 60000
AtilaMoreira: posts the ante 60000
hichnick777: posts the ante 60000
maxsi10: posts the ante 60000
casey1186: posts the ante 60000
AYoshiK: posts the ante 60000
maxsi10: posts small blind 300000
casey1186: posts big blind 600000
*** HOLE CARDS ***
Dealt to hichnick777 [Jd Ah]
AYoshiK: folds
4time2warp0: folds
AtilaMoreira: folds
AYoshiK said, "what about numbz guys??"
hichnick777: raises 648000 to 1248000
maxsi10: folds
casey1186: folds
Uncalled bet (648000) returned to hichnick777
hichnick777 collected 1860000 from pot
hichnick777: doesn't show hand
*** SUMMARY ***
Total pot 1860000 | Rake 0
Seat 2: 4time2warp0 folded before Flop (didn't bet)
Seat 3: AtilaMoreira folded before Flop (didn't bet)
Seat 4: hichnick777 (button) collected (1860000)
Seat 6: maxsi10 (small blind) folded before Flop
Seat 8: casey1186 (big blind) folded before Flop
Seat 9: AYoshiK folded before Flop (didn't bet)


*********** # 576 **************
PokerStars Hand #176682700832: Tournament #2054568934, $20+$2 USD Hold'em No Limit - Level LI (350000/700000) - 2017/10/09 9:14:33 MSK [2017/10/09 2:14:33 ET]
Table '2054568934 624' 9-max Seat #6 is the button
Seat 2: 4time2warp0 (23695356 in chips)
Seat 3: AtilaMoreira (6673238 in chips)
Seat 4: hichnick777 (12270580 in chips)
Seat 6: maxsi10 (11155516 in chips)
Seat 8: casey1186 (25322658 in chips)
Seat 9: AYoshiK (11612652 in chips)
4time2warp0: posts the ante 70000
AtilaMoreira: posts the ante 70000
hichnick777: posts the ante 70000
maxsi10: posts the ante 70000
casey1186: posts the ante 70000
AYoshiK: posts the ante 70000
casey1186: posts small blind 350000
AYoshiK: posts big blind 700000
*** HOLE CARDS ***
Dealt to hichnick777 [7d 9c]
casey1186 said, "i've clicked it"
4time2warp0: folds
maxsi10 said, "i want"
AtilaMoreira: raises 5903238 to 6603238 and is all-in
hichnick777: folds
maxsi10: folds
casey1186: folds
AYoshiK: folds
Uncalled bet (5903238) returned to AtilaMoreira
AtilaMoreira collected 2170000 from pot
*** SUMMARY ***
Total pot 2170000 | Rake 0
Seat 2: 4time2warp0 folded before Flop (didn't bet)
Seat 3: AtilaMoreira collected (2170000)
Seat 4: hichnick777 folded before Flop (didn't bet)
Seat 6: maxsi10 (button) folded before Flop (didn't bet)
Seat 8: casey1186 (small blind) folded before Flop
Seat 9: AYoshiK (big blind) folded before Flop


*********** # 577 **************
PokerStars Hand #176682707500: Tournament #2054568934, $20+$2 USD Hold'em No Limit - Level LI (350000/700000) - 2017/10/09 9:15:03 MSK [2017/10/09 2:15:03 ET]
Table '2054568934 624' 9-max Seat #8 is the button
Seat 2: 4time2warp0 (23625356 in chips)
Seat 3: AtilaMoreira (8073238 in chips)
Seat 4: hichnick777 (12200580 in chips)
Seat 6: maxsi10 (11085516 in chips)
Seat 8: casey1186 (24902658 in chips)
Seat 9: AYoshiK (10842652 in chips)
4time2warp0: posts the ante 70000
AtilaMoreira: posts the ante 70000
hichnick777: posts the ante 70000
maxsi10: posts the ante 70000
casey1186: posts the ante 70000
AYoshiK: posts the ante 70000
AYoshiK: posts small blind 350000
4time2warp0: posts big blind 700000
*** HOLE CARDS ***
Dealt to hichnick777 [5c Th]
AtilaMoreira: raises 7303238 to 8003238 and is all-in
hichnick777: folds
maxsi10: folds
casey1186: folds
AYoshiK: folds
4time2warp0: folds
Uncalled bet (7303238) returned to AtilaMoreira
AtilaMoreira collected 2170000 from pot
*** SUMMARY ***
Total pot 2170000 | Rake 0
Seat 2: 4time2warp0 (big blind) folded before Flop
Seat 3: AtilaMoreira collected (2170000)
Seat 4: hichnick777 folded before Flop (didn't bet)
Seat 6: maxsi10 folded before Flop (didn't bet)
Seat 8: casey1186 (button) folded before Flop (didn't bet)
Seat 9: AYoshiK (small blind) folded before Flop


*********** # 578 **************
PokerStars Hand #176682711537: Tournament #2054568934, $20+$2 USD Hold'em No Limit - Level LI (350000/700000) - 2017/10/09 9:15:22 MSK [2017/10/09 2:15:22 ET]
Table '2054568934 624' 9-max Seat #9 is the button
Seat 2: 4time2warp0 (22855356 in chips)
Seat 3: AtilaMoreira (9473238 in chips)
Seat 4: hichnick777 (12130580 in chips)
Seat 6: maxsi10 (11015516 in chips)
Seat 8: casey1186 (24832658 in chips)
Seat 9: AYoshiK (10422652 in chips)
4time2warp0: posts the ante 70000
AtilaMoreira: posts the ante 70000
hichnick777: posts the ante 70000
maxsi10: posts the ante 70000
casey1186: posts the ante 70000
AYoshiK: posts the ante 70000
4time2warp0: posts small blind 350000
AtilaMoreira: posts big blind 700000
*** HOLE CARDS ***
Dealt to hichnick777 [Jd 7s]
hichnick777: folds
maxsi10: folds
casey1186: folds
AYoshiK: raises 9652652 to 10352652 and is all-in
4time2warp0: folds
AtilaMoreira: folds
Uncalled bet (9652652) returned to AYoshiK
AYoshiK collected 2170000 from pot
AYoshiK: doesn't show hand
*** SUMMARY ***
Total pot 2170000 | Rake 0
Seat 2: 4time2warp0 (small blind) folded before Flop
Seat 3: AtilaMoreira (big blind) folded before Flop
Seat 4: hichnick777 folded before Flop (didn't bet)
Seat 6: maxsi10 folded before Flop (didn't bet)
Seat 8: casey1186 folded before Flop (didn't bet)
Seat 9: AYoshiK (button) collected (2170000)


*********** # 579 **************
PokerStars Hand #176682714112: Tournament #2054568934, $20+$2 USD Hold'em No Limit - Level LI (350000/700000) - 2017/10/09 9:15:34 MSK [2017/10/09 2:15:34 ET]
Table '2054568934 624' 9-max Seat #2 is the button
Seat 2: 4time2warp0 (22435356 in chips)
Seat 3: AtilaMoreira (8703238 in chips)
Seat 4: hichnick777 (12060580 in chips)
Seat 6: maxsi10 (10945516 in chips)
Seat 8: casey1186 (24762658 in chips)
Seat 9: AYoshiK (11822652 in chips)
4time2warp0: posts the ante 70000
AtilaMoreira: posts the ante 70000
hichnick777: posts the ante 70000
maxsi10: posts the ante 70000
casey1186: posts the ante 70000
AYoshiK: posts the ante 70000
AtilaMoreira: posts small blind 350000
hichnick777: posts big blind 700000
*** HOLE CARDS ***
Dealt to hichnick777 [9s 2c]
maxsi10: folds
casey1186: folds
AYoshiK: raises 11052652 to 11752652 and is all-in
4time2warp0: folds
AtilaMoreira: folds
hichnick777: folds
Uncalled bet (11052652) returned to AYoshiK
AYoshiK collected 2170000 from pot
AYoshiK: doesn't show hand
*** SUMMARY ***
Total pot 2170000 | Rake 0
Seat 2: 4time2warp0 (button) folded before Flop (didn't bet)
Seat 3: AtilaMoreira (small blind) folded before Flop
Seat 4: hichnick777 (big blind) folded before Flop
Seat 6: maxsi10 folded before Flop (didn't bet)
Seat 8: casey1186 folded before Flop (didn't bet)
Seat 9: AYoshiK collected (2170000)


*********** # 580 **************
PokerStars Hand #176682716674: Tournament #2054568934, $20+$2 USD Hold'em No Limit - Level LI (350000/700000) - 2017/10/09 9:15:46 MSK [2017/10/09 2:15:46 ET]
Table '2054568934 624' 9-max Seat #3 is the button
Seat 2: 4time2warp0 (22365356 in chips)
Seat 3: AtilaMoreira (8283238 in chips)
Seat 4: hichnick777 (11290580 in chips)
Seat 6: maxsi10 (10875516 in chips)
Seat 8: casey1186 (24692658 in chips)
Seat 9: AYoshiK (13222652 in chips)
4time2warp0: posts the ante 70000
AtilaMoreira: posts the ante 70000
hichnick777: posts the ante 70000
maxsi10: posts the ante 70000
casey1186: posts the ante 70000
AYoshiK: posts the ante 70000
hichnick777: posts small blind 350000
maxsi10: posts big blind 700000
*** HOLE CARDS ***
Dealt to hichnick777 [Ad Jh]
casey1186: folds
AYoshiK: folds
4time2warp0: folds
AtilaMoreira: folds
hichnick777: raises 875000 to 1575000
maxsi10: raises 9230516 to 10805516 and is all-in
hichnick777: calls 9230516
*** FLOP *** [Ac Td Kh]
*** TURN *** [Ac Td Kh] [Qc]
*** RIVER *** [Ac Td Kh Qc] [Ts]
*** SHOW DOWN ***
hichnick777: shows [Ad Jh] (a straight, Ten to Ace)
maxsi10: shows [8c Qh] (two pair, Queens and Tens)
hichnick777 collected 22031032 from pot
maxsi10 finished the tournament in 6th place and received $3497.80.
*** SUMMARY ***
Total pot 22031032 | Rake 0
Board [Ac Td Kh Qc Ts]
Seat 2: 4time2warp0 folded before Flop (didn't bet)
Seat 3: AtilaMoreira (button) folded before Flop (didn't bet)
Seat 4: hichnick777 (small blind) showed [Ad Jh] and won (22031032) with a straight, Ten to Ace
Seat 6: maxsi10 (big blind) showed [8c Qh] and lost with two pair, Queens and Tens
Seat 8: casey1186 folded before Flop (didn't bet)
Seat 9: AYoshiK folded before Flop (didn't bet)


*********** # 581 **************
PokerStars Hand #176682724135: Tournament #2054568934, $20+$2 USD Hold'em No Limit - Level LI (350000/700000) - 2017/10/09 9:16:20 MSK [2017/10/09 2:16:20 ET]
Table '2054568934 624' 9-max Seat #4 is the button
Seat 2: 4time2warp0 (22295356 in chips)
Seat 3: AtilaMoreira (8213238 in chips)
Seat 4: hichnick777 (22446096 in chips)
Seat 8: casey1186 (24622658 in chips)
Seat 9: AYoshiK (13152652 in chips)
4time2warp0: posts the ante 70000
AtilaMoreira: posts the ante 70000
hichnick777: posts the ante 70000
casey1186: posts the ante 70000
AYoshiK: posts the ante 70000
casey1186: posts small blind 350000
AYoshiK: posts big blind 700000
*** HOLE CARDS ***
Dealt to hichnick777 [6c Kh]
4time2warp0: folds
AtilaMoreira: folds
AYoshiK said, "so no numbz??"
hichnick777: raises 756000 to 1456000
casey1186: folds
casey1186 said, "i've clicked"
AYoshiK: folds
Uncalled bet (756000) returned to hichnick777
hichnick777 collected 2100000 from pot
hichnick777: doesn't show hand
*** SUMMARY ***
Total pot 2100000 | Rake 0
Seat 2: 4time2warp0 folded before Flop (didn't bet)
Seat 3: AtilaMoreira folded before Flop (didn't bet)
Seat 4: hichnick777 (button) collected (2100000)
Seat 8: casey1186 (small blind) folded before Flop
Seat 9: AYoshiK (big blind) folded before Flop


*********** # 582 **************
PokerStars Hand #176682730201: Tournament #2054568934, $20+$2 USD Hold'em No Limit - Level LI (350000/700000) - 2017/10/09 9:16:48 MSK [2017/10/09 2:16:48 ET]
Table '2054568934 624' 9-max Seat #8 is the button
Seat 2: 4time2warp0 (22225356 in chips)
Seat 3: AtilaMoreira (8143238 in chips)
Seat 4: hichnick777 (23776096 in chips)
Seat 8: casey1186 (24202658 in chips)
Seat 9: AYoshiK (12382652 in chips)
4time2warp0: posts the ante 70000
AtilaMoreira: posts the ante 70000
hichnick777: posts the ante 70000
casey1186: posts the ante 70000
AYoshiK: posts the ante 70000
AYoshiK: posts small blind 350000
4time2warp0: posts big blind 700000
*** HOLE CARDS ***
Dealt to hichnick777 [2s 5c]
AtilaMoreira: raises 7373238 to 8073238 and is all-in
hichnick777: folds
casey1186: folds
AYoshiK: folds
4time2warp0: folds
Uncalled bet (7373238) returned to AtilaMoreira
AYoshiK said, "i know you do :D"
AtilaMoreira collected 2100000 from pot
*** SUMMARY ***
Total pot 2100000 | Rake 0
Seat 2: 4time2warp0 (big blind) folded before Flop
Seat 3: AtilaMoreira collected (2100000)
Seat 4: hichnick777 folded before Flop (didn't bet)
Seat 8: casey1186 (button) folded before Flop (didn't bet)
Seat 9: AYoshiK (small blind) folded before Flop


*********** # 583 **************
PokerStars Hand #176682734364: Tournament #2054568934, $20+$2 USD Hold'em No Limit - Level LI (350000/700000) - 2017/10/09 9:17:08 MSK [2017/10/09 2:17:08 ET]
Table '2054568934 624' 9-max Seat #9 is the button
Seat 2: 4time2warp0 (21455356 in chips)
Seat 3: AtilaMoreira (9473238 in chips)
Seat 4: hichnick777 (23706096 in chips)
Seat 8: casey1186 (24132658 in chips)
Seat 9: AYoshiK (11962652 in chips)
4time2warp0: posts the ante 70000
AtilaMoreira: posts the ante 70000
hichnick777: posts the ante 70000
casey1186: posts the ante 70000
AYoshiK: posts the ante 70000
4time2warp0: posts small blind 350000
AtilaMoreira: posts big blind 700000
*** HOLE CARDS ***
Dealt to hichnick777 [Kd 9c]
hichnick777: raises 756000 to 1456000
casey1186: folds
AYoshiK: folds
4time2warp0: folds
AtilaMoreira: folds
Uncalled bet (756000) returned to hichnick777
AYoshiK said, "..but who dont..we can just see"
hichnick777 collected 2100000 from pot
hichnick777: doesn't show hand
*** SUMMARY ***
Total pot 2100000 | Rake 0
Seat 2: 4time2warp0 (small blind) folded before Flop
Seat 3: AtilaMoreira (big blind) folded before Flop
Seat 4: hichnick777 collected (2100000)
Seat 8: casey1186 folded before Flop (didn't bet)
Seat 9: AYoshiK (button) folded before Flop (didn't bet)


*********** # 584 **************
PokerStars Hand #176682739255: Tournament #2054568934, $20+$2 USD Hold'em No Limit - Level LI (350000/700000) - 2017/10/09 9:17:30 MSK [2017/10/09 2:17:30 ET]
Table '2054568934 624' 9-max Seat #2 is the button
Seat 2: 4time2warp0 (21035356 in chips)
Seat 3: AtilaMoreira (8703238 in chips)
Seat 4: hichnick777 (25036096 in chips)
Seat 8: casey1186 (24062658 in chips)
Seat 9: AYoshiK (11892652 in chips)
4time2warp0: posts the ante 70000
AtilaMoreira: posts the ante 70000
hichnick777: posts the ante 70000
casey1186: posts the ante 70000
AYoshiK: posts the ante 70000
AtilaMoreira: posts small blind 350000
hichnick777: posts big blind 700000
*** HOLE CARDS ***
Dealt to hichnick777 [Kh 6d]
casey1186: raises 700000 to 1400000
AYoshiK: folds
4time2warp0: folds
AtilaMoreira: raises 7233238 to 8633238 and is all-in
hichnick777: folds
casey1186: calls 7233238
*** FLOP *** [Th Jc 4s]
*** TURN *** [Th Jc 4s] [9s]
*** RIVER *** [Th Jc 4s 9s] [3d]
*** SHOW DOWN ***
AtilaMoreira: shows [Ac 6c] (high card Ace)
casey1186: shows [4c 4d] (three of a kind, Fours)
casey1186 collected 18316476 from pot
AtilaMoreira finished the tournament in 5th place and received $5086.57.
*** SUMMARY ***
Total pot 18316476 | Rake 0
Board [Th Jc 4s 9s 3d]
Seat 2: 4time2warp0 (button) folded before Flop (didn't bet)
Seat 3: AtilaMoreira (small blind) showed [Ac 6c] and lost with high card Ace
Seat 4: hichnick777 (big blind) folded before Flop
Seat 8: casey1186 showed [4c 4d] and won (18316476) with three of a kind, Fours
Seat 9: AYoshiK folded before Flop (didn't bet)


*********** # 585 **************
PokerStars Hand #176682746371: Tournament #2054568934, $20+$2 USD Hold'em No Limit - Level LI (350000/700000) - 2017/10/09 9:18:03 MSK [2017/10/09 2:18:03 ET]
Table '2054568934 624' 9-max Seat #4 is the button
Seat 2: 4time2warp0 (20965356 in chips)
Seat 4: hichnick777 (24266096 in chips)
Seat 8: casey1186 (33675896 in chips)
Seat 9: AYoshiK (11822652 in chips)
4time2warp0: posts the ante 70000
hichnick777: posts the ante 70000
casey1186: posts the ante 70000
AYoshiK: posts the ante 70000
casey1186: posts small blind 350000
AYoshiK: posts big blind 700000
*** HOLE CARDS ***
Dealt to hichnick777 [Ah 3c]
4time2warp0: folds
AYoshiK said, "still nothing???"
AYoshiK said, "4 time?"
hichnick777: raises 756000 to 1456000
AYoshiK said, "hich?"
casey1186: folds
4time2warp0 said, "ive clicked"
AYoshiK: folds
Uncalled bet (756000) returned to hichnick777
hichnick777 collected 2030000 from pot
hichnick777: doesn't show hand
*** SUMMARY ***
Total pot 2030000 | Rake 0
Seat 2: 4time2warp0 folded before Flop (didn't bet)
Seat 4: hichnick777 (button) collected (2030000)
Seat 8: casey1186 (small blind) folded before Flop
Seat 9: AYoshiK (big blind) folded before Flop


*********** # 586 **************
PokerStars Hand #176682752731: Tournament #2054568934, $20+$2 USD Hold'em No Limit - Level LI (350000/700000) - 2017/10/09 9:18:32 MSK [2017/10/09 2:18:32 ET]
Table '2054568934 624' 9-max Seat #8 is the button
Seat 2: 4time2warp0 (20895356 in chips)
Seat 4: hichnick777 (25526096 in chips)
Seat 8: casey1186 (33255896 in chips)
Seat 9: AYoshiK (11052652 in chips)
4time2warp0: posts the ante 70000
hichnick777: posts the ante 70000
casey1186: posts the ante 70000
AYoshiK: posts the ante 70000
AYoshiK: posts small blind 350000
4time2warp0: posts big blind 700000
*** HOLE CARDS ***
Dealt to hichnick777 [5s 7d]
AYoshiK said, "so hich?"
hichnick777: folds
casey1186: raises 1400000 to 2100000
4time2warp0 said, "dont want to have a look hich?"
AYoshiK: folds
4time2warp0: folds
Uncalled bet (1400000) returned to casey1186
casey1186 collected 2030000 from pot
casey1186: doesn't show hand
*** SUMMARY ***
Total pot 2030000 | Rake 0
Seat 2: 4time2warp0 (big blind) folded before Flop
Seat 4: hichnick777 folded before Flop (didn't bet)
Seat 8: casey1186 (button) collected (2030000)
Seat 9: AYoshiK (small blind) folded before Flop


*********** # 587 **************
PokerStars Hand #176682758833: Tournament #2054568934, $20+$2 USD Hold'em No Limit - Level LI (350000/700000) - 2017/10/09 9:19:00 MSK [2017/10/09 2:19:00 ET]
Table '2054568934 624' 9-max Seat #9 is the button
Seat 2: 4time2warp0 (20125356 in chips)
Seat 4: hichnick777 (25456096 in chips)
Seat 8: casey1186 (34515896 in chips)
Seat 9: AYoshiK (10632652 in chips)
4time2warp0: posts the ante 70000
hichnick777: posts the ante 70000
casey1186: posts the ante 70000
AYoshiK: posts the ante 70000
4time2warp0: posts small blind 350000
hichnick777: posts big blind 700000
*** HOLE CARDS ***
Dealt to hichnick777 [6s 9s]
casey1186: raises 1400000 to 2100000
AYoshiK: folds
4time2warp0: folds
hichnick777: calls 1400000
*** FLOP *** [5c Ks 7d]
hichnick777: checks
casey1186: bets 2415000
hichnick777: raises 3885000 to 6300000
casey1186: folds
Uncalled bet (3885000) returned to hichnick777
hichnick777 collected 9660000 from pot
hichnick777: doesn't show hand
*** SUMMARY ***
Total pot 9660000 | Rake 0
Board [5c Ks 7d]
Seat 2: 4time2warp0 (small blind) folded before Flop
Seat 4: hichnick777 (big blind) collected (9660000)
Seat 8: casey1186 folded on the Flop
Seat 9: AYoshiK (button) folded before Flop (didn't bet)


*********** # 588 **************
PokerStars Hand #176682772000: Tournament #2054568934, $20+$2 USD Hold'em No Limit - Level LI (350000/700000) - 2017/10/09 9:20:01 MSK [2017/10/09 2:20:01 ET]
Table '2054568934 624' 9-max Seat #2 is the button
Seat 2: 4time2warp0 (19705356 in chips)
Seat 4: hichnick777 (30531096 in chips)
Seat 8: casey1186 (29930896 in chips)
Seat 9: AYoshiK (10562652 in chips)
4time2warp0: posts the ante 70000
hichnick777: posts the ante 70000
casey1186: posts the ante 70000
AYoshiK: posts the ante 70000
hichnick777: posts small blind 350000
casey1186: posts big blind 700000
*** HOLE CARDS ***
Dealt to hichnick777 [3d Td]
AYoshiK: folds
4time2warp0: raises 700000 to 1400000
hichnick777: folds
casey1186: folds
Uncalled bet (700000) returned to 4time2warp0
4time2warp0 collected 2030000 from pot
4time2warp0: doesn't show hand
*** SUMMARY ***
Total pot 2030000 | Rake 0
Seat 2: 4time2warp0 (button) collected (2030000)
Seat 4: hichnick777 (small blind) folded before Flop
Seat 8: casey1186 (big blind) folded before Flop
Seat 9: AYoshiK folded before Flop (didn't bet)


*********** # 589 **************
PokerStars Hand #176682774447: Tournament #2054568934, $20+$2 USD Hold'em No Limit - Level LI (350000/700000) - 2017/10/09 9:20:12 MSK [2017/10/09 2:20:12 ET]
Table '2054568934 624' 9-max Seat #4 is the button
Seat 2: 4time2warp0 (20965356 in chips)
Seat 4: hichnick777 (30111096 in chips)
Seat 8: casey1186 (29160896 in chips)
Seat 9: AYoshiK (10492652 in chips)
4time2warp0: posts the ante 70000
hichnick777: posts the ante 70000
casey1186: posts the ante 70000
AYoshiK: posts the ante 70000
casey1186: posts small blind 350000
AYoshiK: posts big blind 700000
*** HOLE CARDS ***
Dealt to hichnick777 [7c 5h]
4time2warp0: folds
hichnick777: raises 756000 to 1456000
casey1186: calls 1106000
AYoshiK: folds
*** FLOP *** [3h Ah Ts]
casey1186: checks
hichnick777: checks
*** TURN *** [3h Ah Ts] [6h]
casey1186: bets 1946000
hichnick777: folds
Uncalled bet (1946000) returned to casey1186
casey1186 collected 3892000 from pot
casey1186: doesn't show hand
*** SUMMARY ***
Total pot 3892000 | Rake 0
Board [3h Ah Ts 6h]
Seat 2: 4time2warp0 folded before Flop (didn't bet)
Seat 4: hichnick777 (button) folded on the Turn
Seat 8: casey1186 (small blind) collected (3892000)
Seat 9: AYoshiK (big blind) folded before Flop


*********** # 590 **************
PokerStars Hand #176682785667: Tournament #2054568934, $20+$2 USD Hold'em No Limit - Level LI (350000/700000) - 2017/10/09 9:21:04 MSK [2017/10/09 2:21:04 ET]
Table '2054568934 624' 9-max Seat #8 is the button
Seat 2: 4time2warp0 (20895356 in chips)
Seat 4: hichnick777 (28585096 in chips)
Seat 8: casey1186 (31526896 in chips)
Seat 9: AYoshiK (9722652 in chips)
4time2warp0: posts the ante 70000
hichnick777: posts the ante 70000
casey1186: posts the ante 70000
AYoshiK: posts the ante 70000
AYoshiK: posts small blind 350000
4time2warp0: posts big blind 700000
*** HOLE CARDS ***
Dealt to hichnick777 [Qc 4h]
hichnick777: folds
casey1186: raises 1400000 to 2100000
AYoshiK: folds
4time2warp0: calls 1400000
*** FLOP *** [7h 9h 7d]
4time2warp0: checks
casey1186: bets 2800000
4time2warp0: folds
Uncalled bet (2800000) returned to casey1186
casey1186 collected 4830000 from pot
casey1186: doesn't show hand
*** SUMMARY ***
Total pot 4830000 | Rake 0
Board [7h 9h 7d]
Seat 2: 4time2warp0 (big blind) folded on the Flop
Seat 4: hichnick777 folded before Flop (didn't bet)
Seat 8: casey1186 (button) collected (4830000)
Seat 9: AYoshiK (small blind) folded before Flop


*********** # 591 **************
PokerStars Hand #176682790412: Tournament #2054568934, $20+$2 USD Hold'em No Limit - Level LI (350000/700000) - 2017/10/09 9:21:26 MSK [2017/10/09 2:21:26 ET]
Table '2054568934 624' 9-max Seat #9 is the button
Seat 2: 4time2warp0 (18725356 in chips)
Seat 4: hichnick777 (28515096 in chips)
Seat 8: casey1186 (34186896 in chips)
Seat 9: AYoshiK (9302652 in chips)
4time2warp0: posts the ante 70000
hichnick777: posts the ante 70000
casey1186: posts the ante 70000
AYoshiK: posts the ante 70000
4time2warp0: posts small blind 350000
hichnick777: posts big blind 700000
*** HOLE CARDS ***
Dealt to hichnick777 [4h Jd]
casey1186: folds
AYoshiK: folds
4time2warp0: raises 700000 to 1400000
hichnick777: calls 700000
*** FLOP *** [6h 7d Qd]
4time2warp0: checks
hichnick777: bets 1416800
4time2warp0: folds
Uncalled bet (1416800) returned to hichnick777
hichnick777 collected 3080000 from pot
hichnick777: doesn't show hand
*** SUMMARY ***
Total pot 3080000 | Rake 0
Board [6h 7d Qd]
Seat 2: 4time2warp0 (small blind) folded on the Flop
Seat 4: hichnick777 (big blind) collected (3080000)
Seat 8: casey1186 folded before Flop (didn't bet)
Seat 9: AYoshiK (button) folded before Flop (didn't bet)


*********** # 592 **************
PokerStars Hand #176682798358: Tournament #2054568934, $20+$2 USD Hold'em No Limit - Level LI (350000/700000) - 2017/10/09 9:22:03 MSK [2017/10/09 2:22:03 ET]
Table '2054568934 624' 9-max Seat #2 is the button
Seat 2: 4time2warp0 (17255356 in chips)
Seat 4: hichnick777 (30125096 in chips)
Seat 8: casey1186 (34116896 in chips)
Seat 9: AYoshiK (9232652 in chips)
4time2warp0: posts the ante 70000
hichnick777: posts the ante 70000
casey1186: posts the ante 70000
AYoshiK: posts the ante 70000
hichnick777: posts small blind 350000
casey1186: posts big blind 700000
*** HOLE CARDS ***
Dealt to hichnick777 [9d 9h]
AYoshiK: folds
4time2warp0: raises 700000 to 1400000
hichnick777: raises 2800000 to 4200000
casey1186: calls 3500000
4time2warp0: calls 2800000
*** FLOP *** [Jd Jc 7d]
hichnick777: checks
casey1186: bets 6440000
4time2warp0: folds
hichnick777: calls 6440000
*** TURN *** [Jd Jc 7d] [As]
hichnick777: checks
casey1186: checks
*** RIVER *** [Jd Jc 7d As] [8c]
hichnick777: checks
casey1186: checks
*** SHOW DOWN ***
hichnick777: shows [9d 9h] (two pair, Jacks and Nines)
casey1186: shows [Th Ts] (two pair, Jacks and Tens)
casey1186 collected 25760000 from pot
*** SUMMARY ***
Total pot 25760000 | Rake 0
Board [Jd Jc 7d As 8c]
Seat 2: 4time2warp0 (button) folded on the Flop
Seat 4: hichnick777 (small blind) showed [9d 9h] and lost with two pair, Jacks and Nines
Seat 8: casey1186 (big blind) showed [Th Ts] and won (25760000) with two pair, Jacks and Tens
Seat 9: AYoshiK folded before Flop (didn't bet)


*********** # 593 **************
PokerStars Hand #176682823114: Tournament #2054568934, $20+$2 USD Hold'em No Limit - Level LI (350000/700000) - 2017/10/09 9:23:59 MSK [2017/10/09 2:23:59 ET]
Table '2054568934 624' 9-max Seat #4 is the button
Seat 2: 4time2warp0 (12985356 in chips)
Seat 4: hichnick777 (19415096 in chips)
Seat 8: casey1186 (49166896 in chips)
Seat 9: AYoshiK (9162652 in chips)
4time2warp0: posts the ante 70000
hichnick777: posts the ante 70000
casey1186: posts the ante 70000
AYoshiK: posts the ante 70000
casey1186: posts small blind 350000
AYoshiK: posts big blind 700000
*** HOLE CARDS ***
Dealt to hichnick777 [4s Td]
4time2warp0: folds
hichnick777: folds
casey1186: raises 1400000 to 2100000
AYoshiK: raises 6992652 to 9092652 and is all-in
casey1186: folds
Uncalled bet (6992652) returned to AYoshiK
AYoshiK collected 4480000 from pot
AYoshiK: doesn't show hand
*** SUMMARY ***
Total pot 4480000 | Rake 0
Seat 2: 4time2warp0 folded before Flop (didn't bet)
Seat 4: hichnick777 (button) folded before Flop (didn't bet)
Seat 8: casey1186 (small blind) folded before Flop
Seat 9: AYoshiK (big blind) collected (4480000)


*********** # 594 **************
PokerStars Hand #176682826676: Tournament #2054568934, $20+$2 USD Hold'em No Limit - Level LI (350000/700000) - 2017/10/09 9:24:15 MSK [2017/10/09 2:24:15 ET]
Table '2054568934 624' 9-max Seat #8 is the button
Seat 2: 4time2warp0 (12915356 in chips)
Seat 4: hichnick777 (19345096 in chips)
Seat 8: casey1186 (46996896 in chips)
Seat 9: AYoshiK (11472652 in chips)
4time2warp0: posts the ante 70000
hichnick777: posts the ante 70000
casey1186: posts the ante 70000
AYoshiK: posts the ante 70000
AYoshiK: posts small blind 350000
4time2warp0: posts big blind 700000
*** HOLE CARDS ***
Dealt to hichnick777 [4s 6s]
hichnick777: raises 756000 to 1456000
casey1186: folds
AYoshiK: folds
4time2warp0: folds
Uncalled bet (756000) returned to hichnick777
hichnick777 collected 2030000 from pot
hichnick777: doesn't show hand
*** SUMMARY ***
Total pot 2030000 | Rake 0
Seat 2: 4time2warp0 (big blind) folded before Flop
Seat 4: hichnick777 collected (2030000)
Seat 8: casey1186 (button) folded before Flop (didn't bet)
Seat 9: AYoshiK (small blind) folded before Flop


*********** # 595 **************
PokerStars Hand #176682830492: Tournament #2054568934, $20+$2 USD Hold'em No Limit - Level LI (350000/700000) - 2017/10/09 9:24:33 MSK [2017/10/09 2:24:33 ET]
Table '2054568934 624' 9-max Seat #9 is the button
Seat 2: 4time2warp0 (12145356 in chips)
Seat 4: hichnick777 (20605096 in chips)
Seat 8: casey1186 (46926896 in chips)
Seat 9: AYoshiK (11052652 in chips)
4time2warp0: posts the ante 70000
hichnick777: posts the ante 70000
casey1186: posts the ante 70000
AYoshiK: posts the ante 70000
4time2warp0: posts small blind 350000
hichnick777: posts big blind 700000
*** HOLE CARDS ***
Dealt to hichnick777 [6s Ah]
casey1186: folds
AYoshiK: folds
4time2warp0: folds
Uncalled bet (350000) returned to hichnick777
hichnick777 collected 980000 from pot
hichnick777: doesn't show hand
*** SUMMARY ***
Total pot 980000 | Rake 0
Seat 2: 4time2warp0 (small blind) folded before Flop
Seat 4: hichnick777 (big blind) collected (980000)
Seat 8: casey1186 folded before Flop (didn't bet)
Seat 9: AYoshiK (button) folded before Flop (didn't bet)


*********** # 596 **************
PokerStars Hand #176682832411: Tournament #2054568934, $20+$2 USD Hold'em No Limit - Level LI (350000/700000) - 2017/10/09 9:24:42 MSK [2017/10/09 2:24:42 ET]
Table '2054568934 624' 9-max Seat #2 is the button
Seat 2: 4time2warp0 (11725356 in chips)
Seat 4: hichnick777 (21165096 in chips)
Seat 8: casey1186 (46856896 in chips)
Seat 9: AYoshiK (10982652 in chips)
4time2warp0: posts the ante 70000
hichnick777: posts the ante 70000
casey1186: posts the ante 70000
AYoshiK: posts the ante 70000
hichnick777: posts small blind 350000
casey1186: posts big blind 700000
*** HOLE CARDS ***
Dealt to hichnick777 [9h Jh]
AYoshiK: folds
4time2warp0: raises 700000 to 1400000
hichnick777: folds
casey1186: folds
Uncalled bet (700000) returned to 4time2warp0
4time2warp0 collected 2030000 from pot
4time2warp0: doesn't show hand
*** SUMMARY ***
Total pot 2030000 | Rake 0
Seat 2: 4time2warp0 (button) collected (2030000)
Seat 4: hichnick777 (small blind) folded before Flop
Seat 8: casey1186 (big blind) folded before Flop
Seat 9: AYoshiK folded before Flop (didn't bet)


*********** # 597 **************
PokerStars Hand #176682835832: Tournament #2054568934, $20+$2 USD Hold'em No Limit - Level LI (350000/700000) - 2017/10/09 9:24:57 MSK [2017/10/09 2:24:57 ET]
Table '2054568934 624' 9-max Seat #4 is the button
Seat 2: 4time2warp0 (12985356 in chips)
Seat 4: hichnick777 (20745096 in chips)
Seat 8: casey1186 (46086896 in chips)
Seat 9: AYoshiK (10912652 in chips)
4time2warp0: posts the ante 70000
hichnick777: posts the ante 70000
casey1186: posts the ante 70000
AYoshiK: posts the ante 70000
casey1186: posts small blind 350000
AYoshiK: posts big blind 700000
*** HOLE CARDS ***
Dealt to hichnick777 [6d 3c]
4time2warp0: folds
hichnick777: folds
casey1186: folds
Uncalled bet (350000) returned to AYoshiK
AYoshiK collected 980000 from pot
AYoshiK: doesn't show hand
*** SUMMARY ***
Total pot 980000 | Rake 0
Seat 2: 4time2warp0 folded before Flop (didn't bet)
Seat 4: hichnick777 (button) folded before Flop (didn't bet)
Seat 8: casey1186 (small blind) folded before Flop
Seat 9: AYoshiK (big blind) collected (980000)


*********** # 598 **************
PokerStars Hand #176682838002: Tournament #2054568934, $20+$2 USD Hold'em No Limit - Level LI (350000/700000) - 2017/10/09 9:25:07 MSK [2017/10/09 2:25:07 ET]
Table '2054568934 624' 9-max Seat #8 is the button
Seat 2: 4time2warp0 (12915356 in chips)
Seat 4: hichnick777 (20675096 in chips)
Seat 8: casey1186 (45666896 in chips)
Seat 9: AYoshiK (11472652 in chips)
4time2warp0: posts the ante 70000
hichnick777: posts the ante 70000
casey1186: posts the ante 70000
AYoshiK: posts the ante 70000
AYoshiK: posts small blind 350000
4time2warp0: posts big blind 700000
*** HOLE CARDS ***
Dealt to hichnick777 [Th 2c]
hichnick777: folds
casey1186: raises 1400000 to 2100000
AYoshiK: raises 9302652 to 11402652 and is all-in
4time2warp0: folds
casey1186: folds
Uncalled bet (9302652) returned to AYoshiK
AYoshiK collected 5180000 from pot
AYoshiK: doesn't show hand
*** SUMMARY ***
Total pot 5180000 | Rake 0
Seat 2: 4time2warp0 (big blind) folded before Flop
Seat 4: hichnick777 folded before Flop (didn't bet)
Seat 8: casey1186 (button) folded before Flop
Seat 9: AYoshiK (small blind) collected (5180000)


*********** # 599 **************
PokerStars Hand #176682840811: Tournament #2054568934, $20+$2 USD Hold'em No Limit - Level LI (350000/700000) - 2017/10/09 9:25:20 MSK [2017/10/09 2:25:20 ET]
Table '2054568934 624' 9-max Seat #9 is the button
Seat 2: 4time2warp0 (12145356 in chips)
Seat 4: hichnick777 (20605096 in chips)
Seat 8: casey1186 (43496896 in chips)
Seat 9: AYoshiK (14482652 in chips)
4time2warp0: posts the ante 70000
hichnick777: posts the ante 70000
casey1186: posts the ante 70000
AYoshiK: posts the ante 70000
4time2warp0: posts small blind 350000
hichnick777: posts big blind 700000
*** HOLE CARDS ***
Dealt to hichnick777 [Qd As]
casey1186: folds
AYoshiK: folds
4time2warp0: folds
Uncalled bet (350000) returned to hichnick777
hichnick777 collected 980000 from pot
hichnick777: doesn't show hand
*** SUMMARY ***
Total pot 980000 | Rake 0
Seat 2: 4time2warp0 (small blind) folded before Flop
Seat 4: hichnick777 (big blind) collected (980000)
Seat 8: casey1186 folded before Flop (didn't bet)
Seat 9: AYoshiK (button) folded before Flop (didn't bet)


*********** # 600 **************
PokerStars Hand #176682842618: Tournament #2054568934, $20+$2 USD Hold'em No Limit - Level LI (350000/700000) - 2017/10/09 9:25:28 MSK [2017/10/09 2:25:28 ET]
Table '2054568934 624' 9-max Seat #2 is the button
Seat 2: 4time2warp0 (11725356 in chips)
Seat 4: hichnick777 (21165096 in chips)
Seat 8: casey1186 (43426896 in chips)
Seat 9: AYoshiK (14412652 in chips)
4time2warp0: posts the ante 70000
hichnick777: posts the ante 70000
casey1186: posts the ante 70000
AYoshiK: posts the ante 70000
hichnick777: posts small blind 350000
casey1186: posts big blind 700000
*** HOLE CARDS ***
Dealt to hichnick777 [5d 3c]
AYoshiK: folds
4time2warp0: folds
hichnick777: folds
Uncalled bet (350000) returned to casey1186
casey1186 collected 980000 from pot
*** SUMMARY ***
Total pot 980000 | Rake 0
Seat 2: 4time2warp0 (button) folded before Flop (didn't bet)
Seat 4: hichnick777 (small blind) folded before Flop
Seat 8: casey1186 (big blind) collected (980000)
Seat 9: AYoshiK folded before Flop (didn't bet)


*********** # 601 **************
PokerStars Hand #176682844455: Tournament #2054568934, $20+$2 USD Hold'em No Limit - Level LI (350000/700000) - 2017/10/09 9:25:36 MSK [2017/10/09 2:25:36 ET]
Table '2054568934 624' 9-max Seat #4 is the button
Seat 2: 4time2warp0 (11655356 in chips)
Seat 4: hichnick777 (20745096 in chips)
Seat 8: casey1186 (43986896 in chips)
Seat 9: AYoshiK (14342652 in chips)
4time2warp0: posts the ante 70000
hichnick777: posts the ante 70000
casey1186: posts the ante 70000
AYoshiK: posts the ante 70000
casey1186: posts small blind 350000
AYoshiK: posts big blind 700000
*** HOLE CARDS ***
Dealt to hichnick777 [Kh 2h]
4time2warp0: raises 700000 to 1400000
hichnick777: folds
casey1186: folds
AYoshiK: raises 12872652 to 14272652 and is all-in
4time2warp0: calls 10185356 and is all-in
Uncalled bet (2687296) returned to AYoshiK
*** FLOP *** [Ts Td 2c]
*** TURN *** [Ts Td 2c] [Ks]
*** RIVER *** [Ts Td 2c Ks] [4d]
*** SHOW DOWN ***
AYoshiK: shows [Jc Ad] (a pair of Tens)
4time2warp0: shows [Qs Qc] (two pair, Queens and Tens)
4time2warp0 collected 23800712 from pot
*** SUMMARY ***
Total pot 23800712 | Rake 0
Board [Ts Td 2c Ks 4d]
Seat 2: 4time2warp0 showed [Qs Qc] and won (23800712) with two pair, Queens and Tens
Seat 4: hichnick777 (button) folded before Flop (didn't bet)
Seat 8: casey1186 (small blind) folded before Flop
Seat 9: AYoshiK (big blind) showed [Jc Ad] and lost with a pair of Tens


*********** # 602 **************
PokerStars Hand #176682849868: Tournament #2054568934, $20+$2 USD Hold'em No Limit - Level LI (350000/700000) - 2017/10/09 9:26:01 MSK [2017/10/09 2:26:01 ET]
Table '2054568934 624' 9-max Seat #8 is the button
Seat 2: 4time2warp0 (23800712 in chips)
Seat 4: hichnick777 (20675096 in chips)
Seat 8: casey1186 (43566896 in chips)
Seat 9: AYoshiK (2687296 in chips)
4time2warp0: posts the ante 70000
hichnick777: posts the ante 70000
casey1186: posts the ante 70000
AYoshiK: posts the ante 70000
AYoshiK: posts small blind 350000
4time2warp0: posts big blind 700000
*** HOLE CARDS ***
Dealt to hichnick777 [5s 6c]
hichnick777: folds
casey1186: folds
AYoshiK: raises 1917296 to 2617296 and is all-in
4time2warp0: calls 1917296
*** FLOP *** [5c Kc 8s]
*** TURN *** [5c Kc 8s] [6d]
*** RIVER *** [5c Kc 8s 6d] [7h]
*** SHOW DOWN ***
AYoshiK: shows [9s Td] (a straight, Six to Ten)
4time2warp0: shows [2h Ad] (high card Ace)
AYoshiK collected 5514592 from pot
*** SUMMARY ***
Total pot 5514592 | Rake 0
Board [5c Kc 8s 6d 7h]
Seat 2: 4time2warp0 (big blind) showed [2h Ad] and lost with high card Ace
Seat 4: hichnick777 folded before Flop (didn't bet)
Seat 8: casey1186 (button) folded before Flop (didn't bet)
Seat 9: AYoshiK (small blind) showed [9s Td] and won (5514592) with a straight, Six to Ten


*********** # 603 **************
PokerStars Hand #176682853539: Tournament #2054568934, $20+$2 USD Hold'em No Limit - Level LI (350000/700000) - 2017/10/09 9:26:18 MSK [2017/10/09 2:26:18 ET]
Table '2054568934 624' 9-max Seat #9 is the button
Seat 2: 4time2warp0 (21113416 in chips)
Seat 4: hichnick777 (20605096 in chips)
Seat 8: casey1186 (43496896 in chips)
Seat 9: AYoshiK (5514592 in chips)
4time2warp0: posts the ante 70000
hichnick777: posts the ante 70000
casey1186: posts the ante 70000
AYoshiK: posts the ante 70000
4time2warp0: posts small blind 350000
hichnick777: posts big blind 700000
*** HOLE CARDS ***
Dealt to hichnick777 [5d 9c]
casey1186: raises 700000 to 1400000
AYoshiK: raises 4044592 to 5444592 and is all-in
4time2warp0: folds
hichnick777: folds
casey1186: calls 4044592
*** FLOP *** [4h 4c 5s]
*** TURN *** [4h 4c 5s] [7c]
*** RIVER *** [4h 4c 5s 7c] [Jh]
*** SHOW DOWN ***
casey1186: shows [8c 8d] (two pair, Eights and Fours)
AYoshiK: shows [3c 3d] (two pair, Fours and Threes)
casey1186 collected 12219184 from pot
AYoshiK finished the tournament in 4th place and received $7396.99.
*** SUMMARY ***
Total pot 12219184 | Rake 0
Board [4h 4c 5s 7c Jh]
Seat 2: 4time2warp0 (small blind) folded before Flop
Seat 4: hichnick777 (big blind) folded before Flop
Seat 8: casey1186 showed [8c 8d] and won (12219184) with two pair, Eights and Fours
Seat 9: AYoshiK (button) showed [3c 3d] and lost with two pair, Fours and Threes


*********** # 604 **************
PokerStars Hand #176682858582: Tournament #2054568934, $20+$2 USD Hold'em No Limit - Level LII (400000/800000) - 2017/10/09 9:26:41 MSK [2017/10/09 2:26:41 ET]
Table '2054568934 624' 9-max Seat #2 is the button
Seat 2: 4time2warp0 (20693416 in chips)
Seat 4: hichnick777 (19835096 in chips)
Seat 8: casey1186 (50201488 in chips)
4time2warp0: posts the ante 80000
hichnick777: posts the ante 80000
casey1186: posts the ante 80000
hichnick777: posts small blind 400000
casey1186: posts big blind 800000
*** HOLE CARDS ***
Dealt to hichnick777 [3s 8s]
4time2warp0: raises 800000 to 1600000
hichnick777: folds
casey1186 said, "deal?"
casey1186: folds
Uncalled bet (800000) returned to 4time2warp0
4time2warp0 collected 2240000 from pot
4time2warp0: doesn't show hand
*** SUMMARY ***
Total pot 2240000 | Rake 0
Seat 2: 4time2warp0 (button) collected (2240000)
Seat 4: hichnick777 (small blind) folded before Flop
Seat 8: casey1186 (big blind) folded before Flop


*********** # 605 **************
PokerStars Hand #176682860974: Tournament #2054568934, $20+$2 USD Hold'em No Limit - Level LII (400000/800000) - 2017/10/09 9:26:52 MSK [2017/10/09 2:26:52 ET]
Table '2054568934 624' 9-max Seat #4 is the button
Seat 2: 4time2warp0 (22053416 in chips)
Seat 4: hichnick777 (19355096 in chips)
Seat 8: casey1186 (49321488 in chips)
4time2warp0: posts the ante 80000
hichnick777: posts the ante 80000
casey1186: posts the ante 80000
casey1186: posts small blind 400000
4time2warp0: posts big blind 800000
*** HOLE CARDS ***
Dealt to hichnick777 [7s 4h]
hichnick777: folds
casey1186: raises 800000 to 1600000
4time2warp0: folds
Uncalled bet (800000) returned to casey1186
casey1186 collected 1840000 from pot
casey1186: doesn't show hand
*** SUMMARY ***
Total pot 1840000 | Rake 0
Seat 2: 4time2warp0 (big blind) folded before Flop
Seat 4: hichnick777 (button) folded before Flop (didn't bet)
Seat 8: casey1186 (small blind) collected (1840000)


*********** # 606 **************
PokerStars Hand #176682864201: Tournament #2054568934, $20+$2 USD Hold'em No Limit - Level LII (400000/800000) - 2017/10/09 9:27:07 MSK [2017/10/09 2:27:07 ET]
Table '2054568934 624' 9-max Seat #8 is the button
Seat 2: 4time2warp0 (21173416 in chips)
Seat 4: hichnick777 (19275096 in chips)
Seat 8: casey1186 (50281488 in chips)
4time2warp0: posts the ante 80000
hichnick777: posts the ante 80000
casey1186: posts the ante 80000
4time2warp0: posts small blind 400000
hichnick777: posts big blind 800000
*** HOLE CARDS ***
Dealt to hichnick777 [Th 7s]
casey1186: raises 800000 to 1600000
4time2warp0: folds
hichnick777: calls 800000
*** FLOP *** [Qs Ah Jc]
hichnick777: checks
casey1186: checks
*** TURN *** [Qs Ah Jc] [6d]
hichnick777: checks
casey1186: bets 800000
hichnick777: folds
Uncalled bet (800000) returned to casey1186
casey1186 collected 3840000 from pot
*** SUMMARY ***
Total pot 3840000 | Rake 0
Board [Qs Ah Jc 6d]
Seat 2: 4time2warp0 (small blind) folded before Flop
Seat 4: hichnick777 (big blind) folded on the Turn
Seat 8: casey1186 (button) collected (3840000)


*********** # 607 **************
PokerStars Hand #176682874360: Tournament #2054568934, $20+$2 USD Hold'em No Limit - Level LII (400000/800000) - 2017/10/09 9:27:54 MSK [2017/10/09 2:27:54 ET]
Table '2054568934 624' 9-max Seat #2 is the button
Seat 2: 4time2warp0 (20693416 in chips)
Seat 4: hichnick777 (17595096 in chips)
Seat 8: casey1186 (52441488 in chips)
4time2warp0: posts the ante 80000
hichnick777: posts the ante 80000
casey1186: posts the ante 80000
hichnick777: posts small blind 400000
casey1186: posts big blind 800000
*** HOLE CARDS ***
Dealt to hichnick777 [2c Ts]
4time2warp0: folds
hichnick777: raises 864000 to 1664000
casey1186: calls 864000
*** FLOP *** [5h Js 3s]
hichnick777: bets 1641280
casey1186: calls 1641280
*** TURN *** [5h Js 3s] [Kh]
hichnick777: checks
casey1186: bets 4800000
hichnick777: folds
Uncalled bet (4800000) returned to casey1186
casey1186 collected 6850560 from pot
casey1186: doesn't show hand
*** SUMMARY ***
Total pot 6850560 | Rake 0
Board [5h Js 3s Kh]
Seat 2: 4time2warp0 (button) folded before Flop (didn't bet)
Seat 4: hichnick777 (small blind) folded on the Turn
Seat 8: casey1186 (big blind) collected (6850560)


*********** # 608 **************
PokerStars Hand #176682886859: Tournament #2054568934, $20+$2 USD Hold'em No Limit - Level LII (400000/800000) - 2017/10/09 9:28:52 MSK [2017/10/09 2:28:52 ET]
Table '2054568934 624' 9-max Seat #4 is the button
Seat 2: 4time2warp0 (20613416 in chips)
Seat 4: hichnick777 (14209816 in chips)
Seat 8: casey1186 (55906768 in chips)
4time2warp0: posts the ante 80000
hichnick777: posts the ante 80000
casey1186: posts the ante 80000
casey1186: posts small blind 400000
4time2warp0: posts big blind 800000
*** HOLE CARDS ***
Dealt to hichnick777 [7s 3c]
hichnick777: folds
casey1186: raises 1600000 to 2400000
4time2warp0: raises 4000000 to 6400000
casey1186: calls 4000000
*** FLOP *** [Js 4d 7h]
casey1186: checks
4time2warp0: bets 5600000
casey1186: folds
Uncalled bet (5600000) returned to 4time2warp0
4time2warp0 collected 13040000 from pot
4time2warp0: doesn't show hand
*** SUMMARY ***
Total pot 13040000 | Rake 0
Board [Js 4d 7h]
Seat 2: 4time2warp0 (big blind) collected (13040000)
Seat 4: hichnick777 (button) folded before Flop (didn't bet)
Seat 8: casey1186 (small blind) folded on the Flop


*********** # 609 **************
PokerStars Hand #176682891922: Tournament #2054568934, $20+$2 USD Hold'em No Limit - Level LII (400000/800000) - 2017/10/09 9:29:15 MSK [2017/10/09 2:29:15 ET]
Table '2054568934 624' 9-max Seat #8 is the button
Seat 2: 4time2warp0 (27173416 in chips)
Seat 4: hichnick777 (14129816 in chips)
Seat 8: casey1186 (49426768 in chips)
4time2warp0: posts the ante 80000
hichnick777: posts the ante 80000
casey1186: posts the ante 80000
4time2warp0: posts small blind 400000
hichnick777: posts big blind 800000
*** HOLE CARDS ***
Dealt to hichnick777 [2c 5s]
casey1186: folds
4time2warp0: folds
Uncalled bet (400000) returned to hichnick777
hichnick777 collected 1040000 from pot
hichnick777: doesn't show hand
*** SUMMARY ***
Total pot 1040000 | Rake 0
Seat 2: 4time2warp0 (small blind) folded before Flop
Seat 4: hichnick777 (big blind) collected (1040000)
Seat 8: casey1186 (button) folded before Flop (didn't bet)


*********** # 610 **************
PokerStars Hand #176682893391: Tournament #2054568934, $20+$2 USD Hold'em No Limit - Level LII (400000/800000) - 2017/10/09 9:29:22 MSK [2017/10/09 2:29:22 ET]
Table '2054568934 624' 9-max Seat #2 is the button
Seat 2: 4time2warp0 (26693416 in chips)
Seat 4: hichnick777 (14689816 in chips)
Seat 8: casey1186 (49346768 in chips)
4time2warp0: posts the ante 80000
hichnick777: posts the ante 80000
casey1186: posts the ante 80000
hichnick777: posts small blind 400000
casey1186: posts big blind 800000
*** HOLE CARDS ***
Dealt to hichnick777 [5h Kd]
4time2warp0: folds
hichnick777: raises 864000 to 1664000
casey1186: folds
Uncalled bet (864000) returned to hichnick777
hichnick777 collected 1840000 from pot
hichnick777: doesn't show hand
*** SUMMARY ***
Total pot 1840000 | Rake 0
Seat 2: 4time2warp0 (button) folded before Flop (didn't bet)
Seat 4: hichnick777 (small blind) collected (1840000)
Seat 8: casey1186 (big blind) folded before Flop


*********** # 611 **************
PokerStars Hand #176682897104: Tournament #2054568934, $20+$2 USD Hold'em No Limit - Level LII (400000/800000) - 2017/10/09 9:29:39 MSK [2017/10/09 2:29:39 ET]
Table '2054568934 624' 9-max Seat #4 is the button
Seat 2: 4time2warp0 (26613416 in chips)
Seat 4: hichnick777 (15649816 in chips)
Seat 8: casey1186 (48466768 in chips)
4time2warp0: posts the ante 80000
hichnick777: posts the ante 80000
casey1186: posts the ante 80000
casey1186: posts small blind 400000
4time2warp0: posts big blind 800000
*** HOLE CARDS ***
Dealt to hichnick777 [Jd 7c]
hichnick777: folds
casey1186: raises 1600000 to 2400000
4time2warp0: folds
Uncalled bet (1600000) returned to casey1186
casey1186 collected 1840000 from pot
casey1186: doesn't show hand
*** SUMMARY ***
Total pot 1840000 | Rake 0
Seat 2: 4time2warp0 (big blind) folded before Flop
Seat 4: hichnick777 (button) folded before Flop (didn't bet)
Seat 8: casey1186 (small blind) collected (1840000)


*********** # 612 **************
PokerStars Hand #176682899776: Tournament #2054568934, $20+$2 USD Hold'em No Limit - Level LII (400000/800000) - 2017/10/09 9:29:51 MSK [2017/10/09 2:29:51 ET]
Table '2054568934 624' 9-max Seat #8 is the button
Seat 2: 4time2warp0 (25733416 in chips)
Seat 4: hichnick777 (15569816 in chips)
Seat 8: casey1186 (49426768 in chips)
4time2warp0: posts the ante 80000
hichnick777: posts the ante 80000
casey1186: posts the ante 80000
4time2warp0: posts small blind 400000
hichnick777: posts big blind 800000
*** HOLE CARDS ***
Dealt to hichnick777 [7s 6d]
casey1186: raises 1600000 to 2400000
4time2warp0: folds
hichnick777: folds
Uncalled bet (1600000) returned to casey1186
casey1186 collected 2240000 from pot
casey1186: doesn't show hand
*** SUMMARY ***
Total pot 2240000 | Rake 0
Seat 2: 4time2warp0 (small blind) folded before Flop
Seat 4: hichnick777 (big blind) folded before Flop
Seat 8: casey1186 (button) collected (2240000)


*********** # 613 **************
PokerStars Hand #176682902374: Tournament #2054568934, $20+$2 USD Hold'em No Limit - Level LII (400000/800000) - 2017/10/09 9:30:03 MSK [2017/10/09 2:30:03 ET]
Table '2054568934 624' 9-max Seat #2 is the button
Seat 2: 4time2warp0 (25253416 in chips)
Seat 4: hichnick777 (14689816 in chips)
Seat 8: casey1186 (50786768 in chips)
4time2warp0: posts the ante 80000
hichnick777: posts the ante 80000
casey1186: posts the ante 80000
hichnick777: posts small blind 400000
casey1186: posts big blind 800000
*** HOLE CARDS ***
Dealt to hichnick777 [Th As]
4time2warp0: folds
hichnick777: raises 864000 to 1664000
casey1186: calls 864000
*** FLOP *** [3s Ad 6d]
hichnick777: bets 1371280
casey1186: raises 3428720 to 4800000
hichnick777: raises 8145816 to 12945816 and is all-in
casey1186: folds
Uncalled bet (8145816) returned to hichnick777
hichnick777 collected 13168000 from pot
hichnick777: doesn't show hand
*** SUMMARY ***
Total pot 13168000 | Rake 0
Board [3s Ad 6d]
Seat 2: 4time2warp0 (button) folded before Flop (didn't bet)
Seat 4: hichnick777 (small blind) collected (13168000)
Seat 8: casey1186 (big blind) folded on the Flop


*********** # 614 **************
PokerStars Hand #176682913906: Tournament #2054568934, $20+$2 USD Hold'em No Limit - Level LII (400000/800000) - 2017/10/09 9:30:57 MSK [2017/10/09 2:30:57 ET]
Table '2054568934 624' 9-max Seat #4 is the button
Seat 2: 4time2warp0 (25173416 in chips)
Seat 4: hichnick777 (21313816 in chips)
Seat 8: casey1186 (44242768 in chips)
4time2warp0: posts the ante 80000
hichnick777: posts the ante 80000
casey1186: posts the ante 80000
casey1186: posts small blind 400000
4time2warp0: posts big blind 800000
*** HOLE CARDS ***
Dealt to hichnick777 [Tc 2h]
hichnick777: folds
casey1186: folds
Uncalled bet (400000) returned to 4time2warp0
4time2warp0 collected 1040000 from pot
4time2warp0: doesn't show hand
*** SUMMARY ***
Total pot 1040000 | Rake 0
Seat 2: 4time2warp0 (big blind) collected (1040000)
Seat 4: hichnick777 (button) folded before Flop (didn't bet)
Seat 8: casey1186 (small blind) folded before Flop


*********** # 615 **************
PokerStars Hand #176682915241: Tournament #2054568934, $20+$2 USD Hold'em No Limit - Level LII (400000/800000) - 2017/10/09 9:31:03 MSK [2017/10/09 2:31:03 ET]
Table '2054568934 624' 9-max Seat #8 is the button
Seat 2: 4time2warp0 (25733416 in chips)
Seat 4: hichnick777 (21233816 in chips)
Seat 8: casey1186 (43762768 in chips)
4time2warp0: posts the ante 80000
hichnick777: posts the ante 80000
casey1186: posts the ante 80000
4time2warp0: posts small blind 400000
hichnick777: posts big blind 800000
*** HOLE CARDS ***
Dealt to hichnick777 [7c 9d]
casey1186: raises 2240000 to 3040000
4time2warp0: folds
hichnick777: folds
Uncalled bet (2240000) returned to casey1186
casey1186 collected 2240000 from pot
*** SUMMARY ***
Total pot 2240000 | Rake 0
Seat 2: 4time2warp0 (small blind) folded before Flop
Seat 4: hichnick777 (big blind) folded before Flop
Seat 8: casey1186 (button) collected (2240000)


*********** # 616 **************
PokerStars Hand #176682917450: Tournament #2054568934, $20+$2 USD Hold'em No Limit - Level LII (400000/800000) - 2017/10/09 9:31:14 MSK [2017/10/09 2:31:14 ET]
Table '2054568934 624' 9-max Seat #2 is the button
Seat 2: 4time2warp0 (25253416 in chips)
Seat 4: hichnick777 (20353816 in chips)
Seat 8: casey1186 (45122768 in chips)
4time2warp0: posts the ante 80000
hichnick777: posts the ante 80000
casey1186: posts the ante 80000
hichnick777: posts small blind 400000
casey1186: posts big blind 800000
*** HOLE CARDS ***
Dealt to hichnick777 [Qh 4s]
4time2warp0: folds
hichnick777: raises 864000 to 1664000
casey1186: raises 43378768 to 45042768 and is all-in
hichnick777: folds
Uncalled bet (43378768) returned to casey1186
casey1186 collected 3568000 from pot
casey1186: doesn't show hand
*** SUMMARY ***
Total pot 3568000 | Rake 0
Seat 2: 4time2warp0 (button) folded before Flop (didn't bet)
Seat 4: hichnick777 (small blind) folded before Flop
Seat 8: casey1186 (big blind) collected (3568000)


*********** # 617 **************
PokerStars Hand #176682921065: Tournament #2054568934, $20+$2 USD Hold'em No Limit - Level LII (400000/800000) - 2017/10/09 9:31:30 MSK [2017/10/09 2:31:30 ET]
Table '2054568934 624' 9-max Seat #4 is the button
Seat 2: 4time2warp0 (25173416 in chips)
Seat 4: hichnick777 (18609816 in chips)
Seat 8: casey1186 (46946768 in chips)
4time2warp0: posts the ante 80000
hichnick777: posts the ante 80000
casey1186: posts the ante 80000
casey1186: posts small blind 400000
4time2warp0: posts big blind 800000
*** HOLE CARDS ***
Dealt to hichnick777 [Ac Qc]
hichnick777: raises 864000 to 1664000
casey1186: calls 1264000
4time2warp0: folds
*** FLOP *** [6h Kd 3s]
casey1186: checks
hichnick777: checks
*** TURN *** [6h Kd 3s] [7h]
casey1186: bets 4368000
hichnick777: folds
Uncalled bet (4368000) returned to casey1186
casey1186 collected 4368000 from pot
casey1186: doesn't show hand
*** SUMMARY ***
Total pot 4368000 | Rake 0
Board [6h Kd 3s 7h]
Seat 2: 4time2warp0 (big blind) folded before Flop
Seat 4: hichnick777 (button) folded on the Turn
Seat 8: casey1186 (small blind) collected (4368000)


*********** # 618 **************
PokerStars Hand #176682928569: Tournament #2054568934, $20+$2 USD Hold'em No Limit - Level LII (400000/800000) - 2017/10/09 9:32:05 MSK [2017/10/09 2:32:05 ET]
Table '2054568934 624' 9-max Seat #8 is the button
Seat 2: 4time2warp0 (24293416 in chips)
Seat 4: hichnick777 (16865816 in chips)
Seat 8: casey1186 (49570768 in chips)
4time2warp0: posts the ante 80000
hichnick777: posts the ante 80000
casey1186: posts the ante 80000
4time2warp0: posts small blind 400000
hichnick777: posts big blind 800000
*** HOLE CARDS ***
Dealt to hichnick777 [8h Kh]
casey1186: folds
4time2warp0: folds
Uncalled bet (400000) returned to hichnick777
hichnick777 collected 1040000 from pot
hichnick777: doesn't show hand
*** SUMMARY ***
Total pot 1040000 | Rake 0
Seat 2: 4time2warp0 (small blind) folded before Flop
Seat 4: hichnick777 (big blind) collected (1040000)
Seat 8: casey1186 (button) folded before Flop (didn't bet)


*********** # 619 **************
PokerStars Hand #176682930265: Tournament #2054568934, $20+$2 USD Hold'em No Limit - Level LII (400000/800000) - 2017/10/09 9:32:12 MSK [2017/10/09 2:32:12 ET]
Table '2054568934 624' 9-max Seat #2 is the button
Seat 2: 4time2warp0 (23813416 in chips)
Seat 4: hichnick777 (17425816 in chips)
Seat 8: casey1186 (49490768 in chips)
4time2warp0: posts the ante 80000
hichnick777: posts the ante 80000
casey1186: posts the ante 80000
hichnick777: posts small blind 400000
casey1186: posts big blind 800000
*** HOLE CARDS ***
Dealt to hichnick777 [Ah As]
4time2warp0: folds
hichnick777: raises 864000 to 1664000
casey1186: calls 864000
*** FLOP *** [7s 9h 3h]
hichnick777: bets 1641280
casey1186: folds
Uncalled bet (1641280) returned to hichnick777
hichnick777 collected 3568000 from pot
hichnick777: doesn't show hand
*** SUMMARY ***
Total pot 3568000 | Rake 0
Board [7s 9h 3h]
Seat 2: 4time2warp0 (button) folded before Flop (didn't bet)
Seat 4: hichnick777 (small blind) collected (3568000)
Seat 8: casey1186 (big blind) folded on the Flop


*********** # 620 **************
PokerStars Hand #176682937335: Tournament #2054568934, $20+$2 USD Hold'em No Limit - Level LII (400000/800000) - 2017/10/09 9:32:45 MSK [2017/10/09 2:32:45 ET]
Table '2054568934 624' 9-max Seat #4 is the button
Seat 2: 4time2warp0 (23733416 in chips)
Seat 4: hichnick777 (19249816 in chips)
Seat 8: casey1186 (47746768 in chips)
4time2warp0: posts the ante 80000
hichnick777: posts the ante 80000
casey1186: posts the ante 80000
casey1186: posts small blind 400000
4time2warp0: posts big blind 800000
*** HOLE CARDS ***
Dealt to hichnick777 [5s 2s]
hichnick777: folds
casey1186: raises 1840000 to 2640000
4time2warp0: folds
Uncalled bet (1840000) returned to casey1186
casey1186 collected 1840000 from pot
casey1186: doesn't show hand
*** SUMMARY ***
Total pot 1840000 | Rake 0
Seat 2: 4time2warp0 (big blind) folded before Flop
Seat 4: hichnick777 (button) folded before Flop (didn't bet)
Seat 8: casey1186 (small blind) collected (1840000)


*********** # 621 **************
PokerStars Hand #176682940275: Tournament #2054568934, $20+$2 USD Hold'em No Limit - Level LII (400000/800000) - 2017/10/09 9:32:58 MSK [2017/10/09 2:32:58 ET]
Table '2054568934 624' 9-max Seat #8 is the button
Seat 2: 4time2warp0 (22853416 in chips)
Seat 4: hichnick777 (19169816 in chips)
Seat 8: casey1186 (48706768 in chips)
4time2warp0: posts the ante 80000
hichnick777: posts the ante 80000
casey1186: posts the ante 80000
4time2warp0: posts small blind 400000
hichnick777: posts big blind 800000
*** HOLE CARDS ***
Dealt to hichnick777 [Jh 8s]
casey1186: folds
4time2warp0: folds
Uncalled bet (400000) returned to hichnick777
hichnick777 collected 1040000 from pot
hichnick777: doesn't show hand
*** SUMMARY ***
Total pot 1040000 | Rake 0
Seat 2: 4time2warp0 (small blind) folded before Flop
Seat 4: hichnick777 (big blind) collected (1040000)
Seat 8: casey1186 (button) folded before Flop (didn't bet)


*********** # 622 **************
PokerStars Hand #176682942256: Tournament #2054568934, $20+$2 USD Hold'em No Limit - Level LII (400000/800000) - 2017/10/09 9:33:08 MSK [2017/10/09 2:33:08 ET]
Table '2054568934 624' 9-max Seat #2 is the button
Seat 2: 4time2warp0 (22373416 in chips)
Seat 4: hichnick777 (19729816 in chips)
Seat 8: casey1186 (48626768 in chips)
4time2warp0: posts the ante 80000
hichnick777: posts the ante 80000
casey1186: posts the ante 80000
hichnick777: posts small blind 400000
casey1186: posts big blind 800000
*** HOLE CARDS ***
Dealt to hichnick777 [Qs 6d]
4time2warp0: raises 800000 to 1600000
hichnick777: folds
casey1186: calls 800000
*** FLOP *** [8h 3s 8s]
casey1186: checks
4time2warp0: bets 2400000
casey1186: calls 2400000
*** TURN *** [8h 3s 8s] [9d]
casey1186: checks
4time2warp0: bets 5600000
casey1186: calls 5600000
*** RIVER *** [8h 3s 8s 9d] [Ac]
casey1186: checks
4time2warp0: bets 12693416 and is all-in
casey1186: folds
Uncalled bet (12693416) returned to 4time2warp0
4time2warp0 collected 19840000 from pot
4time2warp0: doesn't show hand
*** SUMMARY ***
Total pot 19840000 | Rake 0
Board [8h 3s 8s 9d Ac]
Seat 2: 4time2warp0 (button) collected (19840000)
Seat 4: hichnick777 (small blind) folded before Flop
Seat 8: casey1186 (big blind) folded on the River


*********** # 623 **************
PokerStars Hand #176682949563: Tournament #2054568934, $20+$2 USD Hold'em No Limit - Level LII (400000/800000) - 2017/10/09 9:33:42 MSK [2017/10/09 2:33:42 ET]
Table '2054568934 624' 9-max Seat #4 is the button
Seat 2: 4time2warp0 (32533416 in chips)
Seat 4: hichnick777 (19249816 in chips)
Seat 8: casey1186 (38946768 in chips)
4time2warp0: posts the ante 80000
hichnick777: posts the ante 80000
casey1186: posts the ante 80000
casey1186: posts small blind 400000
4time2warp0: posts big blind 800000
*** HOLE CARDS ***
Dealt to hichnick777 [Ad As]
hichnick777: raises 864000 to 1664000
casey1186: raises 37202768 to 38866768 and is all-in
4time2warp0: folds
hichnick777: calls 17505816 and is all-in
Uncalled bet (19696952) returned to casey1186
*** FLOP *** [2h 6s 5c]
*** TURN *** [2h 6s 5c] [6c]
*** RIVER *** [2h 6s 5c 6c] [5s]
*** SHOW DOWN ***
casey1186: shows [7c 7s] (two pair, Sevens and Sixes)
hichnick777: shows [Ad As] (two pair, Aces and Sixes)
hichnick777 collected 39379632 from pot
*** SUMMARY ***
Total pot 39379632 | Rake 0
Board [2h 6s 5c 6c 5s]
Seat 2: 4time2warp0 (big blind) folded before Flop
Seat 4: hichnick777 (button) showed [Ad As] and won (39379632) with two pair, Aces and Sixes
Seat 8: casey1186 (small blind) showed [7c 7s] and lost with two pair, Sevens and Sixes


*********** # 624 **************
PokerStars Hand #176682956240: Tournament #2054568934, $20+$2 USD Hold'em No Limit - Level LII (400000/800000) - 2017/10/09 9:34:12 MSK [2017/10/09 2:34:12 ET]
Table '2054568934 624' 9-max Seat #8 is the button
Seat 2: 4time2warp0 (31653416 in chips)
Seat 4: hichnick777 (39379632 in chips)
Seat 8: casey1186 (19696952 in chips)
4time2warp0: posts the ante 80000
hichnick777: posts the ante 80000
casey1186: posts the ante 80000
4time2warp0: posts small blind 400000
hichnick777: posts big blind 800000
*** HOLE CARDS ***
Dealt to hichnick777 [Js 7c]
casey1186: folds
4time2warp0: folds
Uncalled bet (400000) returned to hichnick777
hichnick777 collected 1040000 from pot
hichnick777: doesn't show hand
*** SUMMARY ***
Total pot 1040000 | Rake 0
Seat 2: 4time2warp0 (small blind) folded before Flop
Seat 4: hichnick777 (big blind) collected (1040000)
Seat 8: casey1186 (button) folded before Flop (didn't bet)


*********** # 625 **************
PokerStars Hand #176682959099: Tournament #2054568934, $20+$2 USD Hold'em No Limit - Level LII (400000/800000) - 2017/10/09 9:34:25 MSK [2017/10/09 2:34:25 ET]
Table '2054568934 624' 9-max Seat #2 is the button
Seat 2: 4time2warp0 (31173416 in chips)
Seat 4: hichnick777 (39939632 in chips)
Seat 8: casey1186 (19616952 in chips)
4time2warp0: posts the ante 80000
hichnick777: posts the ante 80000
casey1186: posts the ante 80000
hichnick777: posts small blind 400000
casey1186: posts big blind 800000
*** HOLE CARDS ***
Dealt to hichnick777 [4h 2h]
4time2warp0: folds
hichnick777: raises 864000 to 1664000
casey1186: raises 17872952 to 19536952 and is all-in
hichnick777: folds
Uncalled bet (17872952) returned to casey1186
casey1186 collected 3568000 from pot
casey1186: doesn't show hand
*** SUMMARY ***
Total pot 3568000 | Rake 0
Seat 2: 4time2warp0 (button) folded before Flop (didn't bet)
Seat 4: hichnick777 (small blind) folded before Flop
Seat 8: casey1186 (big blind) collected (3568000)


*********** # 626 **************
PokerStars Hand #176682963188: Tournament #2054568934, $20+$2 USD Hold'em No Limit - Level LII (400000/800000) - 2017/10/09 9:34:44 MSK [2017/10/09 2:34:44 ET]
Table '2054568934 624' 9-max Seat #4 is the button
Seat 2: 4time2warp0 (31093416 in chips)
Seat 4: hichnick777 (38195632 in chips)
Seat 8: casey1186 (21440952 in chips)
4time2warp0: posts the ante 80000
hichnick777: posts the ante 80000
casey1186: posts the ante 80000
casey1186: posts small blind 400000
4time2warp0: posts big blind 800000
*** HOLE CARDS ***
Dealt to hichnick777 [Jc Qd]
hichnick777: raises 864000 to 1664000
casey1186: folds
4time2warp0: folds
Uncalled bet (864000) returned to hichnick777
hichnick777 collected 2240000 from pot
hichnick777: doesn't show hand
*** SUMMARY ***
Total pot 2240000 | Rake 0
Seat 2: 4time2warp0 (big blind) folded before Flop
Seat 4: hichnick777 (button) collected (2240000)
Seat 8: casey1186 (small blind) folded before Flop


*********** # 627 **************
PokerStars Hand #176682965962: Tournament #2054568934, $20+$2 USD Hold'em No Limit - Level LII (400000/800000) - 2017/10/09 9:34:57 MSK [2017/10/09 2:34:57 ET]
Table '2054568934 624' 9-max Seat #8 is the button
Seat 2: 4time2warp0 (30213416 in chips)
Seat 4: hichnick777 (39555632 in chips)
Seat 8: casey1186 (20960952 in chips)
4time2warp0: posts the ante 80000
hichnick777: posts the ante 80000
casey1186: posts the ante 80000
4time2warp0: posts small blind 400000
hichnick777: posts big blind 800000
*** HOLE CARDS ***
Dealt to hichnick777 [Td 8s]
casey1186: folds
4time2warp0: folds
Uncalled bet (400000) returned to hichnick777
hichnick777 collected 1040000 from pot
hichnick777: doesn't show hand
*** SUMMARY ***
Total pot 1040000 | Rake 0
Seat 2: 4time2warp0 (small blind) folded before Flop
Seat 4: hichnick777 (big blind) collected (1040000)
Seat 8: casey1186 (button) folded before Flop (didn't bet)


*********** # 628 **************
PokerStars Hand #176682967557: Tournament #2054568934, $20+$2 USD Hold'em No Limit - Level LII (400000/800000) - 2017/10/09 9:35:04 MSK [2017/10/09 2:35:04 ET]
Table '2054568934 624' 9-max Seat #2 is the button
Seat 2: 4time2warp0 (29733416 in chips)
Seat 4: hichnick777 (40115632 in chips)
Seat 8: casey1186 (20880952 in chips)
4time2warp0: posts the ante 80000
hichnick777: posts the ante 80000
casey1186: posts the ante 80000
hichnick777: posts small blind 400000
casey1186: posts big blind 800000
*** HOLE CARDS ***
Dealt to hichnick777 [7d 8h]
4time2warp0: folds
hichnick777: calls 400000
casey1186: checks
*** FLOP *** [3d Qc 2s]
hichnick777: checks
casey1186: bets 1840000
hichnick777: folds
Uncalled bet (1840000) returned to casey1186
casey1186 collected 1840000 from pot
casey1186: doesn't show hand
*** SUMMARY ***
Total pot 1840000 | Rake 0
Board [3d Qc 2s]
Seat 2: 4time2warp0 (button) folded before Flop (didn't bet)
Seat 4: hichnick777 (small blind) folded on the Flop
Seat 8: casey1186 (big blind) collected (1840000)


*********** # 629 **************
PokerStars Hand #176682973918: Tournament #2054568934, $20+$2 USD Hold'em No Limit - Level LII (400000/800000) - 2017/10/09 9:35:33 MSK [2017/10/09 2:35:33 ET]
Table '2054568934 624' 9-max Seat #4 is the button
Seat 2: 4time2warp0 (29653416 in chips)
Seat 4: hichnick777 (39235632 in chips)
Seat 8: casey1186 (21840952 in chips)
4time2warp0: posts the ante 80000
hichnick777: posts the ante 80000
casey1186: posts the ante 80000
casey1186: posts small blind 400000
4time2warp0: posts big blind 800000
*** HOLE CARDS ***
Dealt to hichnick777 [3s Ad]
hichnick777: raises 864000 to 1664000
casey1186: calls 1264000
4time2warp0: calls 864000
*** FLOP *** [4d Jd As]
casey1186: checks
4time2warp0: checks
hichnick777: bets 2406720
casey1186: folds
4time2warp0: folds
Uncalled bet (2406720) returned to hichnick777
hichnick777 collected 5232000 from pot
hichnick777: doesn't show hand
*** SUMMARY ***
Total pot 5232000 | Rake 0
Board [4d Jd As]
Seat 2: 4time2warp0 (big blind) folded on the Flop
Seat 4: hichnick777 (button) collected (5232000)
Seat 8: casey1186 (small blind) folded on the Flop


*********** # 630 **************
PokerStars Hand #176682982711: Tournament #2054568934, $20+$2 USD Hold'em No Limit - Level LII (400000/800000) - 2017/10/09 9:36:13 MSK [2017/10/09 2:36:13 ET]
Table '2054568934 624' 9-max Seat #8 is the button
Seat 2: 4time2warp0 (27909416 in chips)
Seat 4: hichnick777 (42723632 in chips)
Seat 8: casey1186 (20096952 in chips)
4time2warp0: posts the ante 80000
hichnick777: posts the ante 80000
casey1186: posts the ante 80000
4time2warp0: posts small blind 400000
hichnick777: posts big blind 800000
*** HOLE CARDS ***
Dealt to hichnick777 [9s Ks]
casey1186: folds
4time2warp0: raises 800000 to 1600000
hichnick777: raises 2800000 to 4400000
4time2warp0: folds
Uncalled bet (2800000) returned to hichnick777
hichnick777 collected 3440000 from pot
hichnick777: doesn't show hand
*** SUMMARY ***
Total pot 3440000 | Rake 0
Seat 2: 4time2warp0 (small blind) folded before Flop
Seat 4: hichnick777 (big blind) collected (3440000)
Seat 8: casey1186 (button) folded before Flop (didn't bet)


*********** # 631 **************
PokerStars Hand #176682988725: Tournament #2054568934, $20+$2 USD Hold'em No Limit - Level LII (400000/800000) - 2017/10/09 9:36:41 MSK [2017/10/09 2:36:41 ET]
Table '2054568934 624' 9-max Seat #2 is the button
Seat 2: 4time2warp0 (26229416 in chips)
Seat 4: hichnick777 (44483632 in chips)
Seat 8: casey1186 (20016952 in chips)
4time2warp0: posts the ante 80000
hichnick777: posts the ante 80000
casey1186: posts the ante 80000
hichnick777: posts small blind 400000
casey1186: posts big blind 800000
*** HOLE CARDS ***
Dealt to hichnick777 [3d 4d]
4time2warp0: folds
hichnick777: raises 1000000 to 1800000
casey1186: folds
Uncalled bet (1000000) returned to hichnick777
hichnick777 collected 1840000 from pot
hichnick777: doesn't show hand
*** SUMMARY ***
Total pot 1840000 | Rake 0
Seat 2: 4time2warp0 (button) folded before Flop (didn't bet)
Seat 4: hichnick777 (small blind) collected (1840000)
Seat 8: casey1186 (big blind) folded before Flop


*********** # 632 **************
PokerStars Hand #176682993300: Tournament #2054568934, $20+$2 USD Hold'em No Limit - Level LII (400000/800000) - 2017/10/09 9:37:01 MSK [2017/10/09 2:37:01 ET]
Table '2054568934 624' 9-max Seat #4 is the button
Seat 2: 4time2warp0 (26149416 in chips)
Seat 4: hichnick777 (45443632 in chips)
Seat 8: casey1186 (19136952 in chips)
4time2warp0: posts the ante 80000
hichnick777: posts the ante 80000
casey1186: posts the ante 80000
casey1186: posts small blind 400000
4time2warp0: posts big blind 800000
*** HOLE CARDS ***
Dealt to hichnick777 [Jh 9d]
hichnick777: raises 864000 to 1664000
casey1186: raises 17392952 to 19056952 and is all-in
4time2warp0: raises 7012464 to 26069416 and is all-in
hichnick777: folds
Uncalled bet (7012464) returned to 4time2warp0
*** FLOP *** [9h Tc 7c]
*** TURN *** [9h Tc 7c] [Qc]
*** RIVER *** [9h Tc 7c Qc] [8h]
*** SHOW DOWN ***
casey1186: shows [Kh Js] (a straight, Nine to King)
4time2warp0: shows [Qh Ac] (a pair of Queens)
casey1186 collected 40017904 from pot
*** SUMMARY ***
Total pot 40017904 | Rake 0
Board [9h Tc 7c Qc 8h]
Seat 2: 4time2warp0 (big blind) showed [Qh Ac] and lost with a pair of Queens
Seat 4: hichnick777 (button) folded before Flop
Seat 8: casey1186 (small blind) showed [Kh Js] and won (40017904) with a straight, Nine to King


*********** # 633 **************
PokerStars Hand #176682998092: Tournament #2054568934, $20+$2 USD Hold'em No Limit - Level LII (400000/800000) - 2017/10/09 9:37:23 MSK [2017/10/09 2:37:23 ET]
Table '2054568934 624' 9-max Seat #8 is the button
Seat 2: 4time2warp0 (7012464 in chips)
Seat 4: hichnick777 (43699632 in chips)
Seat 8: casey1186 (40017904 in chips)
4time2warp0: posts the ante 80000
hichnick777: posts the ante 80000
casey1186: posts the ante 80000
4time2warp0: posts small blind 400000
hichnick777: posts big blind 800000
*** HOLE CARDS ***
Dealt to hichnick777 [Qc 2h]
casey1186: folds
4time2warp0: folds
Uncalled bet (400000) returned to hichnick777
hichnick777 collected 1040000 from pot
hichnick777: doesn't show hand
*** SUMMARY ***
Total pot 1040000 | Rake 0
Seat 2: 4time2warp0 (small blind) folded before Flop
Seat 4: hichnick777 (big blind) collected (1040000)
Seat 8: casey1186 (button) folded before Flop (didn't bet)


*********** # 634 **************
PokerStars Hand #176683000443: Tournament #2054568934, $20+$2 USD Hold'em No Limit - Level LII (400000/800000) - 2017/10/09 9:37:34 MSK [2017/10/09 2:37:34 ET]
Table '2054568934 624' 9-max Seat #2 is the button
Seat 2: 4time2warp0 (6532464 in chips)
Seat 4: hichnick777 (44259632 in chips)
Seat 8: casey1186 (39937904 in chips)
4time2warp0: posts the ante 80000
hichnick777: posts the ante 80000
casey1186: posts the ante 80000
hichnick777: posts small blind 400000
casey1186: posts big blind 800000
*** HOLE CARDS ***
Dealt to hichnick777 [Ad 8s]
4time2warp0: folds
hichnick777: raises 1000000 to 1800000
casey1186: folds
Uncalled bet (1000000) returned to hichnick777
hichnick777 collected 1840000 from pot
hichnick777: doesn't show hand
*** SUMMARY ***
Total pot 1840000 | Rake 0
Seat 2: 4time2warp0 (button) folded before Flop (didn't bet)
Seat 4: hichnick777 (small blind) collected (1840000)
Seat 8: casey1186 (big blind) folded before Flop


*********** # 635 **************
PokerStars Hand #176683004605: Tournament #2054568934, $20+$2 USD Hold'em No Limit - Level LII (400000/800000) - 2017/10/09 9:37:53 MSK [2017/10/09 2:37:53 ET]
Table '2054568934 624' 9-max Seat #4 is the button
Seat 2: 4time2warp0 (6452464 in chips)
Seat 4: hichnick777 (45219632 in chips)
Seat 8: casey1186 (39057904 in chips)
4time2warp0: posts the ante 80000
hichnick777: posts the ante 80000
casey1186: posts the ante 80000
casey1186: posts small blind 400000
4time2warp0: posts big blind 800000
*** HOLE CARDS ***
Dealt to hichnick777 [Ah Kh]
hichnick777: raises 864000 to 1664000
casey1186: calls 1264000
4time2warp0: folds
*** FLOP *** [9d Qd Ad]
casey1186: checks
hichnick777: bets 1809280
casey1186: folds
Uncalled bet (1809280) returned to hichnick777
hichnick777 collected 4368000 from pot
hichnick777: doesn't show hand
*** SUMMARY ***
Total pot 4368000 | Rake 0
Board [9d Qd Ad]
Seat 2: 4time2warp0 (big blind) folded before Flop
Seat 4: hichnick777 (button) collected (4368000)
Seat 8: casey1186 (small blind) folded on the Flop


*********** # 636 **************
PokerStars Hand #176683009922: Tournament #2054568934, $20+$2 USD Hold'em No Limit - Level LII (400000/800000) - 2017/10/09 9:38:17 MSK [2017/10/09 2:38:17 ET]
Table '2054568934 624' 9-max Seat #8 is the button
Seat 2: 4time2warp0 (5572464 in chips)
Seat 4: hichnick777 (47843632 in chips)
Seat 8: casey1186 (37313904 in chips)
4time2warp0: posts the ante 80000
hichnick777: posts the ante 80000
casey1186: posts the ante 80000
4time2warp0: posts small blind 400000
hichnick777: posts big blind 800000
*** HOLE CARDS ***
Dealt to hichnick777 [Qd Qc]
casey1186: folds
4time2warp0: raises 4692464 to 5492464 and is all-in
hichnick777: calls 4692464
*** FLOP *** [2s 6h 9s]
*** TURN *** [2s 6h 9s] [7d]
*** RIVER *** [2s 6h 9s 7d] [2c]
*** SHOW DOWN ***
4time2warp0: shows [7c Kh] (two pair, Sevens and Deuces)
hichnick777: shows [Qd Qc] (two pair, Queens and Deuces)
hichnick777 collected 11224928 from pot
4time2warp0 finished the tournament in 3rd place and received $10756.85.
*** SUMMARY ***
Total pot 11224928 | Rake 0
Board [2s 6h 9s 7d 2c]
Seat 2: 4time2warp0 (small blind) showed [7c Kh] and lost with two pair, Sevens and Deuces
Seat 4: hichnick777 (big blind) showed [Qd Qc] and won (11224928) with two pair, Queens and Deuces
Seat 8: casey1186 (button) folded before Flop (didn't bet)


*********** # 637 **************
PokerStars Hand #176683014312: Tournament #2054568934, $20+$2 USD Hold'em No Limit - Level LIII (450000/900000) - 2017/10/09 9:38:37 MSK [2017/10/09 2:38:37 ET]
Table '2054568934 624' 9-max Seat #4 is the button
Seat 4: hichnick777 (53496096 in chips)
Seat 8: casey1186 (37233904 in chips)
hichnick777: posts the ante 90000
casey1186: posts the ante 90000
hichnick777: posts small blind 450000
casey1186: posts big blind 900000
*** HOLE CARDS ***
Dealt to hichnick777 [7h 7s]
hichnick777: raises 972000 to 1872000
casey1186 said, "gl"
casey1186 said, "deal?"
hichnick777 said, "lets play"
casey1186: folds
Uncalled bet (972000) returned to hichnick777
hichnick777 collected 1980000 from pot
hichnick777: doesn't show hand
casey1186 said, "ok"
*** SUMMARY ***
Total pot 1980000 | Rake 0
Seat 4: hichnick777 (button) (small blind) collected (1980000)
Seat 8: casey1186 (big blind) folded before Flop


*********** # 638 **************
PokerStars Hand #176683018867: Tournament #2054568934, $20+$2 USD Hold'em No Limit - Level LIII (450000/900000) - 2017/10/09 9:38:58 MSK [2017/10/09 2:38:58 ET]
Table '2054568934 624' 9-max Seat #8 is the button
Seat 4: hichnick777 (54486096 in chips)
Seat 8: casey1186 (36243904 in chips)
hichnick777: posts the ante 90000
casey1186: posts the ante 90000
casey1186: posts small blind 450000
hichnick777: posts big blind 900000
*** HOLE CARDS ***
Dealt to hichnick777 [7c Ts]
casey1186: raises 900000 to 1800000
hichnick777: calls 900000
*** FLOP *** [6h 6d Tc]
hichnick777: checks
casey1186: bets 1890000
hichnick777: calls 1890000
*** TURN *** [6h 6d Tc] [5h]
hichnick777: checks
casey1186: checks
*** RIVER *** [6h 6d Tc 5h] [8d]
hichnick777: bets 4384800
casey1186: folds
Uncalled bet (4384800) returned to hichnick777
hichnick777 collected 7560000 from pot
hichnick777: doesn't show hand
*** SUMMARY ***
Total pot 7560000 | Rake 0
Board [6h 6d Tc 5h 8d]
Seat 4: hichnick777 (big blind) collected (7560000)
Seat 8: casey1186 (button) (small blind) folded on the River


*********** # 639 **************
PokerStars Hand #176683030602: Tournament #2054568934, $20+$2 USD Hold'em No Limit - Level LIII (450000/900000) - 2017/10/09 9:39:51 MSK [2017/10/09 2:39:51 ET]
Table '2054568934 624' 9-max Seat #4 is the button
Seat 4: hichnick777 (58266096 in chips)
Seat 8: casey1186 (32463904 in chips)
hichnick777: posts the ante 90000
casey1186: posts the ante 90000
hichnick777: posts small blind 450000
casey1186: posts big blind 900000
*** HOLE CARDS ***
Dealt to hichnick777 [Qd 2h]
hichnick777: raises 972000 to 1872000
casey1186: raises 30501904 to 32373904 and is all-in
hichnick777: folds
Uncalled bet (30501904) returned to casey1186
casey1186 collected 3924000 from pot
casey1186: doesn't show hand
*** SUMMARY ***
Total pot 3924000 | Rake 0
Seat 4: hichnick777 (button) (small blind) folded before Flop
Seat 8: casey1186 (big blind) collected (3924000)


*********** # 640 **************
PokerStars Hand #176683033247: Tournament #2054568934, $20+$2 USD Hold'em No Limit - Level LIII (450000/900000) - 2017/10/09 9:40:03 MSK [2017/10/09 2:40:03 ET]
Table '2054568934 624' 9-max Seat #8 is the button
Seat 4: hichnick777 (56304096 in chips)
Seat 8: casey1186 (34425904 in chips)
hichnick777: posts the ante 90000
casey1186: posts the ante 90000
casey1186: posts small blind 450000
hichnick777: posts big blind 900000
*** HOLE CARDS ***
Dealt to hichnick777 [3d Kh]
casey1186: raises 1800000 to 2700000
hichnick777: calls 1800000
*** FLOP *** [Jh 9h Kc]
hichnick777: checks
casey1186: bets 5580000
hichnick777: calls 5580000
*** TURN *** [Jh 9h Kc] [6d]
hichnick777: checks
casey1186: bets 5400000
hichnick777: calls 5400000
*** RIVER *** [Jh 9h Kc 6d] [Ad]
hichnick777: checks
casey1186: checks
*** SHOW DOWN ***
hichnick777: shows [3d Kh] (a pair of Kings)
casey1186: mucks hand
hichnick777 collected 27540000 from pot
*** SUMMARY ***
Total pot 27540000 | Rake 0
Board [Jh 9h Kc 6d Ad]
Seat 4: hichnick777 (big blind) showed [3d Kh] and won (27540000) with a pair of Kings
Seat 8: casey1186 (button) (small blind) mucked [5h Qc]


*********** # 641 **************
PokerStars Hand #176683050862: Tournament #2054568934, $20+$2 USD Hold'em No Limit - Level LIII (450000/900000) - 2017/10/09 9:41:24 MSK [2017/10/09 2:41:24 ET]
Table '2054568934 624' 9-max Seat #4 is the button
Seat 4: hichnick777 (70074096 in chips)
Seat 8: casey1186 (20655904 in chips)
hichnick777: posts the ante 90000
casey1186: posts the ante 90000
hichnick777: posts small blind 450000
casey1186: posts big blind 900000
*** HOLE CARDS ***
Dealt to hichnick777 [6c 9d]
hichnick777: calls 450000
casey1186: raises 1980000 to 2880000
hichnick777: folds
Uncalled bet (1980000) returned to casey1186
casey1186 collected 1980000 from pot
casey1186: doesn't show hand
*** SUMMARY ***
Total pot 1980000 | Rake 0
Seat 4: hichnick777 (button) (small blind) folded before Flop
Seat 8: casey1186 (big blind) collected (1980000)


*********** # 642 **************
PokerStars Hand #176683055787: Tournament #2054568934, $20+$2 USD Hold'em No Limit - Level LIII (450000/900000) - 2017/10/09 9:41:46 MSK [2017/10/09 2:41:46 ET]
Table '2054568934 624' 9-max Seat #8 is the button
Seat 4: hichnick777 (69084096 in chips)
Seat 8: casey1186 (21645904 in chips)
hichnick777: posts the ante 90000
casey1186: posts the ante 90000
casey1186: posts small blind 450000
hichnick777: posts big blind 900000
*** HOLE CARDS ***
Dealt to hichnick777 [7s Ts]
casey1186: folds
Uncalled bet (450000) returned to hichnick777
hichnick777 collected 1080000 from pot
hichnick777: doesn't show hand
*** SUMMARY ***
Total pot 1080000 | Rake 0
Seat 4: hichnick777 (big blind) collected (1080000)
Seat 8: casey1186 (button) (small blind) folded before Flop


*********** # 643 **************
PokerStars Hand #176683057040: Tournament #2054568934, $20+$2 USD Hold'em No Limit - Level LIII (450000/900000) - 2017/10/09 9:41:52 MSK [2017/10/09 2:41:52 ET]
Table '2054568934 624' 9-max Seat #4 is the button
Seat 4: hichnick777 (69624096 in chips)
Seat 8: casey1186 (21105904 in chips)
hichnick777: posts the ante 90000
casey1186: posts the ante 90000
hichnick777: posts small blind 450000
casey1186: posts big blind 900000
*** HOLE CARDS ***
Dealt to hichnick777 [Th 6c]
hichnick777: raises 972000 to 1872000
casey1186: raises 19143904 to 21015904 and is all-in
hichnick777: folds
Uncalled bet (19143904) returned to casey1186
casey1186 collected 3924000 from pot
casey1186: doesn't show hand
*** SUMMARY ***
Total pot 3924000 | Rake 0
Seat 4: hichnick777 (button) (small blind) folded before Flop
Seat 8: casey1186 (big blind) collected (3924000)


*********** # 644 **************
PokerStars Hand #176683059971: Tournament #2054568934, $20+$2 USD Hold'em No Limit - Level LIII (450000/900000) - 2017/10/09 9:42:05 MSK [2017/10/09 2:42:05 ET]
Table '2054568934 624' 9-max Seat #8 is the button
Seat 4: hichnick777 (67662096 in chips)
Seat 8: casey1186 (23067904 in chips)
hichnick777: posts the ante 90000
casey1186: posts the ante 90000
casey1186: posts small blind 450000
hichnick777: posts big blind 900000
*** HOLE CARDS ***
Dealt to hichnick777 [Jc Tc]
casey1186: raises 1800000 to 2700000
hichnick777: calls 1800000
*** FLOP *** [Qs 8d 4d]
hichnick777: checks
casey1186: bets 5580000
hichnick777: calls 5580000
*** TURN *** [Qs 8d 4d] [6c]
hichnick777: checks
casey1186: checks
*** RIVER *** [Qs 8d 4d 6c] [Qc]
hichnick777: bets 59292096 and is all-in
casey1186: folds
Uncalled bet (59292096) returned to hichnick777
hichnick777 collected 16740000 from pot
hichnick777: doesn't show hand
*** SUMMARY ***
Total pot 16740000 | Rake 0
Board [Qs 8d 4d 6c Qc]
Seat 4: hichnick777 (big blind) collected (16740000)
Seat 8: casey1186 (button) (small blind) folded on the River


*********** # 645 **************
PokerStars Hand #176683076586: Tournament #2054568934, $20+$2 USD Hold'em No Limit - Level LIII (450000/900000) - 2017/10/09 9:43:20 MSK [2017/10/09 2:43:20 ET]
Table '2054568934 624' 9-max Seat #4 is the button
Seat 4: hichnick777 (76032096 in chips)
Seat 8: casey1186 (14697904 in chips)
hichnick777: posts the ante 90000
casey1186: posts the ante 90000
hichnick777: posts small blind 450000
casey1186: posts big blind 900000
*** HOLE CARDS ***
Dealt to hichnick777 [7d 3s]
hichnick777: folds
Uncalled bet (450000) returned to casey1186
casey1186 collected 1080000 from pot
*** SUMMARY ***
Total pot 1080000 | Rake 0
Seat 4: hichnick777 (button) (small blind) folded before Flop
Seat 8: casey1186 (big blind) collected (1080000)


*********** # 646 **************
PokerStars Hand #176683078427: Tournament #2054568934, $20+$2 USD Hold'em No Limit - Level LIII (450000/900000) - 2017/10/09 9:43:28 MSK [2017/10/09 2:43:28 ET]
Table '2054568934 624' 9-max Seat #8 is the button
Seat 4: hichnick777 (75492096 in chips)
Seat 8: casey1186 (15237904 in chips)
hichnick777: posts the ante 90000
casey1186: posts the ante 90000
casey1186: posts small blind 450000
hichnick777: posts big blind 900000
*** HOLE CARDS ***
Dealt to hichnick777 [Ah Ad]
casey1186: raises 14247904 to 15147904 and is all-in
hichnick777: calls 14247904
*** FLOP *** [4c 7d 7c]
*** TURN *** [4c 7d 7c] [Qs]
*** RIVER *** [4c 7d 7c Qs] [9c]
*** SHOW DOWN ***
hichnick777: shows [Ah Ad] (two pair, Aces and Sevens)
casey1186: shows [5s 6c] (a pair of Sevens)
hichnick777 collected 30475808 from pot
casey1186 finished the tournament in 2nd place and received $15642.83.
hichnick777 wins the tournament and receives $22761.14 - congratulations!
*** SUMMARY ***
Total pot 30475808 | Rake 0
Board [4c 7d 7c Qs 9c]
Seat 4: hichnick777 (big blind) showed [Ah Ad] and won (30475808) with two pair, Aces and Sevens
Seat 8: casey1186 (button) (small blind) showed [5s 6c] and lost with a pair of Sevens



